11111111111111111111111111111111111111111111111111111111111111111111111111111111111
10000000003000000000000000005000000000500000000000000000000000005000000000000020001
17308022303043244388707750334064303040704063467052776353827757703030647570624030401
10803060006000000000700030000020003060202000003000400000000000305050400080007050201
10602860224278848570703050784630272670302587507070805033432380605050603077405480301
10600050000000000000607060007000600000200020007030005020002050700050802000500070801
10848040803755374438573040708064608586454760365040235470505040657778207020407080701
10500050507000000000400050806000608000006000300030200000500050500000808050407000701
10405460654044272620307060404240756030807067205458506027674070506420608820208274201
10200050004050000000404020608060000070500040300000006070002040307000205000300000701
10577070207030438245306050403026364570443850807043473043807030203085403075566760201
10000080800070002000005030300080004000200000205000006000007020807000007060004000801
10733430502664636050346030364577304083403435703078503444804080703027743050505320601
10005000600000600020500020000000006000404000206000600000402080002000004000300080501
17405045676652206747208063843455268060306340204440752270208082268420405524542070801
10003070000000504050005000300000004050006000700080000050806000000020600000800020201
10375080872260402030606880802638502682702086402064204040528226568024466680602342401
10300030500070302000502060500040004000404000202000207070800000400070003000500080001
10208060606080203046708050623040466030424830278280405060703430804020305055335080661
10705070508070005000200050008070003080000070008000408070300020502060200070003080001
10403040203072746523703327603040705254785088807054204080868040802080622320307048201
10202050005020006000403000800040700000005060800020007030604060002040000000203000801
10806886355050508050308030674070486776807040307270462040208067268263646084658470701
10300000006000302080700080003070008000303040600020500040007000000040008030005020601
10753727753856407020788630606877405020808040282080202826832874323030504370404030601
10000000800000003080800020500050006030600070005060200080000040000030305000504060801
14774060304763743030207080362040864030366348305040405070363030507660407083403080501
10008040800000008020008070606080000030000000808030502040400040300050808000702000401
18607720407628404080364040605080824088238870704040808030303760767550303830407770801
10006000504000500040008030704060003000000050003030203000802000200030700050200050301
10706024255050438538806080303060805424535878567450773385204025703040508060285034801
10202000000060003000006040003060605000600000000000200080003040003000502050002000001
10207852487583607048368070877065308020604026488645507030227040767677245040404047561
10400000400080004020000020200070003070007000003000602000605020007000007030707000001
10765674208050843060405780608870552067755777606050202324608036802034304032607035601
10300060007000500060800070803020300020000000202080200000005000707000206000002000601
10202080502475406760603660507070704775222650868060404634327070202760202486653080301
10008000505000004000605000303000706000000030000040600030004070202000700060008030701
10682077708058855068385075705332407050858086256550473060207060302050288068807070301
10007000707000800060003030002000400050002070000000400030408080702040006000304050601
14802428702080502765202020322060226765308030403277503668608060605040304520207380301
10002000305070500000404050000050500000306000400000400000005050700030705000200080301
10545070302080428380306025653280462720746424842680864055503030868272702050503070801
10300050004040000070003000000060800070800060000040007000506060803000203040606000201
10408572532060472087822730756070704080404020783020404240264020302020774060547866501
10500000200060005000000030300040008000405080200020800030800060008080000030008060001
10703340806448403454685070405862653264667060706472525058503058663047505226508080671
10308000806080005000008020600000005000005050400000000070003000007000600000200050001
10757040704030504030722020727347203082702037205258652480702368273570606220207544801
10300040604000305060800030008000305030007000303000000000406000004000405000204000601
10402738303458857070308560607050604070842760566035866772327027803054438025808080201
10600000400020000040300030700080600060300000600050000080006000500050005070307030001
10556780346020306024656050788070706480402047403040226080306040402880507070602070551
10000060007000707030000060007040307080004080006040008000302080200070700040005050001
18828058803453602040875646204660707025724360403073504562603850428060773485468025501
10007080007000004080004000804000300060007000308000200000302000300080300000004080401
10408020443827255033206820408054355640203078452462404520306030804220308723508020601
10508030400000005000600000802000000060303000800000600080800060300030705000402020801
10765060577332303730708843806547602060508050602870244220448655734050704067406070301
10003080002000008070500000400000503000507040600060000000200000005070008060002020001
10507063608088736060484625464330886234708070738064578874673747807073273040544044601
10208000204020000030000000000080000050007060005040000000000000608000000040003000201
10707380802080408254744788254030763020527633344030244226248450508435536787307380561
10600020600020300000000000300050800060000000200020700000008000500000000000300030001
10234020575830522660248340705526604085283560706470403272802053423657307580753083601
10002000500070000080000050800000706050000030400000704000407030000000400070000020001
10202823505080658053273040864040402080804030258084406060307065206750604066467360251
10804000004030003000004020005020805030708040008060008070603000400040408000000020001
10804065834037472067308234408350302750887087806460422063305080678760404332447053701
10200040200040003000302000304000800000200050303000400060006050000070800060004080401
10552220405720702232803060382070778755507530806020407870828070738040804060477020601
10300000500000600080006020000080008000006000400020500020706070006030404000500040401
18502064654537824050262040653480558077587030656380207070704030436050402325708350701
10007000000030004050400040000020400080000060500000502000200060800060606000600000301
10506482748044203050204075644060603620403880703874674446444040203650403020206277301
10700000003000004050704000700070700000602000600020000000007080500000403080400030501
10666645543063587070604336403563323642205068427220404852208080444576347040676080301
10000000008000700050005000006000500030008030006000507000005060700060800080007000701
10886852706888806085446068232880806020445060408077604083423040705030504324702664501
10005000800060008030003000000070705040400050303000602000300070006000300030002000201
10304080348020606050603825358030408430607230407570735460244266766765372080757060701
10700040004000207000300000002000200000600000500050000060000000000000000080000080001
11111111111111111111111111111111111111111111111111111111111111111111111111111111111
