11111111111111111111111111111111111111111111111111111111111111111111111111111111111
10000000008000000000000000002000000000300000000000000000000000004000000000000070001
12304067205024643527802420626036802020707044857046528486753573805040374470344080601
10202060007000000000400040000040002050206000005000400000000000704080200020007050801
10506540345532226380806080543660733370408623608060403086476560808050205037804260801
10600020000000000000804080006000800000600060005070007050003070300060707000500070201
10763060408523244625232070302043704872526320734030522620402050436638705080606020701
10600040805000000000800040308000508000003000500040500000300070400000806080303000201
10606470852072355820404050804850846050502026606547704065342080508350607870307454501
10200080006040000000704060806080000030500020300000007070003040206000205000300000201
10376040607070543443708050707072864250435780804075774045602020702025706026254420301
10000020500040003000006050300080004000300000808000002000005080203000006040005000401
10568280203853458040564070886668502067508472706044406237607020708032653070705250401
10007000200000800070400020000000007000404000505000500000702020008000003000600070201
18806042284855704488305088343564743040602450706680683320602073526680408523724070701
10007080000000604070004000300000003060003000200050000030803000000040300000800040401
10423030566530402050508430808326505625204076506084706070288254666057365730704252701
10200020600060506000506020500020003000405000402000702070600000700030004000700040001
10606070206060803036608060437070554050522340446540506020505740608070505026465050361
10304020504030007000700070005070008080000040002000708040700070506020400070002050001
10506070207026586484505637804060507725753035606047208050475040806060236640706052201
10608020003070002000208000700020500000005030800080003040306070003060000000606000601
10607268372050405080608080646070883246302050506420434030706045676625343076376380601
10200000004000707040200020008060008000408030400040300020003000000080007050007020601
10875342563273505040232530303532608020803070866060205534386537324020408250407050501
10000000500000004020700060500060002050200020002050200050000050000070703000703080701
16525050708744732080502040377030684080676327202020304030365050607440706042202040301
10007020700000006020004060805070000040000000208060402070800080500020608000704000501
13708870308844603070645060405050868048348880406070204020805430474550702780806660801
10006000505000200060007070508030008000000080008050705000603000700080500040800070801
10502054374040567773302020203060203543833368636260648535604072802080604030742072301
10308000000070006000002040008040308000600000000000300030007040003000304030003000001
10204288538875708084547050233078206030302054734746403060584080286867726080802057361
10200000400050004040000070800080006080004000004000708000603060004000005030304000001
10774337803080337030607540703220474038484465602030605482307074408062702063403074201
10300080007000300060500050708080700060000000404070500000008000706000303000003000301
10505020508248402240704470308050507724338240367020807527863060607860607334884040501
10005000604000006000706000307000205000000050000050800040008030704000600080007070201
10733062204084278063328054408273405070363066763880525060202070705040484037705040301
10006000504000300060004080008000600060005040000000800030502080507060004000607040501
17206277307070304327308060242040565444506060602538704463304030306050705720302250601
10002000306070800000202050000080800000505000700000800000006080400020305000700040801
10756080302060375240603072783460752460853626422620578058203040648552506030606080301
10600080002080000040007000000080300040400080000040008000803030808000604020607000201
10404424746060447068667660786070305080506020464040508430483060806020456080363446401
10700000200030002000000070700040005000804030300080200070700040006040000040003060001
10405420406236202532244040206657585665763070804373328056206046558043808878505020631
10606000305070004000004080500000008000003060500000000060003000002000300000500070001
10538050706020608020886030285423208065703073207553535630607546653870507370606236401
10200050403000807040500030006000307040006000204000000000308000002000408000408000301
10408488602583542020408540402030304060755880246083374878353025605027373052507040701
10300000700030000050800070500080800030800000700060000020002000600050008060507050001
10332840365040806065465050275020804440808063705050456060202060707670307070306040231
10000080008000804060000070006080402050006030002060003000606060300020500040003030001
14444044606323702060447245203260707034243380702027506822304560286050726386684025601
10004040006000004040004000707000400020004000507000600000706000500030200000005040601
10607020564558528054405630203065464320505067585825403750602080207250307458406050201
10706050300000008000300000405000000080402000600000600060700040700080606000607050601
10578040785743205660602358502257207020705020806230833540844577354080803076706050601
10005030003000003080600000200000304000404020800060000000800000006050002050003030001
10807066203047668040537624858420565384502050244074637644532385408058526030368046401
10508000505020000070000000000020000070002020007070000000000000703000000050003000401
10207320802060606863753484378070768070687624288070756236658880702684328773408380881
10800050800030600000000000200070600040000000800050400000006000400000000000600020001
10886050728370263720253770504475402043655720402660603872707046638246802480356024601
10006000200020000070000060700000408070000020300000807000303040000000500020000040001
10307475208020546084627030577030704020204060524075404020605035308270208024435770631
10502000008050002000006030002030206060806060002070007020408000300030207000000080001
10804027347034685048307238707830608760663038207660882027807080436450602442253028701
10400040500060006000308000304000600000500070502000400030003070000040400060006080201
10748330808860306428705070865070746566207280203080408540662060235070707060352070301
10800000700000300030008020000080006000007000500060500080605020007080402000500050301
13804034382565254050237050464270743048235020755230205080605080253050602258304320701
10003000000040003060200060000050800070000040300000302000300070800050804000500000501
10407237287033405070507024766050408740404840608864566467258070504650403030507566701
10300000002000008070707000800030600000703000300020000000004080800000507080600080301
10464438645058344080605727708676347866806024434670806348505020864556333070587020601
10000000004000600030003000004000200060003070005000607000004050300060500050006000201
10276764702546408085533047382560406020685020605047703088688030708080306325303666701
10008000200070006060004000000030207080200040503000504000500080006000500080004000801
10603070654030405060603584562060404530302530306540872460736752526533458020845060201
10200040008000507000400000005000300000700000800060000020000000000000000050000070001
11111111111111111111111111111111111111111111111111111111111111111111111111111111111
