11111111111111111111111111111111111111111111111111111111111111111111111111111111111
10000000007000000000000000006000000000600000000000000000000000005000000000000080001
18707032402075776238306640777044208020305084766047378724482554802060344330558050401
10208050007000000000800050000080003060607000005000600000000000408080600020006020501
10807730577376827740505080562430466230704843808050803027676380706050802057605270601
10800030000000000000302030002000300000700070007060002030002050600060507000600070701
10842060406473363533243070203035802562738860557080476520804040578344702040505040201
10300030203000000000600050703000607000007000300050700000800080800000302070304000401
10703360578063268460803080403820554030808043808276608082834080306560804350308275401
10800080003060000000403060303020000080800030500000002060003080507000806000200000301
10483030807020326478802080208062837440576570208047887035808080303052404048774580701
10000030500080002000003050400060008000600000402000008000003030402000002020008000201
10268380608542534080557020234268405047703366204046708452406050406064846030303360301
10004000700000600060600080000000002000808000706000500000402070005000002000700050701
18807048237474802478804066858768264030508440504360765440206035657640403254435040301
10006050000000306080003000200000004040008000600070000030703000000060300000500070301
10462070236220502030305750308477403282403085303088702070784552436052463770307787301
10500080200060406000407050600020007000407000703000406040600000300070008000800060001
10208060207060208073206050235080547070584360547470803020402840304060403074623040721
10306030702020006000800070006020005080000070003000506070400080608020500080007080001
10203040402024426538505276603050606735745025708075602040523070705080366540402036701
10702050002060008000407000500030300000002050200040002060702070006080000000707000301
10502252644030703040808020562080687466406060803460475030706082456874766057442520501
10300000008000705060600060006050003000504040800040700060004000000060007030002070401
10562766277253607070365650207685305070306040663050405734767632655030208520608020601
10000000500000008080500020700080004070200030008060300020000020000030504000307040401
15287040404574274050706050633060563070686267206060505070534070206830508065205080201
10007080400000007020006060606040000030000000406060503060200070200040608000703000401
12803860603638603020542020202070776058245630604070806020606470227870205530406380401
10003000506000500020006020606020004000000040007030406000607000300020300030200030701
10202025822020225785503020208060406636338427445380244378407055203050807060277084701
10308000000040003000006030007080508000400000000000600080008070007000803060003000001
10604374243887803035284050333067607030503082428728605050374020846556864080204026431
10700000200080008070000070400040005050002000005000602000706070002000003040308000001
10244623405070787050303870403370823064548336406060504677605054505083307037208034401
10700030002000600070700080204030700060000000608030200000008000403000407000003000301
10407080405552303740706560706070403623735350346040506858282070206470806832864070201
10002000407000004000303000805000603000000050000050200070006040204000800050007080201
10386047506024538022525077207234805020344033548270667040606020405080854082502080701
10006000608000600050005040003000300020006020000000500030304080205020004000602080501
13805564703070805642505060867070846646803080405362608582603080302080607720804660701
10005000206080300000406060000040200000203000200000600000008060400050302000300040401
10726030808030334770607065677540258650762737572720232065503050548545602050304030201
10800020003020000020004000000030300050800080000050002000803060202000406070705000201
10804762854070722028254470747060207080304030328060405540642050806050445070544568801
10500000400030004000000060600060002000304050700030700040700020008070000060004020001
10202750602727502355765080302778655673674040304458654072304026835038703722705080451
10708000702070002000008030500000005000006020400000000080005000003000200000200060001
10855050408060602060552040268454602037503077403684322630503283428380406550508474301
10500020605000503040700050008000304080008000207000000000803000005000808000502000701
10503675408482282020306230402070804040646440748026337526557046605054372028207070501
10200000200060000040400020600070700020200000600050000070002000300070006060507070001
10574740246070708084673060768070508660706038204070363030806030706320502050805040771
10000050006000205020000050007030505070003030002050003000603060300050700080004060001
18477043406686303060866853702870808048452730803087802286207770458050455443365043601
10002070007000003040003000602000600040006000508000400000708000400080400000008050401
10407050357578562055507320503085762450708077886675807670303080504770208383708020501
10605080700000002000500000502000000080204000500000600050500070700030706000607020701
10787070572445307480404755404837403070702070202750834740466455676040207072408080301
10004050002000008030500000500000708000806030200080000000300000004080007080004080001
10202042207074745080666777862340688732202030356025272475437352304058626050668048301
10605000807020000070000000000040000020004030008070000000000000303000000070004000201
10602660704060705227446387568020828050662664762030436732338380502682624368505330351
10200040600020300000000000200020800080000000200020600000004000800000000000600040001
10743020324340587370625380208272808023376630205440506837204055837283607860372046701
10003000200080000080000030800000606070000040500000702000604050000000300080000020001
10803872705060646073465080884040507050808060324063808020703086608520707082763430751
10406000008040005000005050007040203020703060004040002080406000400040703000000050001
10805087863068428088505423508640204630485043606780645073506060534370703688288052501
10500080800030007000207000806000800000400080703000300080007050000080600020002070801
10274570203280406455203050653020734356703480602020605880363050466020408030373060201
10300000400000300050005070000020005000002000300020500040308040002050803000700020801
18503038558266736020832070344560834064265060472340408060803030682050406826808830301
10006000000040002070300030000060800070000070600000605000400040700030506000500000401
10208637323068302060508065878020206420605540605232574432357070803340508040808382401
10400000004000007080206000200050200000204000600080000000007030800000804050800080301
10228362432084348050607254606636262273202048877650304636403080873287222080862050201
10000000007000400070008000005000300020004040005000305000004050200040600030005000801
10523335407683604036662087853870603070784030708087304078533050605040704345508482801
10008000300080008080004000000050804080700020702000402000500060004000500020006000201
10202050365060406070806537665080606340306240505250364770722835288488276020766070501
10500030004000302000500000003000600000600000800060000040000000000000000080000070001
11111111111111111111111111111111111111111111111111111111111111111111111111111111111
