11111111111111111111111111111111111111111111111111111111111111111111111111111111111
10000000007000000000000000008000000000200000000000000000000000004000000000000030001
15705048304085542452404370488026604020503028256075244858735864504040844870578040301
10304070008000000000500080000050005070306000005000300000000000704080700080003020801
10302240864768376780207060232750845680607722406070505037567220202040407026807330401
10400020000000000000705080002000800000300080007020008080005080800070706000300030201
10543040806376883545553020305057205424473450253050437520705040572477603040705050801
10600040503000000000300050605000607000007000700070700000500070300000608020204000601
10704460344044644820704050306480723060506036604532807052753060707350508550306536501
10400050004040000000405050505080000080800050600000007040004060404000807000700000401
10662070804060555474704020704087757420647360705026665057807060508054604026736280401
10000070800020004000007050300060008000800000604000006000008060307000006020007000801
10585520503535274020767060234825607052603783707088304553607070202035662020604350501
10008000800000600020500080000000004000303000205000800000706040005000004000600070801
17207042688622804858506085746748674080703760804660646560408056546480304575482030201
10007070000000303030006000700000007050007000800030000050605000000060500000300050401
10656080445780405050404630204824602657203043407066402050288636555056833820503254301
10400020800030807000304070200060008000307000203000204070400000200030006000200030001
10705070502020808064504060872020278040733720537360806020603440403020208067478030371
10508020203080007000500040002040003040000030003000507060200070802050700080003060001
10805050207082826345303727307060403353442084504028506060643020403030282780607026501
10803020008040005000508000700020200000007060800080002050602020005040000000508000701
10702727448040207080606020335060853844208030703450475030506086737867555064437270401
10800000005000304020400080005080003000307020200020200080005000000070007070003020601
10288343227632704030538550305675208060206050483030802533546562723080306220805060301
10000000400000008030500080700020004080200060005060200030000070000040302000806070301
16367070803865852060302080575030673050543644408040507020556070202340502088605020401
10007050500000002040003020508070000030000000505060605020500070600030606000707000201
16202680408572605040652030702030742037244350306080406060302720545430304550402870601
10006000206000800040002020204030002000000030007070307000605000400020500070400030801
10807063576020883453503030508030803238552647686230582745307034702080702060623064701
10703000000020003000005070002080407000600000000000300060008030003000508020006000001
10805557374726406044673060862025604070804054265828706030765040543246736050203032471
10700000600020003070000030500080004050006000002000705000402050008000003020604000001
10757356205080236080305270705670424078452877408080402672608034707057508034506088601
10600020005000600060200030407020500050000000207080300000002000602000302000007000801
10303080608645602330507750506080608756367470363030307543757050302360308724384050501
10008000704000004000207000808000702000000030000080600020004080808000200020005070801
10485038402048376025784037307573308030374057565580373060503050603050222086502020201
10003000505000700030007080002000700060006050000000200080505020805060008000506040201
16707825707070506752602070872040383636502080203845205566305080606040405330804780301
10008000406070200000605040000050200000802000500000700000005020600020402000800040201
10284020503060325870808036853530775440648728287220384074804020885558608020702060401
10700060006060000080004000000020600040500030000050005000804030504000807030703000801
10606287526060563083268550576050603040506060824050205630326030307080784060483336701
10600000800050006000000040500080005000708080400020700070500040005040000070004080001
10404580708822707678442020502842375675833070403788583032205074564082405635704050481
10408000505020005000007060500000006000003040400000000060002000007000400000500020001
10824020203050302050452080637624304063704032508785845780405356472730503350306376701
10600070302000304020500050006000408030002000808000000000807000007000706000205000501
10808773602846578030507460503030308020245680858073364873852065405074525047502060701
10200000600080000050700070500050200020500000300080000080004000200030006070802040001
10736220742020307023578050656080208880802076405060374030602080807880706060408020771
10000060004000504060000080002020204060007070003050003000802060700080300080003080001
17674057608737504020252373604520703053632580204033308526703760786060247745367045401
10006050005000005050006000208000600020006000805000400000207000700060500000004030801
10808020454266536047508850708048867520504034327264307420706020307240707383505020801
10702050500000002000700000503000000080306000400000600040500050400030707000504050301
10372050585835405760203832506277607060402060207570783240577662278030305025205070801
10007040007000008070500000700000604000405070400040000000400000004070005040002020001
10804074807078762020826256237340278562602030875057724432736777705056643040573047401
10604000406020000070000000000070000020007080006050000000000000603000000020005000701
10407880705020706366248665672060383030427424388060242673483340702274867725805550321
10200050500060300000000000200060400070000000600050200000002000700000000000600040001
10238070684270386860273430207456207034774830607370607877403065886336608470543082701
10007000200070000040000030700000606020000040500000406000403070000000700020000080001
10706845505030856075436050742070208030606080854064605060602066208420708074878230651
10306000005040002000003040004050708050602020002070008040305000700020402000000060001
10403077547057228024503763604320703480565033304280344048702070863350405855647067601
10600040800030006000502000302000400000500040406000400080004030000060700050003040801
10356520706850804585605040252080344288504550806070507470326020422030203080477040401
10700000700000700030008040000040007000008000800030300070507070002030706000700030401
12702028767662268050783030727320573058753030852650408030707080452080505466703770601
10006000000060005040300060000030400060000020600000702000300060700030708000400000701
10406783475066403080606034735060703240705360604733547587457050604420605040608334601
10400000007000004030602000400050400000806000800050000000006070200000702080800040401
10476266722038832030308442306583258386508075273820602737408060855547466040653080701
10000000004000800080007000005000200070007030008000703000002050800060600080007000401
10328682502856402054688084643430305030357060504076706075723070305060305547707642301
10007000800020005070007000000030707030500060706000708000500020004000600020008000701
10608050828020607080303257778030505320406850303320477660344763238448858020552080301
10400060006000206000600000004000600000800000400030000030000000000000000040000080001
11111111111111111111111111111111111111111111111111111111111111111111111111111111111
