11111111111111111111111111111111111111111111111111111111111111111111111111111111111
10000000008000000000000000002000000000700000000000000000000000002000000000000060001
12806047208067277487702880358072203040204057723023255326332328205020556840438020701
10406060008000000000600020000030005050507000003000300000000000407030700030006030801
10207430847352357280203030582340248850202872604050605088355550805060408052303820301
10400070000000000000805080007000500000200040004080006040004070500030708000500040401
10258040403883828723234070303034803437833580487030356680408080855746706070708070401
10400050706000000000500080706000306000008000200070400000600050600000602040706000501
10806420758074856260404060802640727020206034506424603056737080602580708230507277301
10700060007030000000305030504030000070500050300000006030008050306000404000600000601
10646070806040763587202050405088663230427250403058773077707050406086405032883830701
10000050800060004000003050500020006000700000706000007000004080404000002030002000701
10858470204482648020884060367345408033603865305085202884803050402082448050602380701
10002000300000200060400040000000006000208000702000300000406080007000005000300020801
12203066687737803672507056273462762070606580402560736750204076842670503754438080401
10006080000000603070006000800000003060002000700020000060507000000070300000800040701
10746060363480308020503270804635202723805076806024304030635444845085282680803888201
10700030700040707000307040400050003000503000407000603080400000800030005000700030001
10604030304030504074504050287050232040235340358820404040205780703060508026435070381
10704050804050007000500060004050005080000030002000608070200040604070300050006020001
10402020702063336587507785407030204474766086706042305070667020403040784570508025301
10507040003030008000805000600050400000008060600080004020408060007080000000704000401
10808225384050808080408060526060248327807040306550445030202083768544756063738750701
10500000002000202030600040003030002000603030800030400060002000000050006070004080501
10738243664645206030728330503237208050502050475070702746886523447020204520407030601
10000000700000005020300020400070002070200030007050700030000020000020408000202040801
13683060507457425030705060884080864080627833302040405030246020203260704044704020701
10005080800000007020004080608030000080000000205040407030500080200020402000205000201
14205730706576807070386060605040382074667250803040503020403230447370603520702780401
10005000607000500060002070702080004000000050004080806000607000700030300020800080401
10802075346070337865305020603080604443426638258240866887408048308080706060765075301
10305000000020008000005080007060805000800000000000700050002040003000305080003000001
10703754325448606052344070645074703070506032583737405040247030666335562070406056471
10500000400060004070000050800070007080006000002000706000503080004000008050508000001
10858577303020888040602360804540553024234835203080504458208065705062406083405056401
10300040003000200050400030806060200030000000303030400000005000804000304000002000801
10604050402444706740204540703070207538353870367060602835526030205570702726874020301
10003000708000003000807000604000703000000020000060300020003050207000300030008040301
10453053404027687032674023303654307060547087778340337050804060506060885062507080201
10008000205000500030005080008000400030004080000000800040705070302030004000502070701
17303468707050506674407040338050888783508020805523806272703020807030204460506280801
10003000204080300000202080000050600000305000200000300000002080600020807000600060301
10884020207080748740508075485250824450243827284860766033708020864835508030805060501
10200080004060000030006000000080300070300020000050004000502040202000202030403000501
10302325868030456063237520473060708030504040253050202850385020207050666050625745701
10200000300080002000000030200060008000807080500030700050300080002070000040004040001
10307270606855502728448050206528363747246030706267665075603055857024207867507080761
10603000507080004000008060500000008000008050200000000040008000005000400000400080001
10662040202030407040565040383246408073502044707235565460708278245650208560605542801
10200050802000804020600030006000702050005000807000000000502000005000202000203000501
10404785804452273040805850305050607020235350827043442868552084808035448025406080701
10600000800070000060300040400070300070200000400050000040005000800080006070308060001
10854830273060806077224060365030305630608028804030842020807020703560502050406060641
10000040005000708040000040003040405040008070005040007000802040800050400020007080001
17366034405862603050555666206730507076224760308047303445804460278020622477765067201
10004020006000005030003000708000400070004000307000500000408000400080500000005020401
10307070477877782087204340504085585550203062326738306730708040405250204278608020601
10402080500000002000200000804000000020206000500000300050200050800070702000404020401
10566040644742202220702376603785302020302020608860556440768275458060503044202060701
10002040006000003030600000200000203000605070400050000000300000006020003020005040001
10602085507028835060243758756670288424607020767073646642247234806034482020347068501
10308000802070000050000000000040000030008030006070000000000000503000000060006000401
10403630407020304753335656744050353030478352443050656523652420507675827822405730661
10200030600020700000000000200060200070000000300060700000008000200000000000400070001
10676080545720238740664550607554305026555440402340806646205025252843808760734058401
10004000200050000020000070300000406080000050200000802000306030000000600080000050001
10805525806030266082324070762070606040207040234065805020803047803850404063323630331
10805000007050002000006070008020807030707070005060002080303000400040603000000020001
10306054725078877043506362604520406550465036407880486066403030682640406642635085401
10800060800050005000405000504000400000500030602000300020004050000060800080005020201
10344360708630704635406080243020457234702570807030705570754050846050407060254030401
10400000300000800060006030000030005000002000500040600070507030007070207000300030601
18802022324254665040456080367630873077234080878620606050405020385070205432506640701
10006000000070005030800050000050800070000050800000307000300050400040702000700000401
10507682383073404040703038775080202760405280508284362336564060205330302050805878401
10200000007000005060703000700030700000607000200050000000005060500000807040700020801
10563477327067774050502855402547388226402076488860205868406070683256776060645030301
10000000006000600050002000006000300070005040007000207000007060300050800060003000501
10255326607684708086366047744280206020358060608044804048445070805050402462808442301
10007000800060006060006000000060203070800070807000808000200020007000600060005000701
10507060744030806050207744384060808320407860503640222770772465584326432060523060601
10500080002000308000300000002000300000800000200040000050000000000000000060000040001
11111111111111111111111111111111111111111111111111111111111111111111111111111111111
