11111111111111111111111111111111111111111111111111111111111111111111111111111111111
10000000006000000000000000003000000000500000000000000000000000002000000000000030001
17202035604043855865305440683068304070505067276053873765472372607040564680265050201
10805050006000000000700070000070007050305000008000200000000000607050800070005050501
10705660536255442350502040857270442770403562607060408077824280402060503057307380701
10200020000000000000304020006000500000200030005030003080004070300040404000500040701
10437050607584765576664040505053802547554580742070555680807050534623705060405030201
10800050208000000000200020203000803000005000600080600000400080700000204040205000301
10408850834024244780508020308580577070306078507686507024743020705650308560508654301
10800070008060000000706070208080000060500060300000007080003020505000208000300000201
10526020508060443326406030208046245250526720805084723034504030603067308056378540601
10000030700030002000005050700060008000700000808000006000005080507000002060007000601
10436270804333835080265040544632502023406357706075202687302040804078556040607820801
10003000300000300030300040000000002000503000403000800000405030006000007000300040801
17806047768233203253304056332825242020607370704730828730204043663320507233624030601
10002040000000602040008000400000003030002000500020000050604000000080400000400070201
10763040767880807080508830807233707426806025704082507050367372664077833240803374301
10400070700070207000307070800080003000306000303000706050300000200060008000800050001
10508060503080404022505060463030456030284730487780203030402860206020806046258030731
10302080605020005000700040008060004080000070008000502050400020205070400020005080001
10507030208027225863407752408070706755547056402047603050587030407020282270205034501
10806050006040002000308000400060700000006040600020006070605040006050000000703000501
10706577353070707040407060622050773358205070605560747030703068778787427064622480401
10600000005000503050300050003050006000705020600080800080008000000030004020007030201
10436622742533402070626850306377702040603070273050404886888332756030208830405060301
10000000600000008040200080800040003040200070002050200050000060000080505000602030301
17362030706264263020403030434040644020822365503040605060757040206540504073704060801
10006070300000002060008060705040000050000000503080502070600070300070303000504000701
16206460207585205060885050608030334072446380205040807030706670564860208880502830701
10003000203000800020003070204080002000000020004060204000307000800050800070200080601
10406066545060635357205050208020307443264478548720724238406032404020706070457078301
10404000000080002000008050006030207000700000000000200070007030006000302070004000001
10805642234282802023724080744047204040702025687654608070432040225887768070502034621
10300000400060007040000040800070004080002000004000305000803030004000007040808000001
10823667308070333070807420306330284057365228603030408846304064706066202023802027501
10200020003000700030700060307080700040000000202040600000007000704000205000006000601
10203060406377605730207450604030503445833760865060504527543020505530802725654060301
10003000306000007000406000602000302000000080000030800020008050508000500020003040401
10872086306034723026238083504752207040546085284750373070506080407070722027808030301
10007000202000700020007080006000500040006060000000200060308070706030002000604020601
13303825305040406886603020766020847738306020307622403587808060407030802750404670801
10007000302030600000606080000050500000508000800000700000006030800050705000500040701
10273060607020743850705038753780524260763555448740875024506070652686606040508060301
10800050005040000040002000000040400070800050000030005000603060408000208030502000801
10407745553060356078677770565040503070805080222040503780555080408020576060557557201
10300000500050007000000050300030002000402080700050300070200040007050000040006020001
10608620402474302835885030806573435588277030702856288075202082282088703753608060561
10704000303030002000005060300000005000003080200000000050006000007000200000300080001
10432030406060602050333080484626204066605027807227754620306883552830307820805586301
10300060407000303080500050008000505070002000207000000000303000004000503000508000801
10506623508342757080803460407070308020236320748076753633855083304044467087502050201
10500000200060000060400050600030800020200000800030000060003000800020002020507080001
10537540528080804024765040564080806460704086802050262020602080407460505030506040621
10000020006000202070000030008050508070008060007030008000706030300070500060005030001
18344057206644205060454433203580403057262720703024603387406440422020274363548084801
10004080002000004050002000705000300080007000304000700000607000700070300000003040201
10704030868735578025607650206055238330203052734453607330703050208420305455207080501
10604020200000004000800000205000000080402000400000700030200070700080808000703030201
10478020266785204750603372207658202050307070707540465620433775823060508077405020401
10003040002000002030600000200000302000602020500080000000500000005070005080002080001
10407082304064223040728355762760222682207060643055873825344728302075774080444024601
10808000405020000080000000000020000040004080008060000000000000203000000050003000701
10408330702020308374637542874080777030572748225020585445386370204675328722803560681
10200040700040500000000000800040600070000000800040400000006000600000000000400040001
10487060764430632730824380806364708088277450306220304882708046843858408260875024501
10005000400060000040000040200000404070000040200000308000308020000000700050000020001
10507388408080282052387050674070807070606050472038206080305063707220306072353280651
10402000004060002000008060005060802050207030007020004020203000500080306000000080001
10502043335076258053502258205630804820243056208520465057504060842370408878638026801
10500040300030006000807000207000200000200080803000300020005020000080400040006060301
10262340607870803248508020753050642623503270508050506430762070738020505080274040801
10200000200000200040004030000070008000003000800020500030306070004080604000600040201
14405046237646562030283070256540876065275040464680706070306050785060806748504270801
10007000000040008030700020000080600060000050600000503000500050500060406000700000801
10807824422073303030504033324030807730306630508527388657883080305670605040703667501
10200000003000005040802000700050500000406000800060000000003030300000307080700070801
10262388362057855080807453207525466654702067636570605567202050282728528050678060401
10000000002000300040005000004000700080003040003000804000008050400070500070002000301
10656253406462606057678044884560308070222060503056704075428030305080708888208868701
10003000400060008030008000000060603020200020307000603000600020007000200020007000301
10702040736030302070805378687080402630204650304820375860665475262426554060776080301
10400030002000304000500000002000200000200000600030000060000000000000000040000060001
11111111111111111111111111111111111111111111111111111111111111111111111111111111111
