11111111111111111111111111111111111111111111111111111111111111111111111111111111111
10000000008000000000000000007000000000500000000000000000000000005000000000000080001
17607034802083484857803680457045804030805022687035775376668465605080678630557050301
10305050004000000000800020000050005060603000006000700000000000702050300060007030801
10606350763564824220704040675760366270204256808050607062626280604080303038702740801
10200020000000000000708060003000200000800030007020003040006020600020503000800030201
10455080806437628628427060207077204424848280485060447380808020752387707030305050701
10300050707000000000800070402000806000005000200070400000600080300000602070504000601
10703380826057242540308020207240832050502032607582703032628020305370203570706872601
10300070007040000000807050208030000020600040300000008080007080202000603000700000201
10622040507070724643802070504038783860523340505024827083207060302084306046823460801
10000080600030002000003070300040006000500000604000007000007030705000004020007000501
10465450305858528040352040523355504043805264807035608242404050602026557070206720801
10005000500000200040300030000000005000807000308000300000603040002000007000200030801
13807033884245706778303034675724427030604270506670856250405082653670302753625080701
10007070000000307080006000800000003040008000200030000040805000000060600000500070801
10285030687550605030402820406638607248502057505084207030658252832073757720308325501
10500070800060502000404060400060006000308000502000307040200000500040004000300060001
10204070205080508078604080262080847080866280743620805070202660302050203024467050771
10707040403080007000300040003080005040000030008000507080600080404020500060004060001
10507050803085868666202762208070506388625028203048606020782040708070333620504057401
10508040007070005000204000200020200000003080700040007040705050002080000000504000601
10306668688040703080805060877020348584705030207670868050604044246268644036327650701
10200000006000708050300020005020006000404080400020800050007000000030002030002040201
10778633646344208060876640808543408030802060634070408663727486874070307330702050501
10000000700000002060500020500020002080300020003080400060000050000030205000506070501
18727070503558668060207080588040833070786587607030807080328080203520508038603030301
10003060400000007080004060403070000040000000503040705020400030700050207000708000601
18307760505826403070547020806030834086535740303080402080303420725830202460802340801
10006000508000800080002030303070008000000020007060405000808000800080700040800020301
10303084826070538768805030804060503574846348533880237256308025707020702030675032401
10303000000070006000006040002040408000300000000000800070002030004000402080003000001
10802875853666403084628060766022803060605052867663605060466070377628257070606068651
10400000200020004050000080800050006040008000006000403000402030008000002030807000001
10353322202020482050507480406270357084738756702060507346408028408057503048406063801
10300060007000400030500080805020500060000000303080200000008000408000408000003000401
10405050204284407420308760208040605766565620563040406647836030205260603522553040501
10007000407000003000505000607000204000000030000040400070005030508000800030003020401
10632066405062457067738085407828506040336062863730626070608040506050446076604070601
10002000402000800050003040007000200070005040000000400070305020608080008000708040801
18408738506060704238607020426030878284503070703252502733703080807040804230408740301
10008000304050400000708040000050400000202000800000500000002080800040304000300080701
10383050404060855670405076542280357230725486735830873027406080247432606080303060601
10700050003050000040005000000070500030300050000060002000302070207000404050403000601
10702243678070887035737650777030605070403030375080707270663060703050788070435458301
10200000500030006000000020600060007000307080300070700070200050003060000040004060001
10606720603475508385786050304235437436666070203766827047602038447085206667502070771
10203000508030004000003080400000006000007020700000000040003000002000700000500070001
10752040308020602080872070427743703042404083607343284570806834848230207470406667401
10300030506000807020400020006000805080004000304000000000207000003000704000705000801
10403847606824246020502440203040705080565460643063535264665036506042765023602060701
10300000800080000030700050300030200040200000700020000040002000500020002070305070001
10533380433030606028422060854020706450202072408060577040707040604630606030403040681
10000040006000408040000030002070408040003080006080007000706040400060800070002050001
14227034407232203070868876508850408068584360504026606863405430463020588767527062401
10006060008000004060003000603000500030008000506000300000703000600030600000003060801
10703050256834485062406270404073686370408028867628403560405020402620707657208070401
10704050200000008000500000408000000070606000300000500020200070600020304000206050801
10337050786256705250402548706568702030402030602850874320488557824020708057206060301
10002030002000007040200000400000203000306040200070000000600000004080003020002030001
10805074805086522060574573652640226832308070634045253635465835504024425020787078701
10604000404060000050000000000030000070006020005040000000000000706000000050008000701
10402830602070406383458335734030877050767628537060488635223340306447336767806450831
10400040600070300000000000600070500040000000200060500000002000300000000000400070001
10268080826630725630484740302738504043237820506460502845708036657425403560857036501
10004000600080000070000060600000503050000060700000203000404070000000500060000020001
10808543808020682058666070333040508050203020455027603070208062508260706077864470821
10703000008020002000002020004060307040206030003050006060208000300050203000000070001
10208052254088837047803845607270603330747022702440575067603080537530707735234085701
10500030300050008000402000804000300000300060305000400080004040000030300020008040401
10884440207320702367302050363070624868803460403050308420874060342040506070664070701
10500000200000500080006030000080005000006000800050200080706070004030502000700060701
16804045883464743040472070838540263032754070446440507020206080675030202865303450501
10002000000040007070300030000050500030000030400000802000600070600060606000500000401
10803442374022602060808038482030804780408530303283874842656060205420602070303258801
10300000007000005050505000600080200000706000200080000000003060700000503060300050801
10678233847024443050407635703844822453502052444250708364708040833558532040427020501
10000000002000700020004000007000300050003080005000403000005020400050500050004000601
10776424606245505055567078545430206070387030805054307067736040205040503454504347501
10007000300030003020004000000050204020800050703000302000800070002000300050007000301
10404050483070802060507554878080406330806720304780878860886547286842857020483020201
10200080003000804000200000004000200000400000300050000020000000000000000050000020001
11111111111111111111111111111111111111111111111111111111111111111111111111111111111
