11111111111111111111111111111111111111111111111111111111111111111111111111111111111
10000000004000000000000000005000000000600000000000000000000000002000000000000080001
16507024707024783257704470647086407040405038224067648523488745702030656220276050501
10308030008000000000600050000020008030306000005000400000000000402080400060006020701
10807540556365784760504020566620678480608748305070204085377340506060704074806670201
10200060000000000000607030002000200000300040003040004050003040700020607000700070701
10684080505452638374333060308043207652468360674020233470502060538448503020307080401
10800060806000000000700050602000208000006000600030800000400060300000207020804000401
10805640483084867250306070707650855020502062306566203066448020205630706430305538301
10300070005050000000507040202080000030600040600000008020004070308000202000300000601
10256080407020878653405040706054773740466260507046356043702020303054203082856660601
10000060400040008000004050800050005000600000507000007000004070702000003080005000301
10667440305566442030653040847782302054306382803052505877206050704043853020603270801
10005000500000300030300080000000008000606000702000500000404050003000005000200020701
13608088537568708648206037356825256040403370602550867850302025865830604654376040401
10008030000000805050006000700000003080005000600070000030404000000030300000500060801
10746040433820207040306720404843805565807063704077608070875363336054554450703547801
10600030700030203000203070200050008000604000802000706050300000200020008000700030001
10806030608070403076702050458060463030534320286820603030703230704060202074764020231
10207070804040004000500030006070008050000020005000506040600080204020400030008080001
10808050405076484354705842703080503686467084405032705030552060305030557780803076701
10808030005050004000604000800050500000006040400020006030207050008050000000204000501
10207852532070408040708030446050423454808050406850862040304052367724562033844880201
10700000008000307050700060007060008000804050800050400040007000000060008050007040601
10386782452626305050258470606277406040202040852050708334432682468030708240307040501
10000000400000006040800040600020005040400050004060700070000040000060203000502080501
17237070803285368060404070853040266040346672508020303060272040605370502068702050801
10004070200000002040004030308060000080000000206060504070200050300040204000506000201
16604540303355507020562070306040452058346420206060804020603630378540607520405620201
10002000507000700070008050802040006000000020003040804000605000700030300050300030501
10706045782030222728408070208070304535548653555770823388507043408040503050363066501
10205000000060006000004030004060206000400000000000400050006080005000508050006000001
10306847437558707035562030566085606070303076762745602020525080486738475050405084761
10500000300050003080000040700030007020003000004000705000505020002000004060603000001
10727626208020434080707370205820733025758822504060502554302086306086702045304054201
10300050005000200030400050806040600030000000208050600000008000603000502000006000801
10304050607388608570802720603040305756352360483050706678282030406760407228375080501
10005000603000008000608000604000305000000060000020300020008070403000500050003020501
10747083205043586028626075505434306030555052863720345070407070304020267075705040501
10004000604000500020002040003000600060002030000000700030205040307020004000503030701
13202752603040504775706070562050852482703080706546507224508060706080204650807740401
10005000702070800000203050000070300000702000700000500000005040500040504000800040701
10435030408080322340607077635350845640685334488660877027602020775874204080706070201
10500020004020000070007000000030200070500060000070006000603050603000206030807000201
10604352267060252026582520625060705070308060543060607750883050606070474030872325801
10400000500030004000000030700040004000802020600040600080400060003060000070008070001
10406580708346703352262040304472858576332030502267232042402047278083408665803020471
10203000504040003000008040400000008000002050600000000060004000002000200000200050001
10448080202020307020364030734778302046708052305234632330302555762380307330404427501
10500020408000308030700050005000207050005000503000000000604000002000706000205000501
10806435504228225040503850204070707020224780542048237648475077703028563084402070701
10800000300020000050500080500030600040500000800070000060004000500070006080407030001
10772820777040202022855070786050403760702072405020888020702080408340607040202080451
10000030004000704070000020003020508030008040006020004000208040700080300060006020001
13362075202646408080785222206680702077575660807063604637402880274050583266623038601
10003040005000008060005000204000200070002000705000800000605000500080600000004060301
10805030667467684076707480306066654320405035884383302680504030208740404827802070201
10702060300000003000200000808000000020602000400000700040500020200030705000806080701
10638080844822505820406342608784302030508080506630238330282464564050705075302080801
10006030004000005060500000400000704000405030800060000000700000006030006080003080001
10202062308085236060567278355680372488604040584028358584835846408072262080426027201
10508000606020000020000000000060000070005030003030000000000000406000000050008000301
10407550203030808244233454866060443080278472537030343647232240202468332834406240531
10500040300070300000000000700070700080000000600070500000002000200000000000700030001
10474060542260325320638670608678603044228480705670407436504083472754503520224088701
10006000700030000080000030400000703030000040400000605000705070000000800040000060001
10702562305070738033825070786070606030806040422042806020703046506540407075664660331
10804000006080003000005080003080408080508020005020008040502000700030307000000070001
10303025764067544036206424506870805560637037503750684086804050247850302562548057801
10500040200050004000706000202000300000600070707000400040002040000050800080008020701
10654820205520703385807020487060463882304620803040307530725050578030203040834020301
10700000300000800050002080000070002000005000300030400030205020005040607000600050501
18502076543325636040474040356830828074845080322870206030802080234050707527707470401
10002000000020004040500080000020300070000050200000704000300060600040208000300000201
10202822855042602020606065445080402680808430806634262264425040607660708020204437601
10300000003000006020205000800070400000706000300070000000006040200000303070500060301
10422878628024642050405846202672738238608058537870304857508030846758528080558060501
10000000005000500020005000003000800070005070004000704000003050300040300080003000601
10262476303584203035867083845450508050772030708074808033726080705080402633506665301
10006000800020007050006000000050302080500040702000508000500040004000800080006000801
10603060365060808080408654485060605350806260202450725670827775824736856070377080201
10700060005000406000200000007000200000300000400080000020000000000000000040000060001
11111111111111111111111111111111111111111111111111111111111111111111111111111111111
