11111111111111111111111111111111111111111111111111111111111111111111111111111111111
10000000002000000000000000002000000000600000000000000000000000006000000000000060001
17504074702078427662407630658073206070708086682037674276487344302040683750752020701
10803070004000000000400060000030002080408000004000400000000000503050500060008020201
10306420584265553820406020826260532370404855703060405055465860303030806054504340501
10300070000000000000208030005000700000800050002060008080005040400050302000700040201
10353070406268765474375040408073404877845620825070224350305050732776806050705060201
10300040605000000000200020402000702000004000200050300000500060300000707040808000401
10607530833084632240402050405680467030202033508653503053674070402280405360305386401
10400060002040000000708060807030000070700080300000008030006070806000205000400000301
10822060306060433366602080706048765880764760404084243088605050607062402045665470301
10000070400040006000004060700070007000400000202000003000005070207000005030002000701
10665770407223272030836070846258305043207428207064602554706020606052226050307270601
10006000800000600060200040000000006000604000602000600000603040006000002000200080601
14804056377284607885508072353646826040405220404450588630706057843570808255583040401
10007020000000303070007000400000003040003000800050000060607000000040700000400070701
10755030227850502020407650602482507743402038405038605020583876628066338770703537301
10200070700050306000705050700030004000703000808000507050300000200080003000500050001
10202020303080705038302080246060322050363880274580604070408880608020807065636070621
10507020505030004000600070002020003070000050007000708030400050807020800030005070001
10705040507065334425708823607070608875428025805065307080532040307020365620308024701
10306050008050008000207000800070400000004060300070005080404080003030000000507000301
10602486346040202050805070264020336564404030404460848060703053645758366088264370701
10800000002000706060400030006020003000407050200070500020003000000050002030003020701
10858842275747302080237440502758502020708070642020304787576586885060308320307030201
10000000800000004030200030600060002050800030002070400050000060000030407000603020201
17675030404873436060404030856050248030443535808080406030565060304650504046702020201
10005070600000004030004020206020000050000000808040808030500050400070206000405000201
16602430302777306030883060404070425034757820802020807070305750783440803820307370501
10007000807000300020002030703050008000000060008020808000204000600060500050500020501
10307032868030566458606050506020203753687625324360486748303025206020807070574086301
10703000000080006000003040002060208000400000000000400020008020008000204030002000001
10705425684846303052264070222032502030406054262676302070852070726685474050405062231
10600000700080007070000060700030006030006000003000804000704030003000008070507000001
10562757402020466080404680404530224028525822603060408434205055303042305024607056201
10700080008000600050700020704060600050000000506070300000004000305000503000007000801
10802070502853206570308560804060202482347770655060706248466060206240407875663060201
10006000205000005000203000208000707000000060000040200020003070605000800080003020301
10626088407074388074236078505775308060583062532240584050502080806020524037308020501
10006000502000400080003080004000400020002050000000400040604060808060008000306080401
13203483306020804686203060425050526857803070302386603342207040803060306870408680301
10006000604020700000405030000020500000206000200000600000004080400040708000300050701
10582030203070223680606072253350857820755288852760722025404070232757506080505040601
10200080003040000060002000000060700070800020000030007000603080606000304030706000201
10804365574060623083873450876030402060407080776040508370822040205070842070864834801
10400000300040004000000040800070003000505060700020300080700040008080000080004070001
10208720805725202442754080603822577826648040604265748078807027256047306778502060331
10805000802050008000003020800000002000008070300000000070008000005000700000500050001
10223020506050208040454050647447707054505082404683642640308684463570807450205256801
10600070505000805040700030006000304060005000508000000000408000008000402000503000801
10707885803782668060302460502060704050388450536052422572554055707068432057706050301
10600000600080000020200060200080800080500000400030000080003000300030002030602060001
10833840666030507038727060254040408450208022507020423070708050308560807060207060431
10000050007000506040000050006020703040005040007050008000705040600040600080004020001
12385055602824703020626425305570308047862880202086403546403480454070265847555036501
10003060008000002050008000407000500080004000607000700000403000800030700000004020601
10405060744524545055406350405086453760808053434286303330503060406680403734206020701
10804080300000003000800000506000000050607000500000700040700080300050808000606060301
10734070772563802350608566706745404050602030802530537650527356437060306047505070401
10004050007000008020400000800000706000807060500050000000500000006050007050008030001
10202077708022252060227483576760868428703040555036478322436726503085665020254084801
10602000602080000050000000000050000070007020003080000000000000205000000070002000201
10302820505020708722883653688070243040857886367070765673674650408842344636207260571
10600080500020600000000000500070600070000000700070600000004000500000000000700070001
10232030824440363230872380205754703035876650405770507225506033232378605560872086301
10005000500030000070000080400000708040000030400000303000406040000000700070000060001
10204248304020262072453070664060705060803070427055806030206082408540606076722820561
10503000004070008000008020004040208060705060005020003020808000300080604000000030001
10505075655035562065603376704530808420245043408680332057704070634450508422783036501
10600070700050006000303000407000800000700050204000800070007040000070300060002060401
10286580804640605858404070287020884253807330806080604760773030736060802030632050301
10800000600000200080004030000040003000008000400040800040802040002020505000800030301
18803068427326474040642040766650524035582020246340303070408080225080808635206630701
10005000000060003080600050000040800080000050700000808000600070400080305000700000701
10302744286054707040302074487040708340304640704725654332648070803580303080803373601
10800000003000002030807000800030200000604000800050000000007080400000403040600020401
10577835755062637050807845606242754623505044732470302627605030624777725070643050501
10000000007000400080007000005000700080008030006000803000007060800030600080006000201
10388576507622408045462072827730602060565030505064402086336050702020404748404343401
10004000800070004050004000000030807060800060207000303000600060004000600030007000601
10508030333040703060306662538070508270504840705760866860838254534235747080837040501
10600080006000303000400000003000800000200000600080000020000000000000000050000050001
11111111111111111111111111111111111111111111111111111111111111111111111111111111111
