11111111111111111111111111111111111111111111111111111111111111111111111111111111111
10000000006000000000000000007000000000800000000000000000000000003000000000000030001
16507026206085546483702440676044306020608058652033232782426786305080258580485030201
10802020003000000000400040000020005080306000008000800000000000303030200080006030701
10804550888855374430704040482660345770408534703030804087643630203070306054807630501
10200050000000000000608060008000800000700070007070005070008050500080702000400040201
10273070203743278333725060308035405355262760473030233850702070252348503030808050201
10700070702000000000700080702000608000002000200030700000600030200000603020306000701
10506640543088475820405030502650857020804032304883806036825050403760706450608733301
10600040004040000000308080404020000040600050300000002020007070202000708000800000801
10263060208040233228502020705065358680553520503062853087505060702022804052752570701
10000040700050003000007070400060003000700000407000007000007030702000002050005000301
10387320803732775070526080485865205062607462803028207786705020207085335050402550701
10005000800000400070500050000000005000507000606000300000806080004000005000200020701
17607044776236605863503043672784472050704570802640653830204038527630702735872030501
10002080000000303060007000600000007060005000700020000080203000000040700000200050801
10328020876340406020506730707235405573807025604077303030554637487034654730508747601
10700040400060403000202050400060002000604000207000604030500000200030004000600050001
10306070603040604074604060272030322060824620372520808070605340704040402043683060531
10402020305070003000400070004060004030000060003000503080400080505070400060002020001
10406050305035236742608352807070502634358026604075508030244040705080754680804073501
10508020007050003000202000600040400000008030300040004040808020006050000000208000601
10708438662070603030305050257020287386606080807640548070403087586545282042827650401
10200000006000808050600040006070003000608020600070600070006000000020004070007040401
10452754854448503050388520507664208050707070635060306737532887643050402360708020601
10000000500000002070700020700030003060700080003080400070000020000050803000706050401
12473020505552655070304020636060465020755444307020705060686030707720508062306060601
10002030400000006030007020405030000030000000505060207040400060500080406000208000401
12404560507367306070563020702030827025456550703080805030505880765770403450804320501
10002000506000300070003030505040008000000040004040708000505000400080200080600060201
10204028355030276422405040604070804286534768858540676674306072802020502040286084301
10707000000030005000003040008070404000700000000000800020008080007000302040005000001
10405328284262606086427020772067208060307036528558207040453070674277254020303072351
10200000400050004060000070800030007080006000004000808000403040004000006030704000001
10884283502050523060307540308340468023284457405060708684803032608053805037206058401
10300050007000600070300070506080500070000000302070200000003000306000706000008000601
10208060603448208480707660708040705742776480473030704646386050506270706263574050601
10007000603000003000202000506000206000000020000040500030004030502000200050008060401
10354048304074464035582085402846504030748087622670356030208050507020784088404050301
10004000403000600040003080006000800020003070000000500040404060803030003000302070801
16808535603050806868808080243060572684205020707458202224704060302070305220403360601
10007000204070800000806080000080600000507000700000800000003060600060806000600070501
10268050808080632230504068632540862530435225267370244062605060322362307060208060301
10400060002040000050004000000070200040600070000070008000807070504000302030407000201
10202644855050458034648250732070307050706020678040807570423040303040668050542685201
10400000500030005000000080500040004000608040800070700060700070003020000070008030001
10408550304273506754856070805328557567522070404444648047804027357054807548206060261
10508000207060008000008070500000006000008080200000000070006000005000200000400070001
10724030202020608060825030287756605032306084603773357240504658583760706270603533401
10500070404000806060800040005000402070002000705000000000805000008000203000602000401
10708288504336683040404540505040606060266880385036358363388074703055785078306020601
10200000200030000030400070200070200070200000300040000070005000500030004080505030001
10752570323080303025756030875060707680308057704020244050402060408280502070707020451
10000060003000705020000050003040608060004060006060003000205040200040700080008050001
12632027606755707050774442804330804062558850607063508635305630375020387426866084201
10004070004000008030006000403000400030006000706000400000706000500040300000004070201
10208070433443665066403550305026522560807088368288804750302060308260506577602030501
10505020800000005000700000502000000040202000500000400040200050400050606000805020401
10878080323256306420608338704678407080305040503220387660638857732050705024702050501
10002050008000008050600000300000803000602060400050000000800000008050004060005080001
10705074804086642070256428884660633424703080742048567373853336504086465030857023801
10703000705070000040000000000050000050008060007050000000000000606000000070006000501
10508620403040406778578434452050535020556845736040638486387470807437762467208280461
10800020500030500000000000200080200070000000600060600000004000600000000000600080001
10362020855720562320884480305874706022877530703450806565406066874267602730275046801
10003000200080000040000080700000806030000020700000602000304050000000800060000030001
10704258704080838074745050624040803070503070557056607030207072306250806068775850771
10606000005080004000005040002020305030204060004080002020503000300060803000000080001
10307027688042628037407428205520708240738056508350386038606050756270506328884046201
10500050200050004000605000702000400000200050208000600040004060000070800020006080601
10225850204250802728803030262070277523308470304040605220876040678030208040355050701
10800000700000400050008080000050004000007000300080400070705020004080508000300060801
15407053883583682060848070676540468046345050852370606020707040647040707854806480401
10004000000070008060500060000040300030000020400000204000800070700050304000800000601
10408232443048708070602058662020508450205380307574772742887050302480703030405887201
10600000007000007060606000400060600000308000600060000000007080400000604030800030701
10676443538058533020203363403353376526507047833680203628705080378764342050233060601
10000000003000200070006000007000300030003070008000507000006040600040700020006000701
10655322206567502084572045753430807040542020605033603077774060704080508448806645301
10002000400040002070007000000060507080500060502000303000400050008000800080007000201
10603070367040203050204866883070603440706240208250567260782445457537483070866050201
10600060004000608000300000007000300000600000600050000050000000000000000030000050001
11111111111111111111111111111111111111111111111111111111111111111111111111111111111
