11111111111111111111111111111111111111111111111111111111111111111111111111111111111
10000000000000500000000000000060000000007000000000000000600000000000000000000000001
13804826226570828330404537277033806043205220306046705730445020808387262374867637201
10002000000040000020700000006000203000200000604000503000500020408000000000000050001
10705625366050655080275377602240808220438838483760202088704330252040665463422020341
10406000200060406000200000600080607000500050002070403000002020008070000030007020001
10705040307060708343205050242040207057305055708030407353527050606065676640302070401
10600030008030004000003040204070008000005000805000400000700050800030000000200050701
10284026827280647040455030802058282360784860502544762780204735344450532877852030301
10007040000050500060007030007000000080000080703000000060800000000000200000003020601
10608460504023407088508053765352268030634020207080325030453484544458707573802670601
10600070204000007000503000000060000050005040003080003070006000200000606000600060701
10258060805678236230608233742580602644407043886038207087605020507450504050722068301
10007000306000000040500000008000600080007040000050707060002040003000506050008000001
14207882305030303053387648767033273050804040807520808070427020542087835070705277801
10008000200080607000006040002070600030508000600040002050004080008000006060800000801
10335780304560763022504060803050303640808563753366254050203030405637503030667670881
10000000300060005000700040600020007000300000000080000050202050500000700040000030001
10537565206074804284788250474230277020536736844020572366803065577820667488452370201
10000000808000400000008000300020700020500050300070000070003000200000800000000040301
10723570342860237338207064738020308564606030602382563030762540702647703748665078301
10000030300020700000002000000070700000005080006000005050000000803000804000300030001
18374830705050604056653666406336407660854048227058373070572256454080504060304230501
10000000803020503000000000307000600050005000008000006020000020006020007030700020601
10375744707060507467208270272050255028476750304667502046526070506087224050267020641
10800070007000400000700040700060006000000020800000805030000070404000000040800050001
16705070206722667230378630708752802053778076203250402085638240808644476224406024301
10004020605000000030000080407000003000007000207000705000000000400080005000005070001
10355020367068525086755087605030386272404780807025203873606225224080407050236040561
10006000600070005050006000808040000030005040506000705000800030005000800080005030001
10405577402030608060783780444035326030868030337820602020373054505024363884304032201
10400040005050700080000020005040000050400080000040007060400070002000000060007050501
10825040738070627558868030403070636870604726888055353470303430707842746080555070701
10606000200020000000000040607020800050005040008000000060700000202000000080008000401
10702728208057663856667840704020203022728080808045688040733837323077867780206845701
10700060206000000000000020200050004000004000806030002050002000000050000060300000401
10605030608035734624843040203027887750303583305040507034407372825840478030887360501
10402030005000004000006030405020000080700080007000306000800000000060800070000060701
10743020232267802028307050304040787035568040275672603360802446465060205063525030601
10000080005000707000600030503000400060000030000000606000400060000050703000007030301
10274723802072703070286570803553384480303633224750307044582680206835508237423070301
10800000306000007070003000700020000000800080000000804070000000408000005000300050401
10404560605353257688447034584020754374458280434468803050404423707034858050308830501
10006000504000600050006040003020300000000040005030007000500080707000004070200020801
10866032502020403070405060853030804076254068806050207220643040805852502047723040701
10007000400070404000600080007040005060003000006000400080508000205000203000002080501
10805680365240606244867454407068246650504823657722535080408060806080208768406040201
10200060600000300000500080003070000080600000700070003040207050208050500000200060301
10472030807366324220503020225070874050206270302050504030608085306060875570255060701
10005070308000300060702020000070005000508000608080800040308000807050000030008080701
16268070503050805030307025543334804024508053806050258870708550706052554036806040201
10007040204040006060607000500000203000804000404060500070003000503000708000604060301
10406050705070843740605820207550508670202860646040663054888387708260602030702630501
10400030605040004000205000303000808070804020008050003000000000400080503050200070401
10744880608085702053705022805065305040404020207038607785467780204070407050643030401
10700020704050002060005000002000006000505070700060300000000000204070406050006000501
10605060502062345050205258406384362338206050862660706538664275203040603042303257601
10804000808000004030800000600080002000002060000000200000002000002080704000700000401
10405873204347203030205370625060605084786042436340307566246063863040706873544070701
10507000705070002060302000800060405040004000800080407000004030300040300000002080801
10802370408020268070707075604840707080307760608050857038303050602330204344804060301
10608000700020000040405030008000208000400000705060600070006030800000800000702020201
10204054476582765860406086866030604554536747504074202820408050358882862820808770801
10500070003000000000706000000080700000000000302000007000408070000000004000800000401
10482720506080723578707354633467753746728550228658464050606086678652605084287523301
10000000600030200000600000800000400080000030000000008070307000000000504020007000301
10286553432740502840605880206570404080285063886340503070202343525370508057603040401
10000000000060602000300040006000408080800030000080400020200000003040005000003020001
10564560386830202022233027387070386040502880583028382850806686502080488635637082531
10000070007000204000005000500080800060500000500020000000800000508020000030000050001
10834087208052603835206583407668404830276450403250787558735640703075332050383620301
10003000202000803000300000200000308000300060804000400070000060400060000020000040301
16204620404260308070384730682680707050207046606084755030575580673460302478744087401
10008000500020806050000070000070703040306000508000008020200020008000400000006000001
10807065562070707063206062387040706024304520803043705060802074206058234340804882401
10603050006020008000806000008030003000200030006000608080708060002030000070500000501
10664064706055767860502465664063767780326045463550304060507040328050862087277070261
10002000708020000000606080000020008000400050002060306050603040400070500070004030001
17502840606080405854405080385240306050505376508040603080307050885860803860702042701
10002000506040200000400020000000802060700000006000600060003060008020700000808060001
10746063205030503650262875546677502080256646385676837757386054504050507627203850301
10004000004000600070000000000000700040000000000000000000002000003000500000500000701
11111111111111111111111111111111111111111111111111111111111111111111111111111111111
