11111111111111111111111111111111111111111111111111111111111111111111111111111111111
10000000005000000000000000007000000000400000000000000000000000008000000000000050001
17805076803087663227704670722045204060605047767026825268763288707030486750723020301
10503080002000000000800030000030004040806000005000200000000000708040600040008050701
10404370433826322770402040874480858220304848504030208036522570506050303088802550801
10300050000000000000202080004000700000300020007070007020005040600060703000800060701
10272030202834343754463050604038703472346580475020467840404020777845203070208030501
10200070808000000000400080204000208000007000400060300000300070200000208030403000401
10605640242086853760602030305450666030606032708346704047242070804270406850503736301
10700040004040000000304050702040000050400020200000002060007030207000405000200000501
10734060504020675558302070308045843450235720605063547032507050703078707088766340401
10000050500050007000005070500020002000700000508000006000006040507000002070008000701
10336620407754474050775070543585406068502738503088707323606070303076772040702360301
10002000800000500020500060000000006000807000405000400000402080005000003000400050801
15802077277824702872203027228553422080507570803270673380607058388650506378427030501
10008070000000508070003000600000003060006000700040000070204000000050300000400070501
10333060632460202070204280208235602437703073607026604020775583454055525750607257701
10800080200060207000502020600030008000605000507000203030300000600040005000200020001
10405040703060507072802080832040266060553380862750308040404660305070207044553070251
10802020402020004000700040004030006030000060003000508060500030303070200080008050001
10806050705084844564702784407080805847473067404064703080868050502080528580406034801
10804040003040004000808000600060800000006050200060004030504070007040000000304000701
10805725373040707020805060447030227563308080408840628040702036844774577027224580501
10800000007000808020700080004050006000404020400030600070005000000050008040005040301
10855848832245504050367620206655408070205070524030804854844854636050308870504030401
10000000700000004030300030700080003020700040007030200080000070000030503000504050501
15473050804273263040206040774060285020733472502050202050645040204540602034205040501
10005030200000003050003070704050000070000000205060404040500020600060403000605000801
16608470302442805080638060505040354076888880405060406060504540657750303330807320401
10002000705000500040002020408050004000000070008030404000202000400060200030500020501
10605052865070687757204080606040607682234833383220543432303024206040303060577047401
10208000000070004000005080006080704000600000000000500080002020002000405070005000001
10303653248574702077856050273074803080605088533444703070462030635253385020407088321
10500000700020007070000080800070007020003000003000608000306070002000006050207000001
10656232503040466080508530502220487088265367506060705683606076802046507055405026801
10500050002000500080200060505060200050000000608030600000002000404000402000005000201
10802060705885207550608860708050705742454660372020206846656020703320302256287060501
10007000603000008000306000508000506000000030000050800030002050206000800080005060201
10332085803078226057848072506757604020243036432620284060602060207040776088603050201
10006000305000600060005030006000400070008050000000800070705040803070006000305070701
12502878305070205483308060455050868868805030707538203823206070307030308530506480201
10008000503070700000508060000050600000207000700000500000005040400050604000300030201
10368050206050445230404087747820747780728537733320267023303020247862302030205060501
10600080003060000030003000000030500070500030000050007000705040507000602040607000801
10705375542040873022522750243040504060703030278070302380778080502060535020734478301
10200000800040002000000080500050003000405080600080700070600080003080000050002030001
10803840207523405737575020604843365877342060402267233064708063858058808658708030571
10806000808080005000006040500000006000003030800000000020002000002000600000400040001
10854070807070506040783040644473707063304085403754224730705757364360403420707482601
10400060804000307060600040002000407020007000406000000000208000007000606000302000601
10602686304273574060807760807060406020224460245062476738383068305066375042306080301
10300000800070000060200050400020400020500000500070000060003000700060005020404060001
10225270768040504032756060382060804240806026404060647050208030603630206030202060861
10000020003000805040000070003080203070007050005070004000705080500020500070008080001
15654073203483604060782435607360507067253730507067702638605830664060285232433024701
10003080007000003080008000203000700030004000504000800000306000600040400000005060801
10204030747535482023705820203088344230805023436283406280608060303820405348302080601
10705080200000007000600000304000000030608000500000400040500050500080306000603070501
10236030854672702730805457508526604040305040308830634740427367567020706077607070301
10002030006000004080300000300000603000707050800040000000800000006060008030003050001
10207025703076533020866463263860364524605060853034327322255824606058625050876062801
10507000505030000040000000000050000080002050005030000000000000302000000020002000601
10602560303080403662567863474060245070466283334070758774762440807765847273504250681
10200080500050200000000000400020800070000000300040500000008000200000000000500020001
10223070382320578540555380304884608037763740403620707838306062533422204650684044301
10006000300080000040000070700000702080000060500000203000208040000000700040000020001
10708237303080664046747060335040205020203060346022307030307034404270704025464630621
10207000005020007000004060004030507070202070007050003040708000500080607000000020001
10708057377087332028606542507540808580742033403630353035203050423440807625637037401
10200080300020008000206000604000600000300070205000600060008030000020700020003060401
10233640208870308626208080435070247256807250602070502760244070383030402050444040301
10500000800000400020002030000080003000007000200080300050504080002040308000500070701
16406035624754587040322080662540677027832080444220805020507060734070804684508240401
10005000000060007060400070000070200060000020500000508000300050600030808000600000601
10505838634074406080508054538020306840608470503767333367843050707540403080403378601
10300000002000007070203000300040600000407000600050000000006030600000407050300070601
10322248343076642070208335507254563636402033476780204525406030487323325050855040601
10000000008000300050002000007000500050007070006000803000007020500070600020007000501
10768667806873604038842052528850303070452060406078505074274080802050807857706682301
10005000800060002060004000000070308040700020507000306000400050005000300020002000701
10503060272060704060605728874030706450203370803580246670486834568388352060757020401
10600040003000307000300000002000300000300000400040000050000000000000000030000060001
11111111111111111111111111111111111111111111111111111111111111111111111111111111111
