11111111111111111111111111111111111111111111111111111111111111111111111111111111111
10000000005000000000000000002000000000700000000000000000000000006000000000000080001
14605083407038735878508760364066507080705083323028357764544442202050668540665060401
10303060004000000000800070000070004040404000005000300000000000208080500020002060401
10604730834437346580702040384770888530303563804080602035642650508040308054307370401
10500050000000000000402040003000300000600050002050008030008050300040708000300080301
10362020602486222685857050507033603565434350532020462520608040457867808030607030601
10800070806000000000700070803000707000003000800020200000600030700000508040303000801
10802880824037742730706080502420626020707082802477804063653020704370805830303332301
10700040007050000000308020406050000060500050200000007030007050404000707000600000701
10746030807080456883503060804047772270327530604082458062808020202022403023576320501
10000080400070008000006050500050005000700000804000007000006020402000005050007000301
10233880504863868060428040757688508075603254203055404474807030507085532070302350601
10002000200000800060600060000000008000302000605000300000507070003000006000500080801
14403044465256302356206046884244772020708480802320435230803057686240703735743040801
10007080000000707020004000200000002040004000800060000080203000000050500000700020701
10776080238660308050705260708855203822606048708042706020362477638058825320807722801
10800030500030804000206060300040007000407000402000806070200000300030004000800030001
10506020702070605067708070626080367070377760256670606040503520608030307078558070741
10508080504060004000500020008050005050000080008000204070500020202080500040007040001
10504080604062565567806477405030207277256082302044702080442040203020464650403048201
10202070005070008000805000300080600000008020600080006070503030004030000000307000301
10503356236080504080504060366060275558207060207560222040305046848345824036533360601
10200000007000806040700030007030006000706070400050800080002000000050008070006040501
10758553735733505070663720705345805070306020432070302833376848374060506550302080601
10000000500000007040600080800060006060500080002070600030000050000040703000702070401
18267030604537488060705020548070334080744744805050703050254060608350203045808050301
10007030800000008020004030704080000040000000204070305080400050200050507000407000601
13204850807633806020583050408020243025383260806070504050606620833860705670303230601
10002000507000800060002060803040008000000060005080504000202000600030800060200050401
10602038464080647684706060308060403468635288525820524264208057807020405050782083301
10305000000080003000007040004030304000800000000000800070006030007000205030002000001
10308384554332402035486040362068604060306056323787807050836030533742436040708045431
10200000800070008040000030200040002020008000003000205000208060007000008020606000001
10425384502020656020202520607380655055222565304080206566807038705052607078203048501
10200060005000700030300040307060700050000000405070400000007000606000603000007000301
10702020803288604260302640705020206522222360754050404746863040408320302528354040201
10005000602000003000806000606000605000000080000050700040005050308000700060005040401
10855084203054742072234058708424804080722027578220626030604080602060232023805070401
10007000505000400020002070008000700080008070000000600060807070804080007000302060301
15708427808020204772304060488070756483507060202733207875305050505020605280702470501
10004000406040300000704020000070700000707000500000500000007080300070205000500070201
10866050404030333540707034284280833250372328472660848043807020654376308080502060601
10800080003080000040006000000030200030300020000020003000405060406000702060603000401
10202862564080678063485850468020405040703050822020204830755020607080685020873388801
10800000400070008000000080400070008000602080800060600030200040003070000080002050001
10407820806273606846365030705587466243437040405426575068206076586068605378704050421
10705000607050003000004020400000005000006080200000000060006000002000300000600070001
10228080705070404060768030762367608046608055204572683430602625472720603850602644401
10500050803000604030800050006000405070003000508000000000502000005000508000303000301
10704887705663837040808440206030206050672770545062346758766085304082822034606030401
10700000400040000020300050300050500080500000500030000050006000300080004060803020001
10264770586030204027538030652070402330708037706030734070407050408660706020308080751
10000080003000702050000070003050508080006040005080006000208030800040800070005050001
15664023605725406050672852403380408024374570503058207773304460444080764582827032201
10006020007000007070004000503000500040002000707000500000803000200050300000007070201
10204060776275285035307480603075686860302088722723606270203070604670208637207040401
10406080300000008000300000806000000020307000600000300080500030600040506000304080601
10583080464728602340802578707535608020302040706270354330875363842030307077604070401
10007020002000004070400000200000304000208080600030000000500000008060002020006070001
10204083303025248030822465484860347852704060852055642235478846208038245050427074301
10205000406080000050000000000040000080008040005030000000000000207000000060006000601
10406260404020207382624236673030568050465276756050334244672750304282337587404360461
10200070700060800000000000600070400080000000800060800000002000300000000000800020001
10358080263540248720346780206438404057748530504820506865704055836868204270372053301
10008000400020000080000080600000507060000050700000407000607050000000400040000020001
10508723203030577056655040252060603070208060754048506020604043504440708087735670571
10505000008070006000005060008060804060202040007020003060805000600020306000000020001
10406073477086624046505425704780706740437076407350523073402050444380702566622024601
10500080300020008000604000504000600000400060506000500020006030000040700070006060601
10546220702560204553308070835040654224407430804040803350885080773030704040783020401
10600000600000200030006070000030006000002000400050500080204030004020305000600030201
13308056836677262070542060326220232048282060877320606070305030746070303638406560801
10002000000040005040700050000060200050000080300000705000500080700020403000800000501
10408488786087804050303037237070204250703330407755686776474070706220305050705343501
10800000006000007070608000200050600000302000500020000000006040400000707080700050401
10488368742045744050407854804746475737707037668480202635406060386642375070534040501
10000000005000400060006000006000500030006060004000704000007040500040300050006000701
10452328808786303028645032828380706020836050606033807054554040806070503686205355201
10002000300070005080003000000030605050600070804000503000700070008000400060008000601
10605070754030503060807634657050405430505320808550586270568878234773567070842060401
10300030005000605000300000002000600000800000800080000080000000000000000050000040001
11111111111111111111111111111111111111111111111111111111111111111111111111111111111
