11111111111111111111111111111111111111111111111111111111111111111111111111111111111
10000000005000000000000000003000000000500000000000000000000000005000000000000030001
15302062303078225385206350662036702060502055452047886863265452208070467540224070801
10402060003000000000300020000080008040407000002000300000000000405050500060007080201
10202280334533832630803080337760768830608543202030804088785340806020706075208470601
10300070000000000000804040008000600000800060003030008020005060200050605000400050401
10438080803534434467643070606056708835383580737080672770306020688485705060203050301
10600050408000000000700080203000602000008000500060500000400060600000404020302000301
10405540742052884560504040806250523060308028507233403074345040205570606830606874601
10200020006080000000503040407050000080700040600000005050004030204000703000500000501
10635070804050534347607070307086552480234660507055376042806030603028305044436650701
10000050200080008000005030800050002000200000205000008000007070507000007040005000601
10234250208586268050325070456732504034502422806077308256802060202065825050602770401
10004000600000200060200040000000004000207000602000300000204030003000006000500040301
17708054385662805888503023527638364040502550202570644440202078244850202527436020801
10006050000000402020005000500000008060007000200080000060205000000070300000800060701
10474070226330705050307570303672802573206076402064708070843334445057633550607847701
10500020700080706000303070400030004000804000704000404040700000500040005000700030001
10304030402060506052406030535050343050376260573280504080202350204030405078886040721
10405030305070002000500070005070006020000060007000205080800060702070500080006070001
10707020408033466722604655207070207274662043203082502050444060603040645820604073301
10403080007040008000305000300050600000004080200030002060803050007030000000507000701
10505872827070607030208040326080384767504050207250235080503065647462642036564270301
10400000008000603060400060002070002000807040600050200050008000000020008070003050301
10556742237624206050273350803634807050407050486070406754265827266040408650706030201
10000000700000004040600050500080003040400060004070400040000060000050708000204040701
17644030304726753080704050272080353070457226405080606020245020303440408052706080201
10008060800000007020008080205030000050000000706050502030400050500070404000202000501
18808770205828303050566070503060665048238460502070405030303720682330205440307780401
10003000205000200060002040808050008000000050003060505000802000600050500020800050401
10508035748070387534708070203020303266256264524520232543305057305080305030574078701
10703000000050002000007050006030705000200000000000600050007060004000306080008000001
10708686846463405032824030652033405020704078525332405040257080256475564070606086671
10600000700050003060000030400020005070004000006000303000308030007000004020704000001
10582624503080838020606750305330844072775583508080603828802075605036506034406077201
10800020006000200060600050803050600020000000508030200000007000605000707000002000701
10303030304723805370804220605080603338756740325070707547357060303370703462255080701
10003000206000002000504000205000305000000020000050300080002040802000200020008080201
10725027706086286037238038807243704070624076644570878060403050303020877034607020701
10008000203000300070007040005000600060003080000000600050805020602080002000802020401
14705382703080603423306050382040234353206060304437508442307060208030206570508660701
10004000603080600000403080000050300000502000800000400000005080400070505000600030601
10747020803080676380406032645260257240764525688780634034502060864586403070402070301
10800080005020000050002000000020400080300060000050003000807070606000706040703000601
10607552535060773038246780886020202060503060634030607480536080502070877080726584601
10400000300070002000000060600030005000407060200060800080200040004070000030002020001
10205630308458805658462070802332434858724040605743588068804076673076602785403030321
10207000206040004000002070300000005000005030200000000070002000006000200000200060001
10486070704080707060468020785463607022706068806544848230403276756280502540707725501
10800050804000707050300080007000408050003000605000000000605000005000608000805000401
10407874205823584030805580302050704050648350622062823366742065508075655085704040501
10200000700080000030500030800060200020400000700060000030004000500040002080606030001
10427250636060806087842050332030708570307046602040783080407080308840807030206060461
10000070008000306050000040006040505060008070003070006000205080600050600080007070001
12323036305834805060448364305520207084768660605028503755506640775080346762837042701
10007050008000007040004000705000800060008000606000300000303000700040300000005050401
10702060748824727052403680405046858860607083356677502860404080704350705877404020701
10308060400000007000700000307000000080208000700000800050200050700020607000503050501
10323080234227402240508285303532302030402060303670422220682775252060508052606060601
10007060008000002050800000500000504000605050800050000000800000003040007040003020001
10207024704073356080865752388580227855302050647085335724824242706026826060336045401
10407000304020000080000000000050000080006040008030000000000000406000000030005000801
10504730807040702466226678786020534040535254573060635865662560805286826257503770741
10600080800070500000000000500080700050000000600050400000004000800000000000600030001
10522030846250326760255230404632502046568220608520608462305054864573302440822024501
10003000200030000040000080300000607020000040500000707000405060000000700070000040001
10307788704070853075623030867060504040802030755057603070507086502780608024772430621
10307000002060005000005060008050704040804030004070007060203000500080704000000020001
10202084864043844058308753508420304820333056203670534064802040566820306573224023701
10500020800020006000504000204000500000300020605000200070006050000070600050007040201
10232770803520806477602030678080435272804340804060203370252080224080403040285050401
10600000800000200060005020000040005000006000700050700080307050003060404000200030801
17803088368463555050882060264240726027748060735260806030702020373070305282605630701
10004000000060003040700080000020700070000030500000604000600080200070803000800000201
10308463443024703030505046676030708730203240506545258635443080804740807020503584501
10400000003000008070608000700030500000607000500070000000005080200000302070200050601
10238684377055245060207445208854743862706032336520203845606070456842528070264080801
10000000008000400020005000003000200020008030007000807000007040300070300070003000501
10552246705782802026484045446480204070873050308082708087782080505080307666702767501
10006000200020006030008000000070607020200050407000407000400030007000600030008000401
10207070367040206070802434243040806680408670505260757880244575456428757020768050401
10200060008000405000700000004000400000500000300080000030000000000000000030000060001
11111111111111111111111111111111111111111111111111111111111111111111111111111111111
