11111111111111111111111111111111111111111111111111111111111111111111111111111111111
10000000005000000000000000004000000000400000000000000000000000008000000000000020001
18608046204084464752804360684027305040806066262085777337245873203060556560774080801
10603060006000000000800040000070005020607000004000300000000000406060200080006060801
10602530337885638850608080854520546450605582406080205073588740607030406046504360801
10200050000000000000206060005000600000200030005050003020003040400030707000500040201
10668080703577433823376080806042602552274730337070647340604060676233307040407080601
10400080302000000000800050805000205000002000200080500000800050500000406060307000401
10605830787047334270606020802850687080208052207674402083422070405750705460402455701
10700020008080000000403050804030000030400050800000004040007030208000706000600000401
10426080402050544443503050705042337220865380505048848045807070504026405026572650601
10000030400050004000002040600040007000700000806000003000004050705000005060002000801
10864370706626738050554020627828206082407345602038608445406080605053776060803570801
10003000400000400080300050000000005000204000707000800000403030006000002000700080501
15203037384448303233705043788836875050408830502760825470404067785240307334433060201
10007050000000608050004000500000002030006000800030000060406000000050800000800040301
10743060835530302030807380302272604255305065808035407020327457763062457720808847401
10500040700040603000202060600050004000207000208000304030800000600050008000400060001
10702080402020802034202040552040342060483830667380705030207570303080303035648050881
10308060705030008000200020002020008080000020005000402030400040305040800020007050001
10202070707074586355307443403050607742248055207048305080644030504080384660204086401
10804030008040007000207000200020700000007050400060004070602070004070000000506000401
10705224485030806040504050845040536758808080703260772040707082827782857025784770201
10400000005000805030200020005080008000203070300060600070008000000050002040002080601
10278445835663808060738780208588808040702020453040403877366772734030307470206030201
10000000700000007070800020500040005070800040004020800020000020000020407000207070601
12345070405545545060303070675050353030525873403020405030562070603660802074706040401
10005080800000002070007060808050000040000000806080706060500080400070808000602000201
12608720304733702020584060207040683028232760807070203060602630452260403820502430301
10005000704000700020003080204040006000000030003080606000602000200030300070800080401
10802063335070427377706040802070605685838828464260427483806072706070603060663086301
10707000000060003000002070006080605000600000000000500060005080005000608030005000001
10706446878542508083847030457064805070606043455324708030355070646456345080508068331
10400000400070006070000070200050003040002000008000303000702080008000003060303000001
10722588305080574050203340603370633065834886208030703865706054206032407045803076201
10500040003000600080600020603070500040000000706020600000002000206000602000008000601
10308050503586307550704820406080204227865380272040602567472070805440705264844040301
10006000206000007000603000208000406000000050000050800060006020204000400050008060601
10542036807044432072655087705225202070256086287840268060705040506070756085807060701
10003000605000400030004070005000400060008030000000400040503020808020007000206070301
14202475507060807556803020264030883627608040307642603857302060703060603250507350701
10008000404050600000302070000020600000806000500000400000003060500050308000200060301
10465050805060438870407044546450765680355874843660252067708060358858305050807020701
10400040004020000070007000000040700080600040000070005000405020804000706040502000701
10203547268030866047325260353070407070203040387080305630258020803040678080538738201
10400000800040002000000050400020003000502050800060500020200030008070000060003020001
10707730607853404344375030406572657635583070307255673065304054323043504833307080281
10502000602020007000006060300000006000007050800000000040007000008000200000700020001
10645070204040306040488030672247206042805025504426536750308843328530606870402748401
10700060506000602040700050003000305030003000306000000000807000007000208000502000601
10404338705337328080204740403030804040665320625064648326527064703023535088506080701
10700000200070000050300020200080800060200000400030000040004000200060006080608030001
10288770482020508053882040727030206370703026308030542050707070405730507080207030631
10000050004000605040000050008040607080002070007040002000207050700060400040002060001
14286066806674807060853883202550308084865580802023408443307760234080268878275065301
10005060002000004030003000505000300040006000602000400000204000700040300000005020501
10704020825745765034605630303063775630505044685763703240608060705220507785408050801
10508050500000008000500000402000000040406000600000600020500030200030608000506080601
10665030377465203450207584808828803040804080608240773230432268888040502034303040801
10004070003000003020800000700000305000306030800020000000500000008020008040008070001
10507047708036286050478686472270875266504040637044542664665226706037733040373074301
10606000304030000030000000000050000080007030002030000000000000402000000070003000301
10702570202060402878766832277070474030276677265050443623764270308436334485203370661
10400040300060300000000000500070800060000000600050500000006000400000000000600030001
10743050483270283260738770408338504056463620804780605648606024444464803350834056701
10003000800020000040000030700000508050000020800000403000704040000000700070000060001
10303754302080474033733020658080702040806020277085604050805075807860404068875530531
10803000004040004000002030005080502070303080005040002030307000300070307000000060001
10305053387025564042702352605650505370456088404850443054203060555220502222486026801
10700030200080007000703000803000600000300020404000600020007050000080300020007020801
10825770806560802642406080666020267233806580203080205820686030682030304070536060701
10600000200000700050005040000050003000008000600080600030807060008040208000300060301
15804048722656588070734040236280232085684050625230304060704070475060604343208260301
10002000000050006040700030000040400080000040300000803000800080600060407000300000401
10408626334038202080806022363060803350202670805873382257536040803570704020803827801
10600000002000006080206000500030200000606000400070000000007050800000707060400080601
10753227642083844020406868606325537484306073735680808534406060542365533030278040501
10000000002000300070002000004000700060007030004000506000003020500040500070002000201
10837785806678302053334087473350508020344050804063602058525050306040508768707275201
10003000400060003040008000000060403070600030308000304000800020003000200030003000801
10206070764020805060403384273060303460302250704670323450346885573756884070756080601
10500080006000308000600000005000800000600000500070000020000000000000000020000080001
11111111111111111111111111111111111111111111111111111111111111111111111111111111111
