11111111111111111111111111111111111111111111111111111111111111111111111111111111111
10000000008000000000000000005000000000800000000000000000000000003000000000000050001
12707046302028676433702870424063507060502054863033348565243372207020837840423030801
10506020007000000000300070000060008080606000008000400000000000407080300030002020201
10404850847634476340308050225630737560307688806050608057847680808020206068603370501
10700060000000000000705040003000700000300050002080003030008050600040702000600070201
10677040806846626328874080502074405554453460886080483270606070855382207020203060301
10200070703000000000200070407000603000006000700020300000700020300000202020805000301
10303480434056658450302020804550832070407064804458207086268050605640707660306456801
10600050002050000000504070503040000020500030600000004060006070203000808000600000301
10574070808060766735302020303036333530325480503022256072306060702073204036288540301
10000050300070003000004050700020006000500000204000002000005060702000008080002000201
10276670306478735020373050228238608035306447703088704762405020304024282030606740801
10004000200000800080500030000000007000202000303000700000305030003000003000300020401
18802057255757407732407053258323253020705530207220738240705054325760308228432050801
10003040000000303040003000700000007040003000300020000060606000000050200000800050201
10833050856830703080505740404376506486303048608078305060635863666055654670703665601
10300030800070208000204050800070006000308000506000305030700000800080005000400020001
10502080508020808068204020647060653070727240878450403030704430403030303065867070371
10808030705020004000700040005080005060000030007000607030400040303020500030006060001
10404030707074223262208864606040703526726063403045203050338050502080327770204047601
10408020008060004000207000500040800000004030700060008070306040005070000000306000801
10203774448040505050207050257020254822405040205830635080802076282886384047766860401
10400000004000703060300060005040002000806070700030700060006000000040002030008070501
10552586588454504050237870207777406040407030787080705566658722648060707380502080501
10000000700000005050800020200070005080700070005060300040000040000060503000307050301
18434020604565472030803080272020356080483727705020406040423080805880202087208070501
10002080800000004050005020208050000020000000308080206030800030200020403000407000401
14203470406658808070273080303050355055347360704080704050408750775850702630807770601
10004000705000400060004050405030003000000060002060707000602000200020400050300070401
10804025363030775587806020505080205473247224826360356522708078603070406080565048401
10204000000070003000002060003060402000400000000000400030003060002000707050008000001
10208855222555502083823040567027703030506075828826407070822060465378772030203055581
10800000300080008030000070200020003050008000008000202000406020008000002060306000001
10573245702040556040506250606540533032732257507030304552505083804078406056805023501
10300070007000400070300030203080200080000000705080200000002000504000708000003000301
10503080405558804520202350707020606854676350722050207445663020207350203345822020401
10002000606000003000607000503000603000000070000080700030008060606000700080003040701
10433072802054784086785088206224207070344056688660838030306050303060863036702080501
10004000503000600050008080008000200080002080000000800050707050402030005000208080801
15506885408050602268807030526060565525806040603342708823505040608040405460705640601
10005000405020400000305030000050200000208000800000800000003040600060602000700080601
10824080604020666680407078844420776260475354672350353046502050678683607050208070201
10700080003030000070007000000030700030600060000020006000802080706000203080806000801
10208526373060848056873250684060704030705040822050802560623060502060843030778473601
10800000200060008000000080800060004000807040300070800080400020004080000080006060001
10707320706725302833432050705268628652267070308877855063704046738024503745402040761
10307000805050003000002060600000004000007060600000000030007000003000300000300080001
10787060306060603060866060362638602046807022405678237770507245734720402430507886801
10400020207000807020400080008000305060005000308000000000804000005000602000308000701
10405632606375522050203350306020305050775880582052427424372028504062574062804020801
10300000500020000070300030300050700070600000600030000060002000300030005040202020001
10283240236070608033672050652080508770403034408080467040808050808620503070603060661
10000050006000704020000040002060503040006070005080006000807060500050600080006080001
18248082506343806020444285508630704088686340305078204523604680743060436868846026701
10007050005000007070005000803000200080003000807000500000802000700060400000005050301
10202050526552476064505670702054786370306042746452703750607050506320707853608070801
10502030700000008000800000504000000050503000500000300030300040800070505000504020201
10426020863448205750308474505473408040402020706640774540526858486050803082704020401
10006050005000005040500000800000207000506070400030000000200000006060002080003020001
10506053708025444030775632425240756363206070738072642485274773306033767020237025201
10602000508080000070000000000020000030004040005060000000000000303000000040004000301
10207360602080504887736564422060268060664242733040445573672280707352875656205330681
10800070700060800000000000200050800060000000400040800000004000300000000000700060001
10284040753740627780338620807323605086825850807230303387408063432785203650256084801
10003000800030000020000050800000606030000040800000503000404040000000700050000060001
10506678406070348032745050473020207020704070525066303030708032604540807082868570871
10406000003040007000007070003030205030703060005080007030204000800070505000000040001
10302083688033387024802883303330203270665072405430325087808060362670206453267026601
10200030400060005000208000207000700000300030703000800060006020000050400060004060601
10763320404580702572504020767040333335607650606080804350777080557030504030346080801
10300000200000800050008080000030002000007000200060700050406080008050606000300030701
14306076785525284030543050364850222046685060255380206060503030444020603358505570501
10007000000050002060500020000020600080000040200000504000600080400030204000600000201
10405222342063606040504075677050403740708630407548346348435060602430407040302743701
10500000003000008040302000600070700000707000200040000000004080200000703050800030801
10873232868087252020606322803662445535404038332480308828604070788387436060576050201
10000000002000200050007000005000300030007070002000305000003020300030500060003000701
10722467208285607072426028654240808060265080706066707044867080206020402888303253501
10002000500040008080004000000060302020300060703000608000200020008000200040008000401
10706070558050205030606665466020204530308870806570733870322658363585454070484080301
10200050003000807000600000003000600000800000200070000030000000000000000070000020001
11111111111111111111111111111111111111111111111111111111111111111111111111111111111
