11111111111111111111111111111111111111111111111111111111111111111111111111111111111
10000000000000800000000000000030000000003000000000000000200000000000000000000000001
16203477323460535730607822746066405054706320204084303650632070306637656647657535801
10006000000070000030300000008000808000200000504000307000300030203000000000000040001
10502556548060857040384384806620308270645643283680304072602520827020482288533070851
10804000600020406000700000400030608000400040008060806000005060006030000030006030001
10207050302030207374307080327020408043207077804050408777645020702034363830603040601
10800050002060006000008050307080002000003000306000500000500040500040000000200050301
10746065278640582070442070307028864320484260502636664830304286845820687753674020201
10007070000070300040005070004000000040000050204000000030300000000000400000002060301
10502740205027603074506086583882653070758070606050432060658226554868203766403320401
10500030405000002000304000000050000020006030002080004080002000700000604000800050201
10882050202533885420404253678550208262307028584052405074708080205830405070664083301
10004000302000000030300000007000500080006030000040802070008080004000407020002000001
15802674305030803028377765378065262070206040508720307080374020736055864040502343801
10007000600020808000002080002070600020503000700020004040002060008000004050400000801
10465580204640657083404060408030202580406636375855244020305020807435703030586460841
10000000500080008000300040700030006000300000000060000050702020600000600030000020001
10727784505083707527248240335480324060466264264040428575805078422530472728625860301
10000000306000800000003000800070400080700020800070000080007000700000800000000050201
10575480627850747328302044342070803366208040202882643060754230303736302537726057301
10000060400060500000002000000030800000002020007000003080000000607000707000600020001
17423620603040308033483655402356504660752037624083625020344843685070402030308830501
10000000707060508000000000803000800060003000004000008040000020006030008040400030201
10648847305080802346707520756020273023448530305733602078328020402026673040353030651
10800070008000200000400060800030004000000020400000705070000040407000000020400060001
17408080305888374770787570406732307033256028508850602076475220402627642633406068601
10007060303000000030000050406000003000007000402000505000000000500050008000008020001
10423020756066568028376082407040366852207620206088605786607738774080406080767040541
10004000700040007020008000507040000020007040504000707000600030003000300050002080001
10702384206070608060685780242076332040678050237330204040676026507077842332805075301
10400070006080500060000060004060000060800060000030004080200070005000000070004070301
10626060626040874283556050202020464770406342458033327650305380402452858040663080201
10608000800050000000000040308020200050002070004000000030600000704000000030005000401
10505548805085632547856440302080507028336040806053253070777844836077245880203653301
10200020508000000000000080200050005000007000605030008020005000000040000060800000701
10303020306034266786442040203072836260205746604040707075804377326340463020485350401
10803050005000003000005030707080000020600020003000303000500000000020600020000070501
10543080574266402052703030602080323065737060835746603820304756763080408084363040301
10000080005000405000800030804000400050000060000000306000300040000060502000003020301
10365377707037303070478860607332827430308476357350205023555630407728504763287020301
10200000803000008020005000700030000000700070000000804040000000808000003000700030601
10808770402646388522723024523030324282728380855388707060708342502068454060705220401
10004000404000500080003080002050300000000050007050004000600030706000004080400020201
10284087304020706070307070857080608045872053204030807670477050208688703064785020401
10003000500030602000700060008050007030005000008000300050305000202000304000004080601
10206850288870802277562233302042624760504776463473378020806040605070206445205020801
10600060300000700000300080003050000040800000200050003080804070206070200000800080301
10382040308377743440703070568080678080202260602030803060204054204060848650472080301
10006030803000800050706020000020003000205000404030300030202000703030000050007070801
14665040703050408050505086347724205076405064704070876260608450402063663047506080601
10006030408030002030604000200000705000502000507060300070004000802000407000703030701
10305070807060448370606840205370803680506680626040748028585535403780507020708380501
10200030607070002000504000406000208040705070008070008000000000400040307080400040301
10524860505065306055607043608074708070806020806055803685862260402030303040652030801
10500080608020002050007000004000002000404040800050400000000000404040503070002000201
10502020205026883050704474805775444722804080645870507534732626607050804062604842501
10606000806000006030200000700070002000005060000000600000004000002050404000300000601
10708784707688606070406640877030203024538085856340407847474084342080608434325040701
10203000505020005020602000400050204070002000500070207000005070600030600000003020201
10406870206060857040702043805650707050608670407080847058504070403240507657503060701
10306000500070000040403060006000803000500000804070500020003040200000400000303040401
10702036242487778560403066384040508242275645308084608360303070323634378870703830401
10300040004000000000704000000070700000000000503000004000203030000000007000500000501
10533230604080228843605475866355436347865250326527287080203064284435707042455566601
10000000400070500000600000400000300060000020000000008080803000000000202080007000401
10227584276370208540605780802680208050823085535750503040504822376720204058804030801
10000000000080706000200030003000305040800030000030400070600000005050002000006070001
10272580582470408045628038658040336080505670264063862250805574607060532866536046341
10000050008000705000008000700080500060200000600020000000300000507040000050000070001
10248087408076505883207633803735202870488520406260322773377350505025747020547750601
10007000807000806000300000400000508000500030605000500050000050600050000050000050801
12306470705470504060743470363670304050302026204065676040643560526370708776288052801
10005000600030706080000060000020404040402000808000007050200050005000500000003000001
10707022774020605084408084765060403077705480805056505060203054804036736440505658301
10308020006020003000306000002040007000600070003000504020208070002030000020200000401
10484025703082827820202876675083424640388027667830602080507060838040443035785070881
10002000606060000000807030000080008000800030004070807080804080800070600050005040001
12502480202030407872608070768740707030405685203020402020505070376640303260502086201
10007000607080300000500060000000605030200000006000300040004060003030800000205080001
10546087807040304840487837654447708070886842584585326566278075607040407768704620701
10006000006000700020000000000000400070000000000000000000002000005000500000800000401
11111111111111111111111111111111111111111111111111111111111111111111111111111111111
