11111111111111111111111111111111111111111111111111111111111111111111111111111111111
10000000007000000000000000002000000000500000000000000000000000007000000000000080001
17407073505088248766504660383026707080304074736062253684848833602070275340566020201
10806030005000000000200030000070005080802000004000500000000000606080500080003050401
10502240842677854560206020828570248480708474407030308076877620504040806033806240501
10200070000000000000405070008000300000600030002080002070006080600060303000600040801
10233020305248363677377030607022507525765770763070664480805080843874302040507050701
10800020804000000000300080804000606000004000300040400000300060600000702020208000801
10404620226022477840606080303330335020502073602553408084336020502560406650307546201
10500050006070000000302060302080000080500030400000006080003080307000305000600000301
10472050804040632253204020802025556240257750808047226057807080802023202073828230401
10000060800020003000003020700080008000500000604000002000008060706000005030003000501
10725230505453822050633050542382404046704335204063703458408020404058767060602770501
10008000800000300050200030000000003000603000406000500000703030004000002000600020401
13507076838865304268803083758553238070505720308420864730406028226230807623323060501
10004020000000803070003000700000008030008000700030000030308000000060400000600040201
10667030873760705070203270205686402846305028608024203020358848444044742380404673301
10700060200030302000808060200020005000504000802000806050500000200060003000400040001
10304040708060808077406070226050338060722430686260202050306430204020802088548050571
10803040808040002000700030006020006030000060005000808060500030208030500030002030001
10804030608067374332405877605020605278634053402043306020424050503040865240704072301
10705060007050007000306000700020300000005060800060003070702070004080000000508000601
10508644255040705060304040556070552647508040204740768080408063524684327067724730601
10200000003000505040800070003070004000804040300050700070008000000050002020008020401
10755875762653603030474530504846305040603020483040702858885256756020702830306080401
10000000300000005060800020300060002040200070008060500020000040000070305000207040401
17244030407342484030202050433020762050728735404080604070563040507540804047805080201
10007020300000003070007040204040000070000000705070608030200020600060807000804000201
12802480705737406030722040807040663082536250603020207030602430538320708230405330801
10007000605000700020003080508080003000000040005060403000706000200080300040800040401
10305046322040355355504030507070608725782648252750837334702042403040703070467026601
10208000000040002000005040008050804000400000000000800050006040005000203030007000001
10403557568826608027645040627066704050606024222322506030437060652367276020605066631
10400000800060003050000020800050008060003000008000807000604020005000008020403000001
10843586307040757080806650407360424062378662207060308865407074508076403087505036701
10700020003000600080400060808040400040000000206030700000006000502000608000002000301
10502040806577503550207270406030203886748420448080706772843020805720608728623040401
10008000603000004000808000507000808000000080000080200050002060208000200060008080501
10586047703053276082786082406688308050863084258420762050703060405030675064702080501
10008000807000400070005020007000500020007060000000400050804030304080003000502060401
14608756605020206837405030585070424482306050804235606353405030704070307260708880801
10005000707020700000403050000030800000208000500000500000008050500080402000200070301
10682040408030254240602086532550644640638432278330335075502060244353305050505020401
10500020007030000040006000000050800070400070000030008000707070606000808070307000601
10708287545050424068876270554030303020707070323060807620565020303020378020878786301
10500000800050005000000060800050008000304050400070500040800060004070000050007070001
10503820808725402646628060503548736588477080803482527025802088836048504644604020681
10207000302040006000005080400000004000006070500000000020008000002000800000500020001
10758030408070504050434070746833206036603058708382264460806638635820802820708374201
10300020203000304020400050004000804080005000205000000000606000002000306000504000301
10306677603388772080602850702030206050567520338056333866374042803066832038602020201
10800000700070000070200030500080200040800000200050000080005000400080002080404040001
10863270667040405064747020485080204730804082205050287080505040306560505030803020841
10000020002000508020000030004070507020002060007070002000507070200030800040003060001
14758067303864802060333557602340507047455570603077505564203670452080558685524065301
10002030006000003040005000406000200040003000303000500000308000300020700000002080801
10404070544233248048606360704088647540404057774624403850605070407440402542402070801
10407080300000008000400000303000000040707000300000500040300030400030205000204030201
10428030554734308250504224604733505040505040208420867730246572828020802036308030301
10002060002000002080300000700000203000805070600050000000800000007040004050006040001
10807085807065633020863233767340327468507070777048262782737455503083742060344064801
10307000305070000070000000000060000080007070003040000000000000603000000080006000201
10802470406020707523262263537020677040582483724060673372428570502365574476708660251
10500030300070500000000000300070400020000000700020600000005000700000000000800060001
10782040763670734620454440502257203068268650206560306824808026466654702580272063601
10007000400080000020000030500000402050000050500000208000207080000000400040000040001
10302847405050676068736070384070802040604050373074202050806042602560408078752760651
10405000003030004000002060008050605080705070003070002030207000200040804000000030001
10507026736076447077707863207720604540657033203640422052604060284360808526857047701
10600070800080004000304000604000600000500070806000200060002020000040500030002060601
10866850708760702884706060435040686872306470405070407380837050373030505030858060601
10800000300000200040006030000050005000008000300040400030505020004060404000500040301
14806053342534883050652030267730556076333030577480607020404050756030604666602440201
10006000000030008070400030000070700070000020200000202000500030400070202000300000801
10505824683053602060602083256030607820503250605662382322727070305420202070304855601
10400000003000006050706000400050200000205000500060000000005070800000707030600060201
10558674775052684060508537308533338432704086432530305285803070725442668060482040401
10000000004000800060003000002000300080005050003000805000005060500030500020002000501
10864737602276304052258032325760506070225050606068402087447080607030203636206764501
10005000700080007060005000000060507030400080802000805000600070002000600070007000601
10707020834070205080502884633080507570602360207620344440538765558275232020842040701
10700060004000708000200000006000400000800000500030000050000000000000000060000060001
11111111111111111111111111111111111111111111111111111111111111111111111111111111111
