11111111111111111111111111111111111111111111111111111111111111111111111111111111111
10000000002000000000000000004000000000400000000000000000000000008000000000000060001
17706058307025626855606720636087807030708076586048284858846355406040728270827080301
10604060005000000000200030000040008050507000005000800000000000504070700040008070501
10704370268846867730702030332860752870405275208020304032452450402030602063606830201
10300080000000000000707070006000600000400060003050007050004070200080603000700060801
10353060505475738384235030205084604552453430543030548240206020754427802020203040401
10700080307000000000700060803000205000002000400060200000300050500000606070504000601
10506470537054363480803050804750736030203045205253707033784020506520607620504848401
10300060002020000000404030608060000020600040800000005050008020706000608000800000801
10374040702050547236305070604026786670834480508038372045608020802073702067868520301
10000050300020008000003040700080003000600000205000008000002080208000003030008000801
10636540806774678060352080684723202027608337306065607342408060706023727060808420801
10005000300000400080500060000000005000606000204000400000503050004000007000800060401
16202083682337505676405063464378442040703250803750754240303067562560706876225030201
10005050000000405030005000700000004070003000400070000020205000000020800000300070401
10452080333360808040506630805485804683307067204052503020355657362063853660608256201
10800080700040505000502050300070003000803000404000707040400000300050004000400050001
10808080605080308066504020537040277080666680335340702060405260408070504074766080881
10302040508070007000200070003070005050000030004000402070300050502080600040004040001
10405060405062323336807235204040804874685027604083802040276040304070574740806058601
10604060005080007000608000200050300000008020500030007070405050004030000000407000801
10608235825040408040707040783020263557203050408760747050206078228423338083848870701
10500000005000408060200040002020008000706050800070500040008000000060008050004050401
10267428276747302080752370205664806060208040637040708628665682563050705570808020601
10000000800000003040500080700070002070800060006020400040000020000030405000502050401
18487060305278453060606070326020653040884447708080803070342060806450502074305040801
10008040200000008040005060405030000050000000608050506020700060400070507000502000701
17208450802262208020252020604070535044874460402050607060808420553640503670303740401
10003000707000500060003020807060003000000050003060806000806000300080200050600030201
10308027465070352442302030404060205642658632333740322636203077803060402070554072601
10503000000080007000008080005030808000300000000000800030006080002000205080006000001
10404335684744404027223070264065603040705075882434707020523060877842878040307033321
10400000200050003080000040200080006080002000003000603000707060008000006080706000001
10574837404050228070404440202430287026688847807040208242506072807055305033708052601
10500040005000500030800030505070600070000000702080400000008000305000207000002000701
10503050504558408420206330702070307236353660467070507652476040404430303228254040601
10002000705000002000406000404000508000000070000060500030007020703000700030007070801
10642073802042267052342073207677304080823038688550445030505040202070477034707080201
10004000804000200040006080005000700060007040000000200070702070502070007000204080201
14408683708020206434804060842020445756802050402484202846406040803050804660606840301
10006000607020400000504030000040300000404000300000300000005080500080305000800070501
10458080603050622530608022537630475780628378265750286052203020777864507030405050701
10700020005050000070003000000030600080400070000060008000604070604000507080706000201
10207687555040585025355820622060303050307020476040805860636070408080767020777632201
10500000500080004000000040700020002000604040700050800030400020004080000060003020001
10305330205474305633826030402752385465822080606383342063807028344052608426502040321
10207000706050005000003020700000008000007020500000000040006000008000700000800030001
10773030206030606040277060777488304034308078406328282420804365723640206740208256701
10300080602000504060600040006000706050003000503000000000406000004000605000208000801
10805222308277533030405350507060802080688580445056476277523068803087363086804020301
10200000200030000030400020300050700050500000400080000050004000700040004060508020001
10888480284060702063368030547020404250305056302050622040602040303630207020605080281
10000040008000304050000070002070406020005060005020004000404080600020400040003070001
18225025404828804020553454408770505025566740802032807657207820865070774547384078301
10006070007000008080007000803000800030008000706000800000605000400080700000007070401
10507040488263875067607640407036468680705082324222805640605070204430205528705070601
10702070700000006000300000608000000020805000300000500020800050500060304000408020801
10245060556233208570707428707645203060304050405680435640363758227030303057506060301
10006050005000002030400000600000504000808080300050000000300000008080007020007060001
10802032404084582030824628647820736676602080375078578445465748805074835080748086201
10807000405040000070000000000060000070002050004020000000000000306000000030004000601
10606220606040305883584686773030233070373743358030865725226220607482834862803720351
10600030500030300000000000500040500030000000500030500000003000200000000000700050001
10433030374770854620636780206747702085832460405450804836606053746862404850683083501
10006000200050000050000040400000403020000040300000603000408080000000800070000060001
10505445308020277033766080253030707080207020455036304050505082208830503045453660661
10607000004080008000008040003040308020404040008020005050708000700070808000000050001
10508088425086826072708437608520407620774054502330622036805060838420607474778088801
10300040500080002000505000403000800000700040704000500020008030000050500020003030801
10828520804840407885405040358060758564604540804060204440435070736020204050647070201
10400000300000500030004030000060008000008000200050400020207040007050305000600050801
16305023235236224020837030464560654063486040374450502030306060686020608335408420601
10003000000040008060800030000040700030000050200000803000200020400040503000700000601
10302645584055408060805025647040804820406630304578278335565030407640605060705738801
10700000005000004050802000300020300000702000800070000000005040600000404080400070401
10867857528085623020502256604287626822308064746340205824604060624742378030336020501
10000000003000700060003000003000400050008050003000407000004020400030700060002000601
10224628302634404078834055477320404070866030203066308073262040508040807853403452801
10004000800070008040006000000030408080200070408000507000400020008000800080005000201
10707060488050808020602868633070202220806270208870846870853783834685526080545020801
10800060006000403000600000004000400000400000800070000040000000000000000030000030001
11111111111111111111111111111111111111111111111111111111111111111111111111111111111
