11111111111111111111111111111111111111111111111111111111111111111111111111111111111
10000000008000000000000000008000000000600000000000000000000000005000000000000050001
13705054805022464728402720536088208020702025272027254524247544803030635270648040601
10204080008000000000700030000030005080504000003000500000000000503020600060003030701
10404650675843885820805080624830862460503556204050203048634320808050503033704520701
10600020000000000000307070005000600000800040007020004080005030800070307000700050401
10243020602575857238344030806046808833842860552070632450603020446388303080704060601
10600040802000000000300080703000703000004000400030200000600030300000302060204000701
10707870532043537330802030506520762070507023302525403025874020806440708860703733501
10800070008060000000208080405050000080500080300000005050005070306000305000500000701
10532040303020376744407030407042563380468550304063856035603030702038707026224320301
10000020800040008000005080800080004000300000806000004000007070704000005060006000701
10436850504568346030363080463544504035806434707048603353703060803044253050602860701
10002000400000600060500050000000003000607000804000400000202040005000006000300050501
17204077685764408743402073586777577050804570206770388250603023564720803228442050801
10006040000000304030003000200000007030006000400030000070502000000030200000400020801
10754050628280702070205460608838508846608035407085507070477565677083423380707632801
10500040400040706000404030600080002000206000208000602030200000500040006000400060001
10508050202050304022406030443080475050636640246350704080608470505060507046687050571
10204050502030008000700040006020007030000030006000403070200060402040800060004030001
10606030306066584338404766302070706236373027503067804030488020604030588580504065601
10507070004050003000308000500020400000003050400060006040704070007040000000505000301
10607562372070806070705020288040287228207070704320234040505043474653876076652220701
10400000004000302040200050002040008000205030600040800080008000000030008030002020801
10656572846273707080488780303872606080408030876020207857753677733060703650706080401
10000000800000003050700060200050006040400080002050500070000050000040502000707070701
13748020705485425020706040572040358080357574607030206030433080506840804052803050801
10004050300000006080002060402080000040000000504070208050600020500020505000408000501
17506330305548802020234080602030375054365270802060408080704230864250606360805250801
10003000706000700040005030306050005000000080003060807000308000500040300040700080301
10802062868070442322804070506040502432734235484330352563405067702030306070245037301
10204000000060002000004080008050503000300000000000200060005080002000206060006000001
10206886474775608022532050545033608030202045728258405020826060432886353030408055241
10400000600040007050000030700020007030008000003000402000202070003000008050508000001
10547447206020233040205650505750724023637565502030205484808045204037702042803026401
10600030007000500080500050503050800020000000407070500000004000806000807000005000601
10306080604288305750306460704070805727768360235060404325534030404770405733723070401
10002000207000005000207000307000607000000040000050500070002080804000300070002050701
10855037606065364074537043304483804050333056726830522040802060206060868032205020701
10002000804000700030008070008000300080002060000000300070803060402060005000303080601
13804365204020806356404050423040425523503080707644603235307050306070803480807220801
10003000405070700000202080000070500000308000500000700000002030800040408000600030601
10553050706070273230408043268660358720876747752650555064306040374373207030302020501
10400030006030000020003000000080200040200030000060004000308020505000808030703000301
10306332867050324072455820838030505070605080766040706570723070302080863060287868601
10600000400080004000000080200080008000603060400020200040800020005050000040004040001
10203730408458504323246050604354623233475050304628848066503083472067803573507040541
10208000303040005000007030600000008000008050300000000040006000008000400000600060001
10443020705080407030564080235562806024504078302646837520607247573820505650606433301
10500050302000203030200050005000207020004000402000000000402000002000808000506000501
10204436705457778060807560806040807080576550488088725782762062802043345028702020201
10500000300040000050700050800050200040800000800030000020008000800020004020204040001
10483580282030604034373040433030303870504058708040554050404060802880508040207020541
10000080003000806070000040008030703060007050004050008000403050700030300060006040001
13578035703384604040446733805520308036664840308024804853508280283060666483335047801
10008030003000003060005000206000200080007000507000800000705000300070700000002050701
10208040465384563043705440407082768260704025474566504630306020402480506833604050701
10607080600000007000600000604000000080603000200000200060800080700050305000207040201
10553030472488604530704546706333604070505050504680536650252853638060804073306080301
10006060005000003030800000700000407000503020300030000000600000003050008080006080001
10705076504024725050854587436740452545303080557088784652265467603058622080636084601
10503000307070000020000000000050000040005030005040000000000000408000000040002000301
10606460705080403234483587526070632080462553452080366278537630802362434648203620221
10800080200080400000000000200050600070000000200020500000004000500000000000700060001
10883020633640634740835480803643207075866530205420504638303044547677708730785062201
10003000400030000040000030800000704050000020200000707000802030000000400040000070001
10303628502060837066277050468080503080802070574076203080403048506750306057386350251
10805000004040003000003030007030603020204030006040004030707000700030706000000060001
10403063632036548046508623606570502460876047303250335067703070644430607465786085701
10300040200070002000604000603000700000200040503000200050002080000070500050003030201
10446320502250802433607070567060872635203440504040303450535070263080303060446020201
10800000700000600030006020000030002000006000600070300030204070004040402000700020401
12806076537766232050664030664830245066288040836440808040808040526050603586203620601
10005000000020006050800020000030500060000060200000403000800020500040404000400000701
10205888387082304020308064823020803380606340705645827443464040508660805030203663601
10400000005000007050804000800030700000808000400060000000005080300000605060700050601
10488585827053765080508835403658627383807057557770302723306070747363743040268080301
10000000003000500080003000006000300060006050005000605000004060500080700030005000701
10677266607367808056862048445240502080768040504035204082378060602030204684502882601
10008000700040002070008000000050702070600040206000406000400050003000500040004000201
10303080276070505020502232255040308430706670805370572320675445355526658030748050301
10600020003000704000300000007000400000800000800060000020000000000000000030000040001
11111111111111111111111111111111111111111111111111111111111111111111111111111111111
