11111111111111111111111111111111111111111111111111111111111111111111111111111111111
10000000008000000000000000003000000000600000000000000000000000008000000000000030001
16705055703062674824408650623076302030706026755022322538545466402040248450233030201
10404060007000000000300040000040002070206000005000500000000000407040500040002030401
10602220522447825860403040284720855820507867508030708088666220502080305073802320801
10400070000000000000306050004000700000800060005030006030008060400030302000500020701
10777080302386562333743080705046205457656880456050823480205070336268207020503040201
10700060507000000000700030205000605000007000500040500000700020500000803030402000701
10203280357068643720302070303850787070607025502262605048265080207570202580808573501
10300040006070000000604070203020000020700040800000004050004030507000204000300000701
10664080202030547255402020506027437560852350704083327075806020404067307026244560701
10000020800030003000003070300060008000800000604000002000005070202000008050004000801
10784840602536863040462070488546206042405587702067304446506070204033347080306420701
10002000500000400080400080000000002000404000304000700000602040004000002000500040301
17705062283588604448308025823773484040208380203440365860405055482840606248782080501
10003080000000204050008000200000006030002000400050000070805000000040600000800080401
10262030458540603060403840808586506822802052702087304070367585533054844860705375801
10700020400050703000404030600080003000207000807000705040600000600070008000600070001
10702030505080606035803070525040362080328380662850805020808330602030208068722070651
10206060808020007000700050005030006050000060003000305060800050508030400060002020001
10203020503024553624606687508030706782628055808025704060833080802030656740603068501
10707040004070005000507000200050400000003080400060008060307080007050000000505000301
10507274664080406050308070338050777845302080704520338020406042877667328058745280201
10600000003000206020700030002070006000206060200030500080005000000060004030003060701
10222233826644604050843330607445604070705060883020805865262588773080605660702030601
10000000200000004030300020700080006080600080007020700040000050000030503000708050601
18827040203644235040803030246060845030248346807020704080422060808220808088705030801
10006060300000005070005060607060000030000000607050306030200050200080304000503000701
14507860806365404030638040705050656067667760408040403040504280343850604520604340701
10007000405000500030002070206080006000000040004070507000507000800080200070300060801
10202045336040676848706020402080306533743475782740548474502036802040604080223087201
10602000000030004000003060007070502000500000000000500060002080006000602070007000001
10506773732853306022278030744068205060805024327238508040653050342885264020208027241
10500000300040005070000050700030007030002000002000707000604080003000007070205000001
10388246208070652040407570302760822077583372606060402773404076404036305055206074401
10500070004000400040400040706080500020000000507020600000008000305000802000005000601
10808050702246606320206220805030607828758550558050404845264060204230207874562050201
10006000506000003000306000706000506000000050000060200030004020404000600060008050501
10524057705052652068473063605382807020835064652640765040206020302050855048604030301
10006000406000600060006030005000700020006020000000200060608040603030007000705020301
16506654707080506868206050853030368565707060204673602223606060506020508760207640701
10003000707070200000304050000060300000307000400000300000003060300070408000800060601
10255080402060535420406027385270732230473552726240887056506020838446508020308040701
10600060006070000050003000000050600020700070000060005000403060308000703020204000301
10303642725040886065766220583060203080807060388040702620453030202060852020347634301
10200000700080003000000070200040005000706030400040500040200060007040000030008040001
10503660303868403485327080204437636833746040708736662086408028765027608726408040521
10202000804020002000007070800000004000006040600000000040005000006000800000400050001
10784030208050704060627030824348804046305073708437454660604488577260305570208222801
10200080808000303040400070005000603070002000805000000000407000007000206000306000801
10207237302327463030305470707080305020686370856037655232387044804037636024802030801
10800000500050000060500070300060600040500000300030000020004000800060002020202020001
10783670666040606073438030233060605370405053303030544030406030705380505020608050621
10000040002000206050000020008050704080007060006030002000604020400050700020003070001
17672075302226408080735627305570203047843230307047206548604420554070748725255023501
10002050004000006020006000207000500050005000803000800000303000200080300000002020401
10208020734762588088508860402057555540806043767275808720808030207750403822804070301
10408050800000006000300000704000000020207000400000800080300070400020208000507040801
10486070747875505480703427202874207040603050702820363650586364328020708085603050401
10005070008000004080600000300000403000204020600050000000400000003050003020002060001
10204062303084556080384566256640822343303030728026852732364537804056325020523065201
10707000206040000030000000000080000080004020002060000000000000503000000080002000201
10302570506070508563462864253060883040878524383060743327474630204654362536806740421
10700030200020700000000000200040700050000000600050400000007000500000000000300060001
10846080675380557320368560508775308045553640506650606726406036785467305530732057201
10004000800070000080000040300000405070000080500000802000405030000000300070000050001
10302783705050378084377060838040407040204030386053302050703067406570204084348740681
10605000002030003000007020004030304020206080004070007050703000400050507000000060001
10503033426068284074503564505430802230743024305320676086406030783630608688437057501
10400060200060004000204000706000700000500080308000300030005050000020200050008060501
10477650205880404442303020778040388267708460602080506450434020347030304030785060401
10300000200000600080006070000080008000002000300020600070405040004050308000600080801
13304082565336784040676070842380227076652070753640305050304070878060505572202250801
10004000000070005070600070000070800020000030300000602000500080500080405000800000801
10506572444065308030802024543020507640808840205735622732266040804340603020808445401
10600000005000006070508000200050700000505000800020000000003030300000407060500070601
10758228553053324040302444607554446654402056332840304428805030853786778020765050601
10000000002000600020008000002000300020002050004000303000007040800020600020002000701
10734752707664804045878082534280206020458080502065504083578060706080502632702357701
10006000400080003040003000000070703060800070603000202000700040002000200070003000801
10503020232040604020802567623030707320406720802520482460747785534424245050342020801
10600020003000606000500000008000600000300000700050000060000000000000000080000060001
11111111111111111111111111111111111111111111111111111111111111111111111111111111111
