11111111111111111111111111111111111111111111111111111111111111111111111111111111111
10000000006000000000000000007000000000400000000000000000000000004000000000000060001
15507023203022328563206550367047703060205084565044482785566887505040823520686060501
10805080003000000000300040000050005050608000008000500000000000207040400020006030801
10404360755565838350404070884640433430702883705030407035226680608050303032402680301
10300030000000000000305070003000700000400070007060006020005020400080708000200080701
10264070303834227777856060405025505373226780283030677760405050657635502060704040701
10800040805000000000500040208000207000006000500080400000200040600000405070308000301
10805850883086386680506050805220835050503072605258507074255030403780402880803887601
10500030007060000000402050205030000050600070200000006060003070803000704000500000701
10274050808050433442204030708085263680477770604082884038202050403034206083763770401
10000020400070006000008020600070003000200000206000007000006080608000002030005000201
10733440203338327050736030728335304048505552404032807256404050805042836030802270201
10007000800000300070200030000000007000204000502000400000204070003000002000800040801
16304042534364306722807033353276766080806360807720474380806037238620203728254050601
10008040000000804070005000200000005070006000500080000070404000000060800000400040301
10525040243580603030702540306362508446603032208022308040852366287087776380203333301
10400020400040406000502050800060006000608000705000405080800000800030006000400080001
10803030406050503076806020874070863020727270422570706080308760307020702027358080821
10407070302060005000500080008070007030000030005000702050400020808070600050004050001
10705060606047282835306838602050707776226045706072305050382060805080348840202026301
10702080003070005000604000500070200000005030400060003070406040006040000000305000601
10706283347030704060503040742060827645206050404550644020207083778626857056236530601
10300000004000206030200020005050008000408080500070300080002000000020008080005060601
10347776438544707030372670605748504080808070555070306642322283867040204320604080301
10000000200000008080300030600030005030600050007020300080000060000030404000705020701
13736080506625863080608030722030687070677738706070607070225060806620205066205030701
10005040400000004060003020408050000020000000806080707080700030400040804000406000401
18504880505828404050325040408030424045362660305020302020306260337880808540705360401
10003000207000400060008020802050003000000020002040804000504000800060400040200070201
10805074868040826344502020308070308556336744753870666747305045708050508070524072301
10404000000050005000003060004070704000700000000000400020007030006000507070006000001
10206437567247703038765070273065207040608054732882308030525080777557375070408052751
10400000200080004080000080700070004060004000004000308000204080003000004080302000001
10655828704020487070508730808850672054865878608030304365508062805044207046805037701
10200060005000800020600020305060300070000000403070700000003000806000303000005000201
10704050408755408750806230705040507822682350848070808582352050407570604578445060301
10003000706000005000703000307000204000000050000080800050004040607000200080005070501
10478065508082486053885053804634406080475066888280526040308030406070522075506040801
10005000607000400020007020004000700070003030000000300060503040407050003000504020401
15704745706050702558203080445020382278703080506848306557504080507080602440804430501
10007000504030500000208050000050700000406000400000200000004030700070705000600060401
10657050405040454240306085732460648630355846362880578062408080884227408020708050201
10500060002070000060007000000030500030700070000080006000403060205000603030406000401
10307588823050674036887880534070205040708050473030708470752050502080873040664452401
10400000200060006000000080400020003000406060800070700030800040004070000070008030001
10207550804722702354236040807888723468776030807576568056506058737077702327702020741
10406000204040007000005070300000005000006020500000000060003000003000400000800070001
10274050407060206030864060582727207025507042306267283640705853238860408430805244701
10600020507000508040800070006000207060004000605000000000604000002000503000605000501
10705773605786722080703770607040802070343350364044882487252058507044436067306070301
10300000700020000060400070800060800060800000400070000030006000300030003080404080001
10635270272030604072322070876080704850802077803020624060804030304250606070406070561
10000070005000702040000080007020605030008030008050007000502070500080300040003080001
13488086304348706060634474208680506077825670805072306258502680344070423678328055601
10007050002000005070002000206000200060002000806000300000206000400070700000007070801
10604020585785824073203730205085233280404085588353502820804060506570507252406080601
10607080800000006000300000408000000050706000600000400070300030400060403000608050801
10866020838548505240602356308735708020304040208860222350826428268030707044507060401
10007060008000006040200000700000307000805040200030000000500000002050003060002020001
10503086702067232080772268857540346784308050246062434352234866507084476080856044401
10406000604050000060000000000080000060006030007080000000000000803000000020003000801
10808770306060702778722458687040673040374686456040485234255540508878378658802650561
10400080400080600000000000700060500040000000800020400000003000700000000000600040001
10465070582780466650756740303337406084722630602340804324305066383358503840352034201
10004000800070000080000030300000703040000040400000706000203070000000700040000060001
10407465603040377027558080374050607070207060726024203060506086707720603044372360651
10508000003040004000007050002030806020606080006040002060504000600030704000000050001
10307023366043724073602744703530202640575062504460534042507040264420602323428082401
10200040700020005000604000405000500000300020405000700080003060000030400060005020501
10342280505320703482302030532030834527206670204040806670655060422070507050564020301
10400000700000600030006080000050002000003000300060200070607040005050606000400020701
14403028637362574020677060486620885044546040823470804040706050847040802487504350501
10003000000020004020200060000030700040000080800000607000800080300080502000500000601
10408477437037602020306045234060808530608330306385858425663050708660605040503323201
10200000005000005070406000200020700000702000200080000000002080500000508050300050301
10624484882052543050607245304724857343606024665260405654504080627686576030543050801
10000000008000700020008000003000500020003020005000403000007030200080200040004000501
10884387704767208056568054266760804070586020608047502045368020606040305627808846201
10006000600020007030008000000070502060200020505000403000600080003000600040008000701
10404070743070206080507355452040702440207220802730484530478645877683863030746030701
10200020003000502000300000008000600000400000300080000030000000000000000070000020001
11111111111111111111111111111111111111111111111111111111111111111111111111111111111
