11111111111111111111111111111111111111111111111111111111111111111111111111111111111
10000000008000000000000000002000000000400000000000000000000000004000000000000040001
15207082403077678657407270724086204050605024468055622787636762705070558530522060401
10808070007000000000300060000030003060507000004000300000000000305050500080006020201
10203630486347775720803040534530585640203632707080304037778480708020602085305860501
10800030000000000000405060006000700000800020007080003060007060400030306000200020801
10837020302855328575368030607032202637734440685040673770405070746875603020806070701
10200080503000000000300050707000307000005000200030800000700030700000506050206000201
10602250662028386230406060302680642070802063308476205083827030206240304450206884301
10800060004030000000206080703050000040400030700000003070002030805000704000500000501
10652050202060774724705020804036788540476840308055426023603070203032804027775750401
10000070300040003000003060600040008000300000606000006000004070604000002040008000601
10367870706636352080378020338447404024503778508076703655706080307077355070302530801
10008000600000200070200070000000007000505000408000800000607080005000002000300020201
16207066882442407362507045623463256040806230304750635520706044557780406778548060601
10007030000000604020002000400000007050008000400030000020208000000040200000600050601
10482040767270707070507860302756206653406088708086702070586288223074476680808827801
10400030400080706000304040200080002000303000205000506040600000300060004000800020001
10808050204030406074407040858050443080528480223880802030202830704030408024856030851
10505080504030006000200030004030004040000030005000207050700020302050800030006040001
10508080405037685322405834306070405868853064303045807030226030607040248220604086401
10202030005060004000504000200020600000002020600040006060203030007070000000307000201
10707363455080604060602080827050423232205020206630643030603053724763784068324240601
10500000007000805020500050006030006000603070800020600030006000000040003040006040301
10854484855445205080466430805836407050804080768030305466854876566050802770806050601
10000000300000004050400080400020007070700060003060600080000030000070704000202020301
13833040403347555030404070842060345070445874403070803050455040405270807042506020801
10006040700000006040007020707030000050000000402070206070400030200030706000403000201
15704760606855804020366070306050334076624630402040707060408240836730508450507870701
10005000506000400020002030802030002000000040007050207000205000600070600050700030701
10506067435030827658805030802050605372674263565260646778806058308080506040525087701
10807000000060004000008040007080508000300000000000500050003070003000302070006000001
10802846222558803078834020555087504050604026386682502050327040358386473040203022871
10600000200070007020000020500070005070005000003000502000608050004000007070804000001
10882483605020478050802860706270823028264553707040406788706037408084203023404068301
10200040008000400020800030306050600030000000203070300000004000703000508000003000401
10804070602586407860804320704080502778263340556040307725683070702250703347454080501
10005000607000006000303000405000805000000070000070800060004060707000300020007040701
10844062506026752085667058207573206030432053857380438070808050604080274087608070701
10004000504000500040007040006000700020004080000000500060604050507030005000504020201
14606372303080403358707060756080687448608060208645207687508080202020604340406640501
10003000706070400000207020000080400000308000500000400000002070600030502000200060701
10678080205060755840202037553850784330827687324440373083207020647887304030208080501
10600030007080000070007000000060200040800030000080007000402040208000707030408000301
10703767734030485084676680373040702030707020526040202470252080203060878030773263301
10500000800050008000000070400050003000303040200050500060600070004080000070007080001
10604540708827606353578050502255745672684030704574665027202022536056306388302080331
10406000204050007000004020200000008000007020700000000060007000003000200000300070001
10723080807030608020482070533356408054708044808467434370603244574620603440205838201
10500030208000205030400080007000606070007000803000000000402000002000803000507000701
10302852502545226060308280502070703030285280638063524326624027802028337022407020801
10400000200070000030700060300030800080700000500070000080005000600040008060808040001
10455740258020604074362060486020303260203025706070246040804040306750406080503020771
10000080005000404050000020005060808040008030003030005000305040500020500050002070001
12222066405554503030452386602720807045657230807064402738408270782080724257326022801
10005020002000006040003000207000500060004000408000500000204000800070400000003020601
10707080565464275045604860204035425240608055527763707360806020505280208822406020301
10404080300000007000400000306000000050408000600000400060400030200060403000207050301
10455040627456203870405625306746308040204080602660553280777544247080704054705030801
10005060003000004030700000200000806000803020200040000000200000006040003060002060001
10806072403075436040776876425320735828705050465062268587234732505066625060378038701
10606000504030000050000000000030000060007020008080000000000000302000000030004000401
10405380708020805644726447255060325040788655277080465346376770508274422486502770781
10700040800050500000000000400080600070000000700060500000002000300000000000200030001
10655060855650235840286860407342302085243730307820305652802052245752608340665057801
10005000800030000060000080700000502020000060500000806000605030000000700060000020001
10707572605040435026343030883070305080803050586035304070505072206330703046887520451
10802000005020006000007070005030505050702060004020002060505000300080602000000030001
10807032635023735052304227405580204560735033807580426057604070372420808556233055701
10400080400040004000404000408000500000300040607000600020004050000030800040002040701
10824670208550508765402050843040655278507630402060704830376020523030206080868080401
10200000300000300080008030000080004000008000200040800050708080005080207000500080201
14807072243336533020876020567560436076828080226220308030503050384020706758304320601
10008000000080007040300030000060800080000030800000207000400050600070507000600000301
10306527673085204030502058884060505630402480503863456266328030608320506030703635401
10500000005000007050408000500020200000702000200050000000007020200000508060400070401
10782364626067757040606484403673244664508074667370805554703060624354522020526080201
10000000007000300070006000007000800060005080002000303000008030400020800030007000601
10434325606534703035323026874740807080562020804022403074552020703050708727807828401
10007000300040002020003000000020403030300050207000508000700020002000600060004000801
10408060666050802020802472366020805520707240405260744480455383577687373030585070601
10200050005000203000600000004000600000800000400020000050000000000000000040000040001
11111111111111111111111111111111111111111111111111111111111111111111111111111111111
