11111111111111111111111111111111111111111111111111111111111111111111111111111111111
10000000004000000000000000005000000000700000000000000000000000007000000000000060001
16307057505046378525504770235072406050203087772045744757236676407080224220255040501
10307030007000000000400020000040003080604000003000400000000000303030800070003030201
10407540235323247240602030724530875220304345303070303048527730606020404025306580601
10200060000000000000504050007000200000400030004030004020003020200020205000400060701
10586020308382683228658050608044503242774330338050842640307080246682406040404020801
10600070504000000000300050502000806000008000800040800000600040400000506040206000401
10706540877033652270804080808740682080608083204373303066726050405670302680507588601
10200060007030000000204070703060000020600050700000007040004060202000706000400000801
10466050203050745224405030307063445820447330608075752024202020605055402047675850801
10000070600040003000002040700080007000600000208000007000005070805000007040002000701
10357230408835766020684080267328406053407874202088602258202020505047353020503660501
10007000200000300050500050000000004000602000802000700000407050007000007000800080301
17608086255647208225403047826824284020508650202370484520603057666830602447347030401
10008080000000305060003000700000007050007000400070000080802000000030700000700080401
10825030823460203030408370405885202588603083708062206060342752565026323450803263701
10700020800030505000502040500080008000702000203000602030500000700030003000800050001
10508070502080702054207050487020474080258250375780307050407640807080402063365070361
10308030308020005000300050002050003050000040004000607030600040605060800050005070001
10704020305074852884605485606060207552362056602075706030554050606060242420203037801
10403070004060008000305000700050300000006050400080003030806050005080000000605000501
10607838286030207070707020773040555684608020304280536040302047723825882058268660601
10600000007000806050400050004070006000304070400080300030007000000050002030006080401
10434447824867503060283470203527406050202030385040703332244422588050407520602070201
10000000600000003030800030200050006040600080008030400050000070000080304000307080701
17568080205258773060503020646020634050233483305050307070558070808240406077208060501
10004040600000008080007030803030000040000000602060202050400050400040706000702000201
14208340508383807020476050404070754035853740203050805020403880657760408350704340201
10007000306000400050008030404060007000000060005080602000806000500040500050700060401
10407062856040842484503030602050502532352472862430868737805085203070607060665062701
10708000000070007000005020004050806000600000000000700030008030006000707050007000001
10605878432567504075447020672076202030608033867223308060252030843673227020702077741
10800000800040007060000080200040003050004000007000702000605020008000005030408000001
10323767308030478050804750406530333062254233803080602356404082806045608076302084601
10600040004000800070700080603070500050000000205060200000002000303000408000002000301
10402030607437704420404870504020804736848250254080806758837060205380202775768050501
10007000504000008000405000608000202000000060000060800020003030606000200020006030301
10578038603035887043332023505422204040786023466560823050705040306080373082708060801
10008000702000600020005020006000500080002080000000700050403020408030004000705050501
16504835403080502272403020222060738865307020806432208844406060703030706760505420801
10007000307060400000603040000080500000503000300000600000007050200080503000500070801
10878030203060872820706076833620883730685838385660335028203030824832303080203030201
10500070005020000020003000000040700040400070000060006000803060708000705030302000801
10806227243020446045862580484070302020703020788020807840568050607020873020423352701
10300000200080004000000050600020005000407060200040700080400080003050000080008070001
10506240805483704482527060506823483355424020805284836027703065727032305883507020751
10604000602040006000005050600000003000005060700000000070005000004000300000600060001
10246020305040806040275030785483502034203044507775834240702435663750504520608336501
10800020408000507040800050003000607070007000804000000000306000002000805000307000801
10405732503842254050408530302060408060422430728025635547676037705067364058702070701
10300000400040000020200080700080300070400000700040000020002000800020008030702030001
10448430666080708086745020866040205230305063303060486030407060407420205030302030681
10000050003000407080000060007040405040008040004060003000504040300050700040005050001
18462038207458705020456226407670405022554580202083705766505260244030635822443048801
10008040003000005060007000402000500070006000403000600000607000700020600000007080301
10802020666748476058504430206056742360704023572828403860707040503560804233807060301
10308070700000006000400000307000000030603000500000300080600080400080307000606050501
10625080833685705420204758402277506060703080404550233850266784847030403067302040601
10008040008000006080600000200000805000402040800040000000200000004020003020005060001
10302088606022248020866665457520433266706040443066222332423827705065323020588026801
10606000307070000050000000000040000030003060008060000000000000408000000040008000201
10305860502020806552777786678030257040764237822040782832425280702225755325205620841
10500060800030200000000000200040600020000000500040500000004000400000000000500070001
10442040886580587220237570205748603032728720402650407232703033647683803320635035801
10004000700040000040000080600000207020000050400000407000304060000000700070000070001
10807883408080683075644030765030402070807070523083502020406033306560405033223340531
10405000003070007000005080008050502060605040002080003080807000600020303000000040001
10507088245023384067504648703750302380225074203830564027806040372630408243522046501
10500070800080007000702000708000400000500070808000200020003060000050500020006020801
10536450202260807862507020328080557774504860302080804530548020777040503050784070801
10700000600000600040003060000050006000003000800030400060503030003070404000400060501
12404088346727825030366050747630753048436020865720208080608020775060205556508550201
10007000000040008070800030000060300050000020600000306000200080600050404000200000501
10708738724053202040207053258020206260308840403547584675685060504660606080804327201
10400000007000008080502000400080800000404000400050000000008070700000202080400040701
10642745387087568050508568502624574424703064655250407683304080664835655030845070601
10000000008000200050008000004000500030002080003000804000003030800080500020006000301
10832366403243303034276068462570206030362020707073508043385030808080703423408832501
10003000200060005060004000000060304030800080307000208000400060003000800050003000401
10302030286070406040704434345040403730407570603830453750574357535382427070774030401
10200020007000204000400000005000600000800000200080000040000000000000000050000080001
11111111111111111111111111111111111111111111111111111111111111111111111111111111111
