11111111111111111111111111111111111111111111111111111111111111111111111111111111111
10000000002000000000000000002000000000400000000000000000000000007000000000000020001
18208034803055334863207440244024404080602023436035442373444578404070455440458070601
10805020006000000000400040000080007020302000008000600000000000808080200020005040801
10304760686685825230502020283450766670706735607050302038475850707020406048704740501
10700080000000000000608080004000300000300050006050007080003040600060202000300080301
10288060604728865837635060308073305727477630733080588620604030532663802080803070701
10200070306000000000300080403000603000006000300080600000500040500000502060702000301
10806580333027752770206030604270325020408062605556402084444050605720408720804387301
10800080003070000000504080604070000020500070400000004060005070607000708000600000401
10483050306080753527704040202043576830238420307067658056708050507075207078482680701
10000080300080005000006080500040007000200000405000002000006020602000005050005000701
10787820608584843050274070628864605066705357404074608753806040406038457060203770201
10004000300000800060500020000000006000302000505000300000605030007000006000300060701
14308075878462303774204082324683422060206450302550527270407055877860803735625020701
10007030000000508020006000500000002030008000800030000030408000000070600000300040601
10363030258870504080208220205386404245403083802052302080865562586055726430607463301
10200050400050507000704070400020004000206000302000506080600000700020002000800060001
10405070204070306068506040364030238060224430554820605080404620202050704044288040861
10505070302020007000200070003020003020000060006000406060200060207040800050004060001
10702050705028825857502673305070208666822053403072506030247060804030843380808038301
10604050003080007000603000400040500000004070800080003060302050003030000000304000301
10408868738080503060305050723060682563604080306550676080303084226275784066668420301
10500000008000705070700020004050008000608040400080300020005000000050002060003060501
10577338223224605070622830805238304030405030678070806223536424248030506260706070801
10000000200000002040700080400070005030300040006020400020000050000030707000304060801
16873030403464377080608020687060883030658538408050207070873050408480405085405070301
10003030400000006020007080704070000070000000203020706070600030500020708000706000701
12303640306526705080357070607020553073654860404050402020406480478870407880306570601
10004000605000600030003020307080005000000030006050407000404000200040600050600020601
10206076434070754788502080707040805622378635855470527432606083305050803070838043701
10608000000040007000003040008040707000800000000000700070004080006000604070007000001
10506787568764203082858030576044406080605088852867304020548050358656632060705087361
10200000300050008030000070300070002080003000006000403000307070008000003040706000001
10525768606080848040306570807370282046442338504080506726203037205044406037606023501
10500070006000600040800070806070700050000000403020400000003000205000404000002000601
10608060708875607680408840507030607755536470636070704544523020206260206737735030501
10007000304000007000703000802000405000000050000020500070006050807000600060004080501
10677066703026465057782087507462707020366037858520262020405020705080288027203080501
10008000303000400020005030003000200020008080000000800060302020505030006000208030501
18207248308070807688504070473040827327405060708423303823503060604020602270305670201
10008000207070400000807070000080700000208000600000400000008020300030504000400070601
10646060503060376740708047238240438850525338248780735028707070438273404030505050301
10300060006040000070007000000080500040600050000020006000804080205000603030402000601
10206582828080727077275220888040306060404060734060808630433040603070238060553387601
10400000700030007000000080300040007000507050200020500020300040008030000020002070001
10207630608377303626543080204736356588274020607786663077508087758044406534506040871
10603000506060007000005040800000004000004070200000000070007000007000400000800050001
10785040304030504080238060823654707067305072405358574760704864757360707470408774801
10300040603000706060500020004000802080005000308000000000207000005000404000608000701
10606733808328444070808560708050407060486750674045635467638064503078558063203040501
10500000800080000040400070500050200080500000500080000080004000300040005030808040001
10723850786030408084622070467050505570408022203050862020407060707650803080807050881
10000040005000305040000080008080202080007060004030005000806070400040400060002080001
17467056408382402020455565605220606023825660304023405867802860468020277545458082301
10006080007000002060002000805000400040005000605000800000503000600070200000002070501
10305020462753267032405840304072542550207084562357707550202030302670606655608050201
10302060600000005000200000805000000060306000200000400050500080700020604000408040701
10622080745723504650207326503786804080308060407280382880737384826030502047504050401
10007040002000008030300000700000708000607020600080000000700000002080008080007030001
10707052406078668070252427257240572582202020856053673553446728606026487070222034601
10502000507040000070000000000070000030007020004070000000000000305000000080008000401
10304360604080503552823338577030632080473344324060765722757360408363528446606820621
10700070200040400000000000500070300020000000500080200000004000200000000000700070001
10327080377770772820532570303783602038648850507550206345608054758526703720333087201
10002000200020000030000020200000304020000030700000602000202060000000500030000040001
10805656203070538028568050424040608050302070734073303040304086803770504084785340831
10705000004030002000007060006080608070407060004050006040708000700060806000000050001
10504074666024275072208358302360508630772058603550245022206030826750402883567084701
10200020500080005000405000205000600000200060508000800060002060000030800060005080301
10342320204660405626308040755020476723308240707080406460456050747030507030786050401
10600000300000600040002050000020004000007000400050800060203050004050603000500080301
16502053847752778070862020728580327023286080634260403060403050245030307765708440701
10004000000080002060200060000040300030000040500000607000500060800050404000400000701
10705435557072205050305067443040807650202280303544862283564030608820304020205573801
10200000004000004080303000400050500000702000700030000000008080500000808060800040501
10428372327037363020203876308235426287207026765460203844503040256365742040547050301
10000000006000700020005000007000400070008080003000604000006040700050300050004000701
10373675205337705066487065542730405080734040305068405043384040402020308863406772201
10003000600080007060005000000050406060300040405000408000600050008000700080004000701
10306050573030404030205335565060207220605620206780367580228357345334563060834030401
10600070002000504000300000003000700000500000800060000020000000000000000030000070001
11111111111111111111111111111111111111111111111111111111111111111111111111111111111
