11111111111111111111111111111111111111111111111111111111111111111111111111111111111
10003000200000300000000000000000600000004000003000004000000000000000000000002000001
16806060702076504630228330675340505530606030705082506050735438273056456724806747201
10000020306000004000600030000040007000600060308000300030000000007000000000300000001
10723220307044775073885062725037363070727380707540887670532427702724263870606457831
10000060205000400030007000500060006080200060200050300070000000500040000060400000001
10623040606586807622508570257620402040655060442070546057535020278030825020403065361
10200040007000400000200040000000200050600060003000200050007020800080005000605020001
10205652744080838850807078568584476350405788705056306420304480307328605724606250201
10700000000060000080506020000000000030006000702000506000500060500000304000002000201
10233447645275385060476040307762505032253020603458202087435050707350606686235045501
10000000007000200050000070200000404000000040600000807020000060600040200000000040501
10842025503080408044503840804570667774265020505440804074386370306050555472606450201
10003000603040507000605000800080000000006070200060005000000000406060000000400020001
10306430503066806470822020366064355064608080402077378757373646625056255270205057661
10300040305020008000600070002070005080006020405000000000300000002000006000508000001
13426020605050808088603026306087606580235050822277673720202064206350306026477060801
10000050606000607020008000806000406000800060000030004000203000200060204000008020301
10372350307425404070204760402660403020767627873030606036202470653040307226405055501
10000060600050205020403000200030007070400080000040700080007000300040700070002050001
10247066286080706040643085364085762065307030664020682260583086503282742360562060731
10500060006070508030008040006070006000307040002060600070500050500000000020800050001
10603050706050205044802270406035402070383040607820705040403450808552432060803778401
10802050800040007000300000504000002070800070500050206000700000203000500030804000001
10406250566375364870307846308023485530806560688052802022267384403050305060725056571
10200060000000002000400000606000400000500050008000003080005000006050005080008000001
10738045777352808056733486205030205357632065503273237780305234455060582056205472501
10003000600000408000400000603080700000008000305000700000600000000070007000608000801
13807070342720206353604860605040837074204670308070308254353525822224444650706560701
10003060000000700000008000302060002060200000706030408000002000005000300000500080301
10422230784768484763428056305042802050707553508060602076406024204080406053236030301
10000040400000500080005020003000806000304000700060803000707080006080608000008070001
10852033803030202080206020506343407064602040765480304380703760465070507088307065521
10007040008040205000603000305000008000200060000020305000700000600080002050806000001
10202060888860304052608834422024445655257388546230507070578778405057337070504664601
10605020000030007000700000003000002000400050000020600070000000403000003000705040001
10806075367040288220468023506342525020704070803030572264687080204458306537503080501
10706000800030000030004000500040008060306080506000600000006050800000600000706030201
10406370502835302078208430344060806280407080807850505282802040402630403630208070661
10204080006000404000400030405070800050702000200070400070007050402000400030600030001
10806058547420804450486040507080637040284037456037356080575480268033376320227034601
10608060000000400020002050003000800070006000500020003080800000600080000070005000601
10503040648067803055304052258238608062405680304840406050505842208364346060807630201
10200060006000303000606000600000005040002050700000807020508000005000004020602000401
10557677605030355435405580807330434540376030402260805057704068474080404020205324501
10000000004080000030006060300070005000600060200040500060002040005030500070208000001
10836757676080266030624030246044468050303540804073845870736040508030227326608050451
10000000603060005070200030004000500060400000603000602000600050504020800020002020001
10363740604043208030205084405230305735302524704570308040804850307080334050237026601
10003040006030003050003000308000306000800000207000704070700000400040000040006000501
10706080738070834057736350304067606030705860406067403047478024754230455865578370251
10407050400030500060000000207020008080608000505000008000005000300060000000300040001
10403070205586604474807726207080353630878062204825755685505050335073207223603073601
10304060305050005000402000005040000030006080003000000040002050008000400070004000401
10608040502020573040755026543057507034404040336020428060835058707760888070544383701
10500020300030000030005000002000204020007080000050008070005000300030003070000000001
10766730765485343328707838602020438080668050657883738076403030685033407720663482351
10005000400000000000204020005030000030800030003000400060504040005000600030000000001
10402362803083526570406030656648657480606478326020802720602543407380262050784547701
10500000202000000060500050000000000000203000500030004000702000600050007040000000801
10625630503030702080224085386534638443405780502467877020603020856624407070764775701
10000020005080404030003030000000000060400000608000700050303040000070006040003000001
16867070483030882030307750202252322020706626803040808070608027743020457047802053701
10600020400050400030500030302000004000200050007020005020407000800050007030007000401
10404040506880606433823080407873206070326030667086868040607660607643505047276350801
10007070500020800000504030600000805080003060000060000040200070500080005080000000301
10824320508050832420603040724070704088287035732266367040457068847080426060538724401
10007000805030000030406060003040007000003000000000003030002000500020007070600000701
10706088736070853240503050306083736430604023675885208884308350507053508070508080331
10506000700040006000307080705000300020504060004000002000600030008000700070007050001
13207450704573273027805073202060805062305820204075367054304048807740375736787627301
10008000300000004000003000007030002000708000805000008000804000600050000000300030001
10434044337544303447784247422044734360708074477770503230403360567350452640507080471
10200080000000403000000000005020000050700060600050800040704000700020500070006070001
10704320604428802033802356203050862070634230706060883060287023303060602047527085701
10500000500060007000500000505000802030000000403080005060007000003060007000007000501
10727752336070834750724340403884204067564644305075782042508088754030874478762273501
10700000700080200070500000202000002000008000004000700020008020003050000000600050001
10403030842480508060804476305084655772803057436650504220804043208045664830408050521
10004030000040205000205000004000000000003000800000300000706000008060003000404050001
18673222432070207767473024662655622588544420607273872225747736678080805060805337601
10000000000030003000000060000000000000000000600000000000000000000050800060600000001
11111111111111111111111111111111111111111111111111111111111111111111111111111111111
