11111111111111111111111111111111111111111111111111111111111111111111111111111111111
10003000600000500000000000000000600000002000008000006000000000000000000000007000001
18808070205057603570666850588350706430308080806024408080822648445024562627407736801
10000080503000002000300040000040008000800080803000400050000000007000000000200000001
10543560606058484062338077524024254050868860705670628530868735603226425770702577671
10000030304000300070003000500060005020800070400040600030000000800040000040200000001
10764020202344607552703830854580604060832050334030777047582070388020883050204035681
10500070005000800000200040000000600080200060008000600070004050700020003000705020001
10307753283030447350405052366325336350706848407048707220407680707687202776704670301
10700000000060000080305080000000000070008000206000205000700040300000605000004000401
10762855846356547040285070406837405054386040203537702075624050707520604258725025301
10000000003000500070000070200000503000000060800000505040000030500030800000000080601
10848048302040305064203260305270443478685070304480706084274650403080767854708730601
10004000607080206000307000600060000000006080500060004000000000608030000000700050001
10302460206056704650334060448075758022808060202074283435642782654077358650203083651
10200080802080008000200060002040007050005030503000000000600000007000007000407000001
13437050506030403082706066406068306820647060846232852230508063604360602023786080401
10000040808000306040007000405000302000600030000030004000708000500030607000002050401
10285250204462702030202560604520502030825837335080407084408640685060408254404052701
10000080200080305060808000700030008030400020000040400050003000300040400050002070001
10342027688070202060735088872024237066707060482070847870342075802757285550634060331
10300070007050408070007020003050008000303050006030200030600040600000000050400070001
10507080804060602078702620803085502040737020504780304040503620704566252020408568701
10606040400060007000200000606000007020500060200040508000800000707000600040304000001
10403430558346757550807862503024486620706630436072603064658454406060307020252035431
10300050000000003000600000506000300000500040004000006060005000006040005080004000001
10834022855722304024568754504070304526672024607456826650802682824070266036705755501
10008000600000804000400000308040300000005000407000500000500000000020005000704000801
15502080526870403452608770408080432077203660207070206337874742543385432230207680701
10005060000000700000003000505070008060800000404070502000007000004000300000600060601
10232360262388664745678066503048605070604845403050407044302065303080503062327080601
10000080800000400080004060008000305000706000200070607000304070006080203000008070001
10527027704080504060804080505365603076704050755870405340303450824060405073407038631
10007070002070307000203000304000002000400050000070504000700000300030006030304000001
10408020557430205065504436675045755352424366888240403020585357307052434070803247201
10508060000070005000800000008000005000400030000040500020000000403000005000205080001
10408044543080337330573042203775752050807020307060655833452040507852407624503040401
10606000500040000050005000500050007020402060803000800000005040200000400000303070601
10803370302246802066303630556060507570206080503630305743606020305640602870408060631
10504050003000303000500060507060700030606000600040300020003060305000700020700070001
10308072862570508480442030207050445070426045234034276050372830232066674820324034201
10604030000000200070008040003000500040002000600060002050800000200080000030003000301
10505060876073705046207088466262207038205530508230305080302685505274352040704870701
10500070004000203000804000200000005070005020700000702080208000004000003070206000601
10363337702050658525802250406520552370652030707760803073204052872070306020308224501
10000000004070000060007060600070004000300020300050600030005050005040500020605000001
10543456432070222030628030734083573070503250204025646250532060803050467286507020241
10000000508070006050700040005000800080300000303000304000700020802050600080002070001
10246350308026807060707024803480608335805577508720202030306680408030474080644075201
10007030008050007030006000505000305000400000504000306020800000800020000070005000301
10302080277040848072263360407032207080803780203065407084432082545420276773446770681
10503020700080600060000000304050003080302000503000007000008000600060000000600070001
10408050705242705722203766408020675460486084505755888583706050847043205545202057201
10607050402020003000308000003020000050004080005000000040003060005000700040008000301
10804080307040683020387087658055703044506080535080736080688052804650355040372474301
10700080200050000070002000004000506080003020000020007040007000800080006050000000001
10576620766783673886505585305030563030546030857236864043302040273058706330632722861
10003000800000000000502020005050000020700020005000600060204020005000400050000000001
10503358603027783370506020472864223330708263622030507520706556808580535070756876201
10800000302000000060500020000000000000805000500060002000703000500020007050000000201
10444540706080608020578065233435628567303450305852766060306040844832507030568838701
10000030006070508070005050000000000020200000405000400050406040000040007070006000001
14467060677060887080504430603582884030208623608040608060205055226040745083405035501
10600030500070200050700030707000008000200040004060006080707000500070008070007000601
10404020808260306544225020307458403080472080257035346070608630504333402055374260501
10007070300060200000806080400000507060008040000040000040400030700030005050000000201
10587520305070285730406060234030202042778087358552587070223066263020452050853268601
10002000607080000040207030007070002000006000000000007070008000800020005040500000201
10804072784080232780202070504056278830504024877244808837403250607052306070202030581
10502000700020007000804070802000800070205050007000008000700050003000700040008060001
13504760208858454065703036404070606078606580507078455083503083805350723765338384601
10004000500000008000003000006080004000608000706000007000408000400040000000700070001
10733048374833505378263864282058365660606086225360805670502250623370774680408050871
10300060000000703000000000005060000080800060700060700080403000200030600030008060001
10502450303764602038307857602070233020568780507020336030246082707030405034357044501
10600000700020008000800000803000504040000000205040004080003000002020002000008000301
10868325577050458880482550404555506042456477803088645076806075558020363277328567801
10700000500070400050600000805000002000006000008000800070002020004040000000200040001
10608040525440706050206877804053573658405088576260505820806052506068254680802020571
10007080000040403000307000006000000000004000600000400000402000005080003000406040001
17544677376060804475758076388268476526487250705663337275447548532050606020402628601
10000000000030008000000030000000000000000000200000000000000000000060400060200000001
11111111111111111111111111111111111111111111111111111111111111111111111111111111111
