11111111111111111111111111111111111111111111111111111111111111111111111111111111111
10004000600000300000000000000000500000005000003000002000000000000000000000003000001
16503080606036504460845650324320508250506030304052803080665877436063787576507373401
10000060506000005000400070000030004000200080806000200060000000002000000000500000001
10563480507073455064887084868052774070443380206440534570784862206774347840304252751
10000060702000800040006000300020002060700040300070600050000000800050000040800000001
10422030807256705227807350737220507050446080642060847063787030325060265020604035651
10500020008000200000300020000000300080300020007000400070008050200020003000306070001
10703423375040522830305062484657754340306624305085208270507470403687708436202480601
10500000000030000070306060000000000080004000303000507000600040600000304000008000801
10742647534658754050655040308674804073755040405286407036338080508540807363662043201
10000000007000800060000040200000703000000070400000508040000030800080500000000020301
10326026802020408055206220403760378454328040603550506067238860305040776488204880701
10002000602050708000203000800020000000002060200030006000000000507050000000300040001
10703450507066706770444020522045485026706070807048334257835884563067448480808066831
10200070405050007000800070002060002080008020405000000000300000008000004000407000001
14835080203040302088404036408025307240653080625252666240503083507680407057227060201
10000040202000605060007000403000704000400050000020007000505000600070808000003080601
10464820208247706040305580503380802050887573344040306042707230722070807465204026401
10000080800060405050606000600060004030400070000030700080002000300040600060005070001
10432055752020702050747033335033436033308020378060444280274034502226848650433020531
10300060007080404020008020004080007000307020003030400030800060400000000080200070001
10306070302080206028202870608047506020353070704550206060406820304225865050505887201
10807050500070005000300000808000008020500060200070802000800000607000200070307000001
10805860465258448480203752608076448220702460485067707038844448602050206020672077631
10200030000000006000600000302000700000300080003000006050003000006020007050003000001
10643038632327808078836246506060806744854077408635266560205777532040484076805656501
10008000400000204000500000208040400000006000308000700000600000000050003000205000201
16203020247440204238702780405080353025707680403040303765685835747485635820506330301
10005080000000500000003000706070005080500000402060306000005000004000300000600020601
10682830557287522738348043607064504020707822504020306037604078607070404055738050301
10000030400000700070005060002000602000405000600080505000302050008080702000004020001
10623084207080402050503050508673502072205040262340502560302560427040507075508038821
10005040007030805000607000706000007000400030000070808000700000200050008050203000001
10402050736780502057308434245064383838863383472470602040278247202064364020602454401
10808050000080007000600000004000005000200020000080400060000000804000006000503020001
10805042584070446860654053502337548080706070802020542436327030206235804686308040201
10508000600050000030004000400070003050406060402000200000003040200000600000305070401
10803470508458408088605570634020407420504040806770307472508080302680502530407020871
10805080005000306000300020804030500050505000400050300060005070708000300030500080001
10808085876470308720355040604080422060327037357066474080267260485026455750388054401
10708040000000800060008020005000500020006000800070006050200000500080000070002000601
10206040764064502085504046855237205028507820503460706030703883503253436040407560401
10200040005000305000706000200000006050008070500000303070603000003000002080804000401
10787257306070578476603370302640232280577020505870302037807047757050805040407767801
10000000006030000070006030500060008000300060800050300080003070008020700020806000001
10582886637040553050225080582022438040807630803025526260762020405080624264705020731
10000000407050007040800060004000300050300000307000502000300020202030600030004080001
10852620406076206080607046204560707367602348702840406070703330404080584060353027801
10003040008020004060002000706000503000200000705000405020200000200050000030006000501
10605080523070374078666350505046803020407570206073208072244068323660684857352270681
10803040200050400050000000705060003030208000207000003000005000300060000000800040001
10608040407842807623305455303070854240732067203674744237308070277088406582306024201
10804080307020002000306000008040000060002030007000000030006070008000300030004000501
10306080505070878050827074824067304053703070853060526070344032802340372030532882701
10200060400040000040007000008000603020007070000070006030005000400080006060000000001
10523640225336778727304357504030762050487040254722252056308050688076405750348457221
10008000300000000000807060003080000020300040003000400040506070002000300030000000001
10806574607045428470607080284558588480602355745050507440407343705260273070423385801
10200000306000000040800060000000000000307000700050002000305000600060006070000000801
10686240402060605040327026833684728684803760506628735070704050233267806060385368201
10000070008020706070003080000000000050500000708000800050508070000030008080002000001
15773060525040827060706460604284346020402365403030308030704027626080465076207068401
10600080300070800050400070503000003000500070007060005070405000400060002030007000701
10804040508430703764754030502754405080884060233052328080607630505683705054423280601
10003030800020400000408070600000608080006060000060000070500060600020008030000000501
10655340206020668430706060732050307078243067653458737030487054653060736030486244501
10004000608080000040706040004070003000003000000000008020005000700050006080600000201
10506022763080388370702020708074578770703055782744505763603720608048405050607040761
10208000800080004000804020207000800080403040002000005000500020004000300070008030001
14806420304234546037506022202030308043407570404043442034406022303470686435634356801
10004000300000003000002000004070004000208000403000002000605000700020000000600020001
10428084568226203728827663362073738860706083387830502280406740738820853280405020241
10400060000000508000000000007030000060800060700020600040708000800050400060006040001
10404660607745407046606353503070738050743750605080624030682086704070702072274063601
10800000500070006000400000306000305030000000605030003070008000007070003000006000701
10644754846050568550653520503474803063867527405053472023405028658080487652283445701
10300000500060800040300000302000007000006000008000400020003020002080000000800080001
10604060288730607080404376702057872655604058775220606340708023705065846320306040341
10006030000030706000504000005000000000006000800000700000402000007060003000203020001
14725654527020506852572023362262238686578370608785364733246444846070406030607444501
10000000000020007000000060000000000000000000800000000000000000000040600080400000001
11111111111111111111111111111111111111111111111111111111111111111111111111111111111
