11111111111111111111111111111111111111111111111111111111111111111111111111111111111
10008000400000400000000000000000500000002000008000003000000000000000000000003000001
14502070405048208360845540646580208380708060303027707050688237425045456873202743801
10000070403000002000500030000070004000300080706000500080000000007000000000700000001
10684360804077342026886057827042662070445320605720385380756322507367266630807886431
10000070705000700050005000600080007030800070300060800020000000300030000050600000001
10262060406463504325704680332870704030758040242020847053245030224030642030403086361
10700030005000600000200020000000600070600030008000500030007020200050006000405080001
10805375542020287330302038524377565770804346603022405450805760807328505572306860301
10200000000020000020307050000000000070003000506000807000300070500000208000005000401
10265357253745585030276040702327506063345040302543802073845080708550706677528057201
10000000003000400020000020200000308000000050300000707060000070200080700000000060501
10777072204050302043304460505760438572487050403820407047466250303030457388703360301
10002000404080703000404000200050000000007030300070005000000000505060000000800060001
10302580302073505370424030466045785023504030308055257435886848257066634680607046731
10400080604080002000200080008040003070004030402000000000400000002000008000802000001
18323070802050405066208023308065207660644050656626675660808066508670705028576050501
10000050203000707060005000704000706000500080000070002000406000200020808000002050601
10382640805376507080808660308670203030382335742040608033708450843060806754307067801
10000020800040703080604000800040005020800040000050400060005000400050400080005020001
10638044484020306020776073235076252037806020452060547880824063406847537660382030241
10800080007020303080005070007020002000705070006050200030700040700000000050300070001
10402080306020503026603520207062802080822080707780206080602240404688742020507522501
10204040800080008000300000308000008080800080200050503000200000407000600030505000001
10707670522724426260606573804055475560602540643022203053822836703070507070252036541
10700040000000003000800000302000700000400050004000004050002000008060008060002000001
10865045872634808064785224206050603475522027205858623320604273857040523078802674501
10004000600000403000200000204080200000003000305000700000800000000040003000202000401
15306030348740607434402250705070582043405340507060208652824764383457822620307570801
10002080000000800000005000802040002070200000302080708000003000008000800000300070201
10888440373247856574642073608077807050502628508040508078706074703080402038583040801
10000070200000600040003080003000606000808000200060403000406020007080803000005040001
10444044606060705070802040502222607072706060282670706680508730466020207088507082471
10006020002070402000202000802000003000700020000030706000400000300040008020506000001
10803030764630703037203845362076477776825258282870706060454783207023628060807836601
10307040000020005000300000002000004000700040000020500020000000602000003000704070001
10705038355060263880225042205347673080404040403070472284544020203425502758705060801
10705000800040000080003000500040004020508040606000700000003040700000800000802040401
10204350203444405054302850322040708750205020607330206466305070506360704560207030351
10404040004000707000800020205050700020308000400070300020007030503000500070400030001
10204064556250505420868080402040578050452024476046773030688240287024655230727025301
10606060000000400080003060007000800020006000200070008020400000400050000020002000701
10403030374068806042306055622562603028802850206880204060707253705424527050407560401
10600030008000503000802000600000002020007040600000304030206000005000002030307000401
10828657402070582388307250707470445750533040507580405034805033525050406030808467201
10000000002070000030008050300070006000500060200030800060003050007060800020206000001
10676788442060325050466070766068564020806270402045284430262080707040853234608060581
10000000204070006050200030005000300020500000405000607000400080406060400040002040001
10377380802024403070302023406320305372506265806340304080304530702080783080856083601
10006050007070002060007000508000806000400000303000408020600000200060000040004000701
10508080288080237074663380707087207030608570704034806032586043278370455378878320441
10805060600060500020000000608070002020508000302000007000002000600030000000600050001
10605050804883208765403347506020458380754047403574833854302030687056407555207064701
10606060408050007000507000002030000060007050004000000060005060005000500050007000201
10503080704040745080337037353038804073602040768020387060388045706860768050783387301
10500040500080000080008000002000403070007070000070002020002000800040008080000000001
10224330837423567874503383602040466030473070827372446076406050255084804720857822861
10004000300000000000808020002080000040500050002000400070406050004000200060000000001
10706824203036574840603030662568743830708487284020705840805664302670464020833742301
10400000202000000060200080000000000000303000400030004000602000600040004030000000701
10746580505070306020245082327763477446303880304285562070605020284746506050747333301
10000030003080308080005030000000000050600000503000300070306050000020003040002000001
18237030255020878080506820203584247050708533608050407030302074465070745083403034301
10800030600070400080500070706000004000400020003060003020603000200080002080007000701
10603070803660305726738050502428405060266030658055548070606380606735608047562350601
10004060700070700000402050700000402030006030000020000080700040700070005080000000601
10367420808080685330503070223070805032438087458332686060535088334070873020348687501
10002000506020000030607050005080002000008000000000002060003000800040002060600000201
10707033663040448770703060707023425870406062442375603733206370602062303050403020461
10405000800050008000502020208000200050505070004000008000400060005000500070004050001
14303850304334537078308027607080406046502370306042486062207085407760752452266773701
10002000600000002000002000007020003000802000605000003000608000700070000000200080001
10368044482822206777244272368028726460402048883370505330204840237480362750302080541
10700060000000503000000000003040000070700040400060300070605000400020400060005050001
10305870407625308043404336402020444020367640404030842080855036705040807065337087501
10500000600040003000700000307000803060000000503030003060002000004020005000007000801
10274722877030787370374430802523204044438274708087786035307027545060826336463386201
10300000600060300020300000704000004000008000005000800030002050004030000000600030001
10707020883420708040805748608086333473707055438720308340307064305084532270602050571
10006060000030302000607000006000000000002000300000300000502000006060005000304070001
15286832577020606588833074332235367572844250806768264623355737855070206070807888301
10000000000070005000000040000000000000000000300000000000000000000040400030300000001
11111111111111111111111111111111111111111111111111111111111111111111111111111111111
