11111111111111111111111111111111111111111111111111111111111111111111111111111111111
10006000200000300000000000000000400000007000008000002000000000000000000000002000001
18506060404056204420254570333850404530507070304028403060574476764087763865308574401
10000060803000008000300070000050006000500080707000500060000000008000000000800000001
10243330606047475035533044258045338050723770605580532340342334402233843630706362561
10000050503000200020006000400070003020600040500030200070000000300020000080600000001
10452070406847805624604720886520602060256060777020746038355030488020835020305024441
10500050007000600000800020000000400030800030003000300040002020300020008000503080001
10203243263060275580404037755255467530303855504022506560704560704424502844608370401
10300000000070000020205040000000000020004000504000808000200040300000308000003000701
10587425367844356030737060502876206086835050708657803077368070804360207787234025301
10000000006000200020000040300000806000000050600000407040000030200020200000000050401
10687073403070405042402370605230433584847020505360703086767420702050635336407520701
10002000503070506000206000500030000000002040300080006000000000705040000000600060001
10705440408076708440634020833025555023207040308025263844758672555035284630803087231
10200070404050008000800070004030007070004020402000000000600000002000002000604000001
13764030207070308065803063606046302440724040858877383330405074705770506056666080501
10000080508000807060005000506000308000400020000050002000606000800030208000005070701
10534260207553503040306530703360703020585868263080404062504560646040808862606035701
10000070700060205030606000800020003030300070000040400070008000200070300020004070001
10276046768020805020245033728038244024306060445080366350726034503768853620737080231
10300050002030608070007060008020007000507080005050800070800080700000000020800040001
10606050302030803076808350206086805050237030707760405070408460802785784030406872801
10604020500030004000800000704000003070500080500030702000700000606000500040307000001
10505240828436425530602667208045736470508820884075608065362434208070506080482057671
10400040000000005000200000408000700000800060006000007070003000004060008070002000001
10272022333882306075346753507080606366543035303377483460406537835080825038407865301
10007000500000604000400000703040400000003000205000600000500000000060004000705000601
13203080387880406768205440605050335053602370703030305534827644862238838640605330601
10002050000000600000002000405060003070300000303050507000007000005000800000300080701
10662560262682472767872037405053402040204323202030207075808037204070306074338020601
10000050700000300080003040003000606000402000200080304000706030004040703000002070001
10756064606040204020705040803767607046405070573460804630302270223030206066204028721
10003060005020505000708000704000005000800040000040407000200000800060006040708000001
10208030575580204045807582772043783655276778677650307060336323304067424050607286601
10403050000020006000200000003000008000600020000060200070000000607000007000804050001
10805047567080244520742064807337537080205030704020643356838070604752702443507030801
10605000300080000060003000500070002070608030703000500000007040600000300000304040301
10204570407643407083205730726060506330508040205640502553303030507430608520708050241
10808050008000207000800030803040400070304000200060600080003030802000200080400080001
10406024832440604280523030703040236060426062535022384040542630562023385480325078501
10707080000000300050003050004000600030002000200060007050700000300040000020007000501
10302030883065208033606034766442702033703870407830802080707484607476645030403440501
10600050004000803000404000400000006020007060700000204030507000007000003030508000801
10656722306030566283405550503260533750556080404330506072504073858040204060208528601
10000000006040000070005070800050004000600070700030700070007070005030600050302000001
10482824374030638070886080478065322030504660206058535670858050205030477462308030681
10000000704040004040300030004000200050700000803000702000700050605070800070003050001
10232280407082403020407055704420707653708563203630202030603250307080344080624025801
10008050007080005030002000306000407000400000703000505060400000800030000020003000301
10306040433040583067886680608035708040206320405056403057625074337750583643237850781
10806020600070700080000000802020004050206000304000003000006000200050000000700050001
10208040503527804664802637705060345450876072506542727522804080344042404334807053201
10306080207060004000808000007070000050007080007000000040004020006000200030006000501
10408050208060726020327043347048503065708020822080346020822036707670244050685554401
10500020300050000030006000007000204060003050000050002030005000200040008020000000001
10776640724877465432804683408030872080443070255647353025405080285057603470734836281
10008000600000000000707050008080000060300080008000200080307040005000600060000000001
10207323406068664570404020264668426580303582275070305250805578702550282030734478701
10400000705000000070800080000000000000202000400030005000807000800020005080000000701
10743840707080206060764027888273268767503870203488266020607020854882203060322584201
10000040002050203040005020000000000080400000303000500060807080000050008080003000001
18484080542040465070803580506382878030808685402060508030306068633060623052306075401
10300080800040300040400080205000002000800060008060004020505000200050002040006000701
10505060204750706566884040404575507020672060484086672050806760708843406048582770601
10004060300070800000808060800000803050007060000040000080300040300040006050000000401
10488650406060755340503080887060507056523026872637544060672042437080838040754267501
10003000603070000070502040004030004000005000000000006060005000400030008030200000301
10506055473020752360606030402034232360708042384458805488708270608036602060706040451
10603000300060003000807050702000200080804070006000008000600030005000400080007070001
18405250502743565062308048408080703087408250805058276053408064607430853575472668401
10004000500000003000003000008020003000502000403000002000304000700080000000200030001
10637046233385808586548657476075866550202077742760203740303520453360262480203040341
10200040000000403000000000003050000050200060500020400020708000600030700080003040001
10302520405866203054602828505040355030538820307060575020742056504080607076824078601
10600000200060003000500000208000207060000000305040007070005000007030002000004000701
10343643456060223320524240805428402035324444603068645022704048436070233562758875801
10700000400070400020700000802000004000004000005000700070006080002070000000800080001
10306080732430708050702845305056532746202062865370607380505078507085577540408070761
10006080000030706000508000008000000000008000400000700000502000005020004000802060001
16525272847060504537428054485463765556827260804488824448682667455020407060403778701
10000000000060005000000060000000000000000000300000000000000000000060500060600000001
11111111111111111111111111111111111111111111111111111111111111111111111111111111111
