11111111111111111111111111111111111111111111111111111111111111111111111111111111111
10007000800000300000000000000000800000004000003000006000000000000000000000008000001
16804070504028404360667460362660505430608080304033506050453757576058473388703264401
10000060505000008000200060000030008000200080604000300050000000007000000000200000001
10452780506024882056585052387074355070758670706640726350467782605873364430604273581
10000070805000400080003000400060008070800050600080300070000000600050000030600000001
10744040707558207866206880824250706080287020264070287032434030727040372050305045881
10400040004000600000800080000000300020500060004000300040006040500020005000806040001
10707855785020244640208047687852677680203456703056803880405260506785605286708640401
10200000000040000080505030000000000040006000605000703000700030600000307000003000201
10885886725842748020848060502467707055228040604784402085243030207630706386282055301
10000000007000200050000050500000302000000020700000802040000070800060300000000080601
10634027708060203025707580403580844582786040402780607058667240502040864575703340201
10004000502070406000604000700060000000008040200040005000000000203050000000500020001
10503640503042306670577070555055486035708050308053348678344352554058425870203083751
10200030607080005000200060005070005070007070803000000000500000008000005000204000001
12576020405040405076804083205028208540352020336664572380306033304520307062677050801
10000020807000207070006000507000403000500080000050005000405000500080605000002020801
10224450204286705020308220705240207040236257655020604057604770244070402248305054701
10000030200020308060503000300070004060500030000060800060008000400020600060006060001
10834073374080405020623036853044246058305080647020276370683056505234832550482040571
10200050004070802020005050007080008000208020002020700020600080400000000040200080001
10802060305060503086806860307048702020668060408430404060805240503527376040805554401
10808040200050004000500000207000003060300050200070207000500000702000200070807000001
10407840462555856750308484604055732250203580654056505028452757503060405080453025851
10200040000000004000800000503000800000400050003000007080006000006050003080004000001
10525032733746808036877736603050706282383022206742735460304262478070854027806737401
10007000600000508000700000206050200000007000805000600000600000000060004000605000701
17403030587760605846703740506030648056202380308050706335832285484253475420806840301
10007040000000700000006000705050004040800000404070208000006000005000300000500040201
10884370275458264884648025308053603030608372306070604073708084606020505068888020401
10000070200000700080008040002000403000506000800080303000608070004080808000004070001
10635026307050602070205020604364708085607020544420704380405270736070206082203033721
10004020006040605000205000303000004000800070000040806000400000500060002080804000001
10204080773670604067503742677048668457836428568450506080487364306047222060308637601
10406060000040002000200000005000007000600050000060400070000000402000005000404030001
10708023766020556560233043803766555030808080507040848458273060303476802652708040801
10703000400020000040002000400050004080608080707000700000006070500000800000408080301
10402650706864502058606730566030702720507030305750403887606020508860202530704050781
10703040005000405000600080508040300060808000800040400080008070305000300060400050001
10502053856430306350436070402070568040873032725048476040778870337035255230322082301
10808020000000500050002030008000700020007000200060008030300000500080000020003000801
10503080347042407026702083835388402043405350702340406020507745402845356080405660701
10200050005000504000502000600000008060006080400000405020304000002000008080707000501
10875527207060263465204760204360466830788080708670602034206023424080403080808284701
10000000003030000080004040500080007000700030700070400070006030006040300070403000001
10723265262030743070562070488077256030603720508054576460744050703060276734403070431
10000000502020007050300050004000500050400000808000304000600070307030200040007040001
10682380603025805040405064805670208735202758408830304020205530806060626080266067501
10005080004040004040002000202000505000200000606000206080700000700050000040005000701
10603040582040768032582260707066406020207220504054302086633072627330585866244720781
10607040400080800060000000803050004030703000402000006000007000800040000000700080001
10502080608428802335502476304040627630867055702453745652405050264086802538805034801
10207060405020004000803000003050000030004060006000000080006040004000200060002000701
10205060203080628050638036644078304035203030524040462030566063406270442080546335301
10200050500030000080003000004000205070004050000070004040004000400060005040000000001
10538420345425325678807255508080543050346050665842842088502030243073707580354277531
10008000500000000000203030006040000030400040002000700070303060002000800070000000001
10604482408087735840302080374576677250303646243040608580805847508850688020766824701
10500000807000000040800060000000000000303000600030002000407000800040002080000000201
10672880606020304080765027363548777575305250304828375040204040382574205050356452401
10000060002020308020004020000000000040400000202000700030308020000060005030008000001
15752040627080638040308470305358566060302854702040406060607084845050784087504033201
10300060800030700050500040707000007000600040006040005070606000600080005050003000401
10206070808240202882528070308534206070332080342088454060302320405288507074732650501
10007060600080400000303060300000408040002070000070000040500020300020008070000000601
10323370408040686480802020733050807054554057566363355060565033823020436070227254801
10007000503060000050203020004080002000006000000000002030008000200030006030200000401
10308045238060747460202050708057578760204074257423405452606830705056608070702030681
10202000800060005000206080208000500070806020004000004000500050007000200020003040001
16803520506582365055406072408050803074708550404027736088202057504540524754264776601
10006000600000004000002000004020002000704000208000002000404000500050000000200020001
10257033553783402778363283865073742540204085744220802770705680326440848240805040231
10300020000000208000000000004050000060300040800060800030606000400060700060003070001
10508570605722703035506362502040254060232660506040477070722066305030305085283057301
10500000700060006000800000603000705050000000604050006040003000007070007000003000501
10635855775070543860653330605527802023632842807075425043503066246060868867455466401
10500000500040700050500000202000008000002000005000800050008030005080000000500040001
10307070375520703020308348607045836486402063543870406250707028408045234860705050671
10008080000060605000506000003000000000002000200000700000602000005060003000506060001
17355868882050608466566053623678385828642470306572768548225625632080405080808762501
10000000000030004000000070000000000000000000300000000000000000000060500050500000001
11111111111111111111111111111111111111111111111111111111111111111111111111111111111
