11111111111111111111111111111111111111111111111111111111111111111111111111111111111
10008000700000800000000000000000800000005000006000003000000000000000000000003000001
12408080604062705830258380425560604540705080707024208060484477834055868667402785801
10000040405000002000200060000040004000800080707000700060000000005000000000500000001
10236850303065232028742042763034264020575760808820635350827852405833465380705586771
10000030607000500040006000400060005060700070800060600080000000700080000070300000001
10487030802654503332302430782540608020748060255080242056746060428030373030704082631
10700040008000700000800060000000800030300040004000500050008070800040005000606030001
10202355628070223520703053888472426430203725703026607270508330703746306766306550501
10800000000030000030704050000000000080004000208000506000500080300000603000005000501
10857863535482285020885050507286204024824060502838307085856060708620603742856052501
10000000006000700060000050600000305000000080300000402070000040700040600000000020501
10676047608070208024205430406380464655824060306520403026734330406030838274403740501
10006000704050205000404000300030000000003060800080003000000000208050000000400050001
10704530703078207670434030462045527076503020404086363363555278242057833630707044871
10200060607050008000500040004070007060004070607000000000200000003000008000307000001
16846050706020804025403087206064406260357050276262456860607075306680507067683050501
10000080205000706030003000505000602000500030000050004000804000600070207000002080601
10626420706257605070504650408230706040278288273040702056806780836040508577203063801
10000060400080406080704000200050004060300060000060800020008000600070700050008020001
10364056634030402070337083254027853083604060225030622320346075505277564280222030721
10500050006060407030003040003040007000504080005070600080500070400000000050300040001
10504080304040408034204340603088306070364080805550206020807670806785356080402458301
10203050400080005000700000602000006030800060300070702000800000402000600040603000001
10308230624743743420407286407022632620804630747065508077243344506020606030782088471
10600040000000002000800000606000400000400080008000003020004000004050007030004000001
10637076877884707085225266402050706462724046304432664280604633385070456037702868401
10006000800000207000600000606080500000005000202000500000300000000060003000806000701
15408050274540206284206870602050846038202770705020207458474867442477375240404830501
10006030000000500000008000603070005060800000806020505000008000008000300000700070701
10738670588734637865722058506042402020802348403060508088503088703050406035844030601
10000070300000700070002040003000205000508000200040706000503060007070204000003020001
10352085304060504020202070206373502057505060522560208880203740324080803075302035681
10003020002080605000208000407000004000600040000040603000200000300030004070705000001
10406040474360204037606653878087835463474532538730708050875744806027548050605348201
10202080000030007000300000003000006000300070000080200020000000707000004000708080001
10408057558070377820363062406252862030307040406020284443758070605455707443805030501
10706000500050000070002000800020008040804030205000400000006040600000800000708070501
10504540402427305078206430322070602580304020506820404772505050804880308650505020861
10305030004000408000200080207040500020608000400020200080007040504000400020400050001
10807067723370807620677080803020436020534058746052253040353430675037882460252067801
10706070000000400040005080002000400050005000400070006060500000600060000050006000501
10704070638045205043608027885664502066707550205340604070703847507226268030702370301
10400080005000704000605000800000002050004040200000307070206000006000002040706000601
10325428706040333338702430408660572630426020805570706045805065668060802030606266701
10000000002060000060008080500060007000400080800040600020004030008070800020403000001
10558354248030538080348060468047843040503720304038747620272080807080875247804030641
10000000802020003040800030003000500040600000602000706000200080606050800030002030001
10565440702078202070504046404740408576306843408840805030605560603040754050673026501
10005080002080002050003000206000405000600000503000402060800000300030000070004000301
10204070687020485024287660202075503030308450707043805082544047325640473667234570351
10206080200060600020000000305050008070705000807000007000006000400060000000500050001
10508070805777807856304228302050572440232084602755487865207060272032306487602062601
10305040607080004000705000004050000020005070005000000020004060007000500020004000601
10807050505060345050352045333022408068802040488070257040752033706240454040835728401
10700070300020000030003000004000808030005040000050006050002000600080008050000000001
10854420342336484624208743802020635050527060356842743066703080476043606370734444761
10004000500000000000205050006080000050800080007000400050202030003000300050000000001
10802654203085868530703060446362846470702435732030208260404287704680558050286687601
10600000706000000070700040000000000000503000600030003000605000500030005080000000501
10483770203020402030254077288346367378703780804823468050205080253275304070235658201
10000030004040506070005070000000000050200000702000700070408030000030004060002000001
12243050277070634060808650507267424030502222207070207070503057325030552082607078501
10700030700080600060300060707000003000800080005060002030504000200050007050002000501
10804020308260703758462070404248203050636080887052755040807750403224407026435370501
10004040400040300000302050700000303040003040000050000020400030600050006070000000801
10434570702050234450405050422040502072522063746726852050667053768030742040666532301
10007000407070000080406050005050007000002000000000006030003000300070003060600000301
10704045872030837360807020805057574670606038547248605723307480605026308020702030671
10605000800070008000203040503000400080208050008000002000300070006000800030003050001
12804220808656735072408047605070303058704520508062432082203032607420823777568465701
10007000400000003000007000003050005000607000204000007000406000300050000000300030001
10587057526242308635536332386075882640407084443740302220304470864420726230507060221
10200020000000703000000000003070000080700070200020500050304000500030700040004080001
10408630505837207084604744302080625080388420807040365040234073407080308076346036601
10400000600030007000500000708000303050000000807080004030002000006070008000002000301
10577548285070828540372250202774806076783625508072726077208032363050367823453342301
10400000200060200050200000302000004000002000007000800080002070004030000000200050001
10607040268580708030707358506067547357804068745870607740403054708054645520302070481
10006080000040604000303000002000000000003000400000700000702000005030002000504040001
15748582587020405247328085666842425582372350704852444786244765778060202070708224701
10000000000030004000000040000000000000000000400000000000000000000060800080800000001
11111111111111111111111111111111111111111111111111111111111111111111111111111111111
