11111111111111111111111111111111111111111111111111111111111111111111111111111111111
10004000400000400000000000000000500000006000004000008000000000000000000000007000001
13808030704045403570675480233440305650807080605067505040868782446023677725508246801
10000080308000006000800050000070002000400040507000600070000000006000000000500000001
10878670505067537022263047638033287050263280705770823350432342507332667860403676281
10000040308000800020003000200050005020800070200070500020000000300050000080500000001
10355050502264505847706740872460405070658020464030262043585020282040328070605022551
10800070002000800000700080000000400080700070005000200040002020600040008000403020001
10304668884020743750304052632463243440706488203034205670808730205827305887506760701
10400000000040000030503030000000000030007000204000505000800060500000705000002000201
10636884865586538050637080705237603072726020307778407075237020806730408538738064401
10000000005000600020000070200000302000000060600000708030000080500050400000000080801
10388025507020206042607770405540246285236020804620504063462250402020544347706750301
10006000808040607000307000500060000000004040300080006000000000807070000000300070001
10204460805054704650652040863067465072807050204032636545373763776023527580606074661
10700050403060003000300020007020004030002060304000000000200000002000008000206000001
12376040707070205087207087505074602730535030477558237850702058304580508023235040701
10000070802000205070007000704000507000300040000070008000603000200030304000003060401
10564720603747802050802780303350406020673278637020704032204580264050605255306063801
10000050200020703020807000700020005020300050000060400020006000800080800040008060001
10374076746020206080674084528038358082307070566030648480888073203254752750722080871
10700040006080708050003050002030002000202030006060500050600030800000000080500070001
10807070308040405043803260308058502070238020202720507050407370404424848080405735301
10507070800080003000800000605000006040600020200070805000200000308000400030705000001
10504580676674726550803373507085442360408640433044506075535374302030406020765053251
10800030000000006000700000704000200000300070008000007020005000002060002040006000001
10432064632853408067723272405020703535277036204373366250304752588070566042305876701
10008000400000704000400000205050800000004000805000700000400000000080006000202000401
12808070267650604466302450506080848057708840504050207855477655633667675840506540701
10004050000000600000008000204050004080800000506050206000006000008000500000700080801
10583820883755422465653064406066808080202344706080202034807045605020705027787030201
10000030600000800080004020005000805000408000500080302000506020004030607000003050001
10633045302040202030308040703867708065605020555270807730706320763030404075503036251
10006060005080706000705000202000007000200050000020602000500000700070007070803000001
10404070847620702054604825264072553823734533368680408060753745406048372070307737801
10307030000040007000300000008000008000200080000050400040000000702000004000402020001
10304068883030847330544022206443647060608050307040857668686060407456207475605030701
10308000500070000060004000800070003070306030408000300000004040700000500000208050301
10204480702435808064502670866050302540502060306470405462206080307840207270603080761
10608020008000407000700040406020500060604000700030400070002070703000400080800070001
10604073732770305380643030707020356020683075756042434050768630455028887820743066301
10502030000000300020007060005000400040008000400060003070800000600070000070003000301
10602070357044308032807022673645307033706470505670807030304325207888365060205670801
10200020008000804000407000200000008030007040300000205050702000002000002070805000201
10482226805070628444303520502470284520383050704720302054404058655030708080704432401
10000000004040000080005030500020007000300050300020700060007050008050300050306000001
10234857722020454030736030543083644030702650308035487440753040404060676467304070331
10000000505080004020700030002000200050700000806000405000800040702050600080004060001
10776580405055706080608037808480506458704465706280506060402560206070788070273042601
10008050005020005060006000307000604000800000403000806040500000800040000070008000601
10506020237080786076368350602074207050504320302084604033245042648240675758244220661
10402060800050400080000000602070005020606000808000006000004000400060000000200070001
10606060404554303685806224302050635640832035702488275862206040484033704487204083701
10808070808060006000806000003070000030002040004000000070006060002000600080005000701
10407070805030383050562086836046708038403020657030344030384048508820762080778633301
10700020400020000070005000005000705070003060000040005060003000200030008050000000001
10352630388385473632803387304070477060687060565754455087408050224052804320332587581
10003000500000000000408080006020000020600050006000200070505080008000500040000000001
10403732203074445780705040332876223440605678234040508840604478606780453020242872501
10700000503000000060700050000000000000403000700080003000707000400080005020000000201
10254250504050504040457062646626722563206230503758384060707080425685708080842426801
10000070002060807060006030000000000030400000408000500030808080000040002080006000001
13487060433040264020505730203322543050805786704070406050705074787050354052303048201
10300060500040700050500040405000002000400070007030007020205000600030008070002000801
10402070308380408722576030306366506070872040663046538040807880404243507044832620401
10006020400070400000808020200000402060006080000080000060700050500040007030000000701
10784420406080747680606060724060303082655084868442778020647054265040728030576485401
10007000302050000070302020003040007000004000000000005040006000600080004040200000301
10602056532030784850702040206034546730504064657683303668204640605087607040508020761
10202000200040003000402060607000700020702020005000006000700030002000300030007030001
14803340405275255085604022204040604042805880703073833066207023704750475847888746401
10007000200000008000003000003080003000303000707000002000606000800050000000700070001
10242045833782204884448662773023463770806023786450407830308660452650683450304030221
10600040000000205000000000003060000070700050700020700070307000200080600030005080001
10506580703664207073207837308020278040743320803020284050236072507070206052544088601
10300000200020007000600000807000704040000000706020007040002000006030007000003000201
10436342848040234520885270508584608077355853605034687068606056553060423652567554701
10400000700050200060500000303000005000007000006000600080007040007070000000400050001
10604080435750405060603785504036277537505072486220807340608023405023768670204050471
10002040000080806000702000004000000000002000600000400000707000004040006000608020001
13324337274070803852252058556838575737683230802685777676828535768020507080608462501
10000000000060008000000030000000000000000000600000000000000000000040800040500000001
11111111111111111111111111111111111111111111111111111111111111111111111111111111111
