11111111111111111111111111111111111111111111111111111111111111111111111111111111111
10008000300000600000000000000000500000003000003000007000000000000000000000006000001
13508070608058402660655680378230402460205040305036604030842377768072544582807727201
10000080203000004000800030000030005000200080406000600030000000004000000000300000001
10258540207037847047245072468045252080523380702630373580373622408538657360605537881
10000020505000300020002000300070006080800050200020300050000000700030000020200000001
10766060606785808533204380578620602080774040287020438032253080633080687080802053581
10300040003000800000500070000000500040200050007000700030008070400070008000503080001
10802275654030326750707055453748635840706434407053406440203540408275305462607760201
10500000000050000050605070000000000040003000502000708000200030800000402000008000801
10375385765777328070586060705327603076678060705362702048426040808460206622753033301
10000000007000600070000070500000303000000040700000805030000070300030500000000080501
10844063706030707067608880508770687466656020307440504062553640504050878764708370201
10004000708070707000403000700070000000002080300030007000000000805050000000300070001
10305750706083302720463080346047482073705050806054358355242447388022664680802032251
10800080304020008000400080004020003050005020802000000000500000003000004000803000001
17558020707050502074706032207046505580328080674423224480402087406780807083853030701
10000040602000708030006000405000503000300030000050008000706000300020507000007060601
10784370406255307030408460408230603020563667558060706057206450847060208545504066701
10000040300040403050807000700020005070200070000030600060003000600040500030007040001
10482053654030705070635052522032668082706060345060428820322062506542775370585050881
10200030008080308080002030004080003000303050004080800070300080600000000030200070001
10504020805070706065504560404063306080628040408620508030805660308584622040406882501
10206050400060003000600000402000003040500040800080707000800000603000300080407000001
10802870855253634350707352608072458220502270836063808033228327206030602070334043221
10700040000000008000600000407000800000800080006000004080004000004060004040006000001
10674046266582705047664572202030605528728088802374542280706257524030534054406743301
10004000200000505000300000505050800000004000705000300000600000000060002000608000201
15803070878730206326702540807030725034202870608070308543666742875454752730603560601
10003020000000800000002000502050008060800000502070803000006000002000700000700060701
10637350847336664887233053505068706040607262606070406035205058305060207057868030501
10000060200000400030008070005000307000404000200060603000804050002050404000003080001
10463073207030504020306060805752605056402080542870204760206870885080605065404075451
10006070008040203000205000807000006000700040000060402000400000600060004030704000001
10505070465830402043505373883076845255434464356580304020724842805053242040203276801
10808080000060007000500000008000002000300050000070600080000000305000008000307080001
10203026657050462220733047303567682080508020208020526623277040803677602478307040401
10506000600030000050006000800080003050506040405000600000004030200000300000507080501
10804450706226406056604680767060303530405040608750703656803020306830806370406050341
10304050002000306000700040402070200060208000700070200050004040207000200050200070001
10204023227360404680228070703070573080327065238068237070774620345078467430563076301
10206080000000400080002070005000400080007000600070007050800000400030000050004000201
10606070857033206025605086223425305028307470408880707060702383402642886040308820701
10800070006000606000605000400000008030003080800000502050606000007000002020403000501
10572468706060536832807880706250735830342060402340408066206087622050305080408328401
10000000005030000070006040300080002000600050500020200030004060003020700050206000001
10234546653020723060475060435046878030305380605085456350466080504030453777504050441
10000000205030007070700070008000200040800000703000205000400060405070500070003070001
10363770303047306070302057506550303255806357206470607070407330502070845020282064301
10007060007080002030008000307000402000200000405000205040400000800040000050004000201
10604030843070722038633780803076503060406380703053202076273027372730226362384550871
10408080700040400080000000502050007080403000403000003000005000200040000000500050001
10508020506287504387603666607040277860653074305435425464303030356064305685604076701
10708030602040007000506000007070000020006030007000000080008050002000300030002000301
10707080504040555080248045722036505067205030773070774080235077506370346040544674201
10300040500020000060008000004000602070008050000060006070006000300060006040000000001
10265470825688682366403355707080423040746030344226884055606050557028302830843445821
10008000300000000000404050004030000030400060006000700040706070007000500080000000001
10608735304077762580806020777763477470704577235080405630803226805880477050385237701
10800000402000000020800070000000000000505000300080008000302000400060002080000000701
10738570407020407040426054323377354673205420602263627080806050887657803080274243201
10000060004060503040002050000000000020800000506000200060808040000040005070004000001
15858060682080257030306720703838466040508845205030504060805052463020267084606054201
10700020400050800040600060805000006000600060002080007080502000800050008080007000801
10807070606380403326676020504753603030786050557034666020605770808658505084336860401
10006060300030600000807040300000204020004070000030000020800070400030004040000000801
10682230505040887220202050246070702038373027642743534040743065723020657030532574701
10002000303020000080603080007080006000004000000000005030006000400020003050400000701
10205086482070768540707080608034543660302046785468405526503380703083804040606060371
10803000400020006000202080504000300020708020007000005000600080003000200040006030001
16503240803783474035303057302030206042603480606046674025403076508640877875585782501
10005000700000008000005000007050005000806000407000008000302000800020000000700050001
10332068346332807284378553236076824270308055354870207260708780877880554470502070731
10700050000000606000000000005080000060200030800080600020707000300020500030008080001
10207380404778204032407266203060727070438270506050556070428037308020605065324027301
10400000200060006000200000608000304040000000406060005080004000005060002000006000701
10747672482050633320833280208364206047353685405034466076404033688040724237283563601
10200000200070700060800000402000006000004000004000400070008060008050000000300060001
10808030382650705050206547305042337357703047457560704220205052508052555750706030481
10005050000020805000602000006000000000002000500000800000707000002060005000403050001
18787233756040205546467054752632682332458660807822357553287256384050404080607884201
10000000000020004000000040000000000000000000600000000000000000000080600070800000001
11111111111111111111111111111111111111111111111111111111111111111111111111111111111
