11111111111111111111111111111111111111111111111111111111111111111111111111111111111
10002000600000800000000000000000200000006000007000006000000000000000000000003000001
12402080703073308820883680748340405340208030205066205030464646558053237653305772201
10000020502000004000300080000080005000300030304000600070000000004000000000400000001
10877440803044333067753076257076387050885520407420583620283222507558287670802374561
10000030308000400020002000800020007060700060200030400020000000200080000050700000001
10422080708377303432508660522660508050585030646040674067767080578030476080702038371
10700040004000200000200070000000400030400060003000200060002020800040003000306060001
10403854527070646670302083652546627520802585408087303540302280502375407573802760501
10200000000020000050505060000000000040004000708000207000800020300000304000008000801
10752556877728242060346020307352404042264020206586608068647050808380207288538065401
10000000007000600080000070200000408000000070800000605080000070200030400000000070601
10775048205060306026802430502830254535578030705260805053285430605020637654205860301
10002000207020402000205000600020000000003020300060004000000000308030000000800020001
10804440307076403640452060463072288022707030404042456226766323525072256550606052541
10500050504050005000400020006040003060007020602000000000800000003000008000207000001
14323080707070202055702088205047504230863080757363732660608086606770208068462080301
10000020808000405050004000206000504000800080000050003000503000200080502000005030201
10757850305822202030703650407870306030762546685020206067206820755020605458603075501
10000030300050803030705000300040006070500070000040600040007000600030400020007020001
10246022446070705040828084556056538046608080252040725520284063403867474250484020521
10700050006080508020003080005060006000704040006030300080500040500000000030400080001
10504040703060405042708730507066708020837050406370404070805580807322777040306827401
10605050500080006000400000408000005020800030800030402000200000508000800020207000001
10603440358556465670702846208087484840207870484065702062683224705040503020363033661
10400040000000004000700000302000600000200030006000007070003000008030005050007000001
10487043648257504085652766307020505784577085705543242230608348234030356065604266701
10007000300000706000600000703050600000002000204000300000500000000030005000508000801
14407080468430507342505770807070543036505440804070702248347282563663687270806850501
10002070000000200000003000202080006020300000705050202000007000003000200000300070301
10365420238544863662562075303067305070403324503030507072804043202020402088646060601
10000050700000500060003070004000305000602000700070608000803030006070405000003030001
10368068208020307080705020307282306046204040353570807230603730876060604042304047561
10002040007070303000406000304000008000700060000080405000600000700030005020802000001
10808080656250306025407675226048277526838835863370508080665457406052453020408845801
10508020000080007000300000005000008000400030000040600050000000202000007000807030001
10202026566060425650635047702437538040708070305050688766265050607778805768204050701
10208000800060000050006000400070004070207020206000200000007070800000800000703080601
10706230803862805088802360875020307860405060204560805265704070607760306720605020761
10704050004000807000800030803040700070507000400080300050007060504000300080800080001
10803086657220806370387020702060642070682027556027248040673470357073234470428067501
10304020000000200020005050007000500070005000700080002030700000400040000050004000401
10704060267088306034702035465623305084306820808630806070202232402272847020604750601
10600060008000308000204000600000003070005060400000204020408000008000005070202000601
10483648207070872777305320707560774540648070506480303027606063332080708040308667801
10000000008030000020008050700050005000500060700060800070006030003070500030303000001
10848325473080348040328060562033442060202380208058543220326020602040776634406070341
10000000505040008070800020007000500020500000204000808000800030604040400040005050001
10872520803058806080207036303650203244202635406570807080703440308030277040422034701
10006080008070004040005000408000304000800000608000505040200000500020000050005000701
10705020247050265073387740606057202060604660207033302024875082845440567624886280881
10706070300080700050000000304020007030607000702000005000003000400080000000400030001
10204040308888307284405346303030724470256045806672454368408020274055708826306068401
10705080207050004000602000007050000040008030007000000070008080008000400040002000401
10302050404070678070822066273073408072808070256070437050847088702430827070533622401
10700050300030000040007000002000705080008040000060005050002000500070008030000000001
10758340263743587248804867307050235020836030742455858055804060263083304630866832751
10004000300000000000402040007080000070500070003000400030802040003000400020000000001
10604552404076848840404050738473462360705344628030604420402477206530364020636663601
10200000403000000060600080000000000000805000600080006000306000300060007040000000601
10624370503070705050744087655238876855802250407864447070402050868872805020762658401
10000020007020602040008050000000000050400000502000800080403030000080005060002000001
14235050634070743070404580707258772020605686605030408080406027738050643033802035401
10800030500040300050200080704000003000600020002060008030607000800030002060008000501
10707080702580408873344080805663505070737060857068886070507630206384206047427850401
10008070600050200000805050400000408030007040000080000020600070300050008040000000201
10475860804070876280604020565040207053656042422283636070436047866050657030783688501
10006000708040000060208050004070005000004000000000006020002000800020008040300000301
10706064448020688680708040305075628560603084752462604546305730302047307060806020651
10206000700060002000506050804000600080306060002000008000400080007000400080004080001
16402280806488625043504068806030602035605480608023325072702026604620588852726773801
10006000400000006000006000006050007000205000606000003000405000600080000000700040001
10383067765535202454457425288043366860604082834430504440407880466840576860808070221
10400060000000605000000000004030000030400060600030700050705000200030600030004030001
10208520305867504083407657807040854040585880803020425030476053702030206077248073501
10300000500020002000500000508000502070000000804020006060008000003080004000002000801
10722528633060823220577580505328404083654232605044823087404073838070473865226332201
10600000300030800050200000505000003000004000008000500060005020003030000000800020001
10202050252320807060807445205033226586208056266680602740706075305038546230605060441
10008030000020804000308000004000000000008000500000500000505000003020006000607040001
14877553245050406735877037886643326882662270203425426654687622582080405030602266201
10000000000080008000000020000000000000000000700000000000000000000070200020200000001
11111111111111111111111111111111111111111111111111111111111111111111111111111111111
