11111111111111111111111111111111111111111111111111111111111111111111111111111111111
10003000500000200000000000000000500000005000004000005000000000000000000000002000001
13807060406034508240758570783880502260807050807065502060667262773054788472203725801
10000070806000006000600080000020002000500080608000300020000000003000000000500000001
10586380503032256046884074478083467030556250706620456670744754504368275330705445561
10000070503000700060008000600050004050600040400030600080000000500020000040800000001
10755070603325805386204260434360402020455070237050647056366080284050244050404078421
10400070004000800000200020000000600020500040006000400070002070300080007000404060001
10607526665020242850605065727656427540505224304044202350306850608823403253504780501
10600000000030000070303050000000000030003000304000507000500080400000605000005000801
10664453467874265040332020602722803053626060307526805022674040203280202345655082501
10000000004000800030000050700000206000000030200000804060000020400080800000000030601
10638024602060402033303580303550455285752080303570606033328750704040476762508620401
10008000505060805000704000300050000000005080700060006000000000503060000000300080001
10706740305063505840427060223038662026304020306087237752283383427082737750306076241
10600050508070004000700080008030003060002070208000000000200000003000005000808000001
13882080807080206066504084605077604240465040227254642220502076206630708056278050701
10000030806000506070004000307000306000400080000070003000607000300040402000006060701
10672280602774508030305230503360802070868738453020503068307630574070403626404072401
10000030600030305040306000400080004080600020000040400070005000600020700050006040001
10558022523070206040284023823038878042507050432020455550322033208366236440265060771
10600030003030703020007060007060008000604050005020700030200060700000000060200080001
10603030708070202076803760504055307080858020703720202060707730602646257050702353301
10302070700060004000300000604000007020800060300020804000500000705000500080402000001
10608850267874752750304723803032436580406320356033204067368823602040506080734064681
10800040000000005000300000603000200000500050003000007070002000003050008070002000001
10683046728868608052882458604070403476434066205468356620802328625050235062204842201
10003000700000405000500000403040200000004000407000300000600000000070005000702000701
14406030835650707687302420708050284024702640407020807676845687256773262780208650701
10008070000000300000004000207050003080800000608030803000002000005000200000200080601
10453870664456428653236043402033206030205324604080306028404024708030802062233040401
10000060300000600030003040007000802000402000300080606000706070005050703000007020001
10665088208020608020507040508868505046302050647530705270704240787030806077802038341
10004030006070504000702000402000006000200030000030207000500000800030002050703000001
10607060355330402023602525765083434346387235658660202050372822704028347040404735301
10407070000070008000200000008000007000600020000060600020000000604000002000807070001
10208083424030828760682028508643667060604060307020263367324030407267602675804020301
10503000600070000060002000500060008020502070506000500000002020600000800000707070201
10204220704464406035408520246060202620408080803860207624806070805830803320706020671
10304060003000805000700030808050300030204000600080400080004030504000600040600050001
10707056363630207870488040808030788080442087274086882060442380423076387880555043701
10206070000000500070007050003000700030008000600050006060700000800070000080002000801
10205020632067304062702046875326203076203870202320702060606754607566747030707340601
10800030003000407000405000800000003080006040600000805060503000005000004030206000501
10484338303020363627706440305720852480634060304820805057306073347070606070502684401
10000000003020000020002050600020004000600020800060500080004030007020200040803000001
10552485622070547070778040772073482060805650602075557750684040805080872233603050671
10000000703040006070300050002000700080400000207000804000200080306080700060005080001
10465780206084508080802054308460307556302748207840506060605880305040335030425037501
10006050004040003080007000703000408000800000702000705080600000700070000060005000801
10808080833040762076586470207045607020407620606056503048887047744580727624272770651
10603020700050200050000000607060002080603000203000005000008000700050000000600040001
10505080306287605886607385805060577420454055306322242257507020684024807774405066201
10303050702040002000804000007060000080008060002000000050004060008000700030003000601
10402070502060642070358063565022204063804030442070557080558067504340647050885777401
10300040600070000080004000002000202080004060000060004070005000500040007050000000001
10778820587223687774605448308020576060582050365744836037602020225037307450284268881
10004000300000000000805050007080000060800050005000500070303060006000800020000000001
10204755204085223330405050726658685480405282435080607360305454302430473050225666301
10700000203000000050700080000000000000605000400070002000307000600050002080000000701
10384420202060803050484053463787838762203750404342626040507030425272605060724222801
10000030006050403020004060000000000020500000507000600060403050000080005040006000001
17374060778080436040208880604662337080607255705080402080708024747060653047702043301
10800050200060700060600050802000003000400050002080008060207000400030004080008000601
10206020707620403788685030505756306080238070267033433030307650808584704023237780801
10005070400070600000203040300000204030003060000040000080500020200020004070000000301
10463240307020838450707060238020504084756084523683482050727082735080528020266652701
10003000708060000080305070002070004000002000000000004080004000200080007070700000601
10503077264030524880606080507086548370506075725748505527603450808042407020608070861
10806000600060002000602030307000800060506060002000002000700040008000400030003020001
13707580407786756025407036608050402076303660703057655027502028708660224657574484301
10002000200000005000007000007040002000204000606000008000807000700040000000800060001
10672054846482302225667882462028273260403022262650307650404560425840843550208070331
10800020000000504000000000004040000030200070700060700070702000200070700060006070001
10504760306357503047506286708080367080264770702070256020624036604040605058627077501
10600000500080008000600000604000205020000000306040005050007000002050007000005000501
10337756777050653650373820208338804025834347508032464062608072523020375827755323301
10700000800080800080300000505000005000006000002000200080002020005020000000500070001
10604060843850404020705725406083264728507026678720702640808048408058488440603060841
10003070000060704000607000002000000000003000400000800000303000007060006000607040001
18627474543040706566542075344283328748537480708663334626253466834080704030805888401
10000000000070006000000040000000000000000000700000000000000000000020800080700000001
11111111111111111111111111111111111111111111111111111111111111111111111111111111111
