11111111111111111111111111111111111111111111111111111111111111111111111111111111111
10002000400000700000000000000000600000007000006000008000000000000000000000002000001
16402070407084702640385340836750203480208020403082508080475246577052424852302578701
10000080603000005000400030000070008000600040606000200050000000008000000000500000001
10338520607077856053765026233038372060344750705670747740874837804643532780405378521
10000040207000700070005000500040003020700050400030800060000000500050000050600000001
10378030402874602457205250357880204020832080487070847078758070477030635070808084881
10200080003000700000400080000000200060300070006000800060007050300030006000203050001
10807243752040667430602045884777647360306482506052808480806350303847804322707250201
10500000000040000050606080000000000020007000702000205000500030300000703000002000701
10443865826285345040338070707355808024746040306362206068353050702280804426822062501
10000000005000400080000080700000405000000080600000703060000080800050400000000050701
10722087308030806053207740503380683688556030404220206058386360805080588727705580301
10002000706060402000503000500030000000003030300030002000000000702080000000200030001
10402320803075506660524040247084666083303070505083376254624327457044344440808057881
10400030307020006000500050005040008070004050705000000000400000005000005000506000001
17725020707060305062808027704036705470286070442563856570404088707350802082548040601
10000040407000707020008000307000808000600050000040005000404000300040602000008030801
10586730305263405080206350703530408040658456852020606024505870378050406467808068301
10000070200020308050407000400070002050500070000060400080002000700050200040007050001
10328075535060506030656087255083765082308030734080458530536084707683622470347020751
10400020006070805070005080006050005000704070004030700040700070500000000020700020001
10603030404050704044508530308073505060557040504830303020806320203225645080304755601
10205070700030008000800000403000005070400040500020202000800000506000700030208000001
10605680388374372750202787506048535550804350777075603032326475706040403060444027321
10500020000000005000200000704000600000700030002000002080006000008080002040004000001
10652062653628305088428832505080406563282084506573853780507223344070563068303375401
10006000500000705000700000403030300000004000707000800000500000000050007000206000601
17308040855330604632604270507070574045804370603050702555782522238365622830202660201
10002040000000700000003000605040005020800000803030608000006000006000600000800070501
10352370382688744476752058407038505020606382304030408032605086503070602027823070301
10000070400000700020008030005000704000506000600050702000502070005040406000005080001
10384063406050605040806080603752505043806070545480507240208670683060506053304066421
10007070004060403000405000704000004000800050000050604000600000200070004080308000001
10305060333770503035403434848056454487555664648450807060687856208082823040605226301
10704050000050008000400000002000003000500050000080800050000000202000004000402060001
10702076783080528580388074704555283080505080506050245777553040803837402672706070201
10808000300040000020006000200080002040804020602000200000008060700000300000505070301
10508870808384504053505320743050503650308040504560604326404080608330705220407030251
10505020007000506000600070502020300080807000400040700080004070305000200040600040001
10407033762830408440424070307080354040255027842043842020785240558077855340774072701
10602020000000500080002060008000400070003000600040004060300000700080000020008000501
10702030687036805047203034858373207062504540302350407020603364507548347050308440701
10200030008000603000606000200000002070005060300000808030406000006000008020604000701
10347577602030638432802470607550847270732080805660807065307088547020207060302625801
10000000007080000020003070400050005000500030500080800070004020004020200040305000001
10875338477050264030668080457026756060302350802038224880868020504050473874603060381
10000000807080005060700080002000300020400000608000405000600040708050400070004020001
10783850407043802070603034805230302878208663204430706060605880805020545040662063401
10008040008050008070006000604000605000300000808000406070800000700080000040007000601
10306050845060365064344420505084405060402630405046306035628076356270667778373860381
10602080400070200080000000605070008020308000702000004000008000800080000000600060001
10605060406628805657603283806030522370552032405746685276304070573045205774606066501
10306020605070002000206000002040000070003050005000000040005050002000600040007000801
10802060607060328070676037778073207048803040645050743080688062302240447060765467601
10400060600070000030005000002000305070007070000020003080003000700040007050000000001
10562470873327335634806443608040568040344030345633635044707040746024705250422742741
10005000600000000000405050006070000060500050007000800050806030004000300040000000001
10203335203062623670404060486866236880208236573030507720506736502570775060834553601
10400000706000000030400060000000000000705000400050002000505000700050003080000000801
10274520707050305080877036326374657266408670202275742040404070378455503040887458401
10000050003050206080005070000000000040500000605000700050408030000030008030003000001
15286080438050826080207570408578368040202748305060308040507026343060842038705036701
10700040400020600040600070705000004000600070005050004070206000400050005080002000301
10402050608770203245623050807243205060568030574063383040304540504563507068785770601
10008030700070200000607070300000602030003030000070000050200080700020005050000000501
10526260208050567630707020333080504026583045573726433050562035673080734020827623401
10004000506070000040507050005070003000006000000000005020003000800050002070600000301
10308066724070383720608020303068724550305077245635704226804680203086203030204020741
10305000800020005000505050405000600040304080007000006000200050005000300020005030001
13607460503366247074305077805020805072703220803068465025607023806360722228452575401
10005000400000003000007000003060002000405000606000003000707000300080000000500050001
10363038284352406373742673742075466240405032578560807350204680325320434840605080671
10400070000000406000000000004020000080500080700050800060404000700040300080005070001
10802370704325607025605775206060266030888570605060676060547078708040306086452074801
10200000600080004000600000407000203080000000207020002040006000003080002000008000601
10247486522020458550846460408623604062674725604057745023804048655060463577788843601
10300000600020800040400000206000007000007000007000800080007070005050000000400030001
10206040744280203030702472504043444376702036746480307650302034705032764840505060321
10002060000020504000306000002000000000003000800000300000505000006060003000205080001
12627338786060707458478023353466888562628640306734523283646773724060802070707482301
10000000000040003000000060000000000000000000400000000000000000000060500030300000001
11111111111111111111111111111111111111111111111111111111111111111111111111111111111
