11111111111111111111111111111111111111111111111111111111111111111111111111111111111
10000000000000300000000000000030000000008000000000000000700000000000000000000000001
13608838764620675270607453525074807084508220204025408670625040208375247846227648301
10005000000040000050300000004000205000600000302000704000300040806000000000000070001
10306646753020445060468647805770207670534584654630704062303620658070634265447030461
10606000700080708000500000500020205000800030002070707000007020003060000020004030001
10208040306020606225702050587050404044307025805040807248287030808077887250803030401
10500040006080005000006050206040005000003000406000500000400060800030000000500060201
10872084347620388060247060607022445480855460206677637350805225767680322243384070801
10008020000070300020008060002000000020000030402000000020700000000000200000008030601
10206320603036606073608037274653455030333060706030435060448238234864703283702620601
10600070203000005000508000000080000040005050008070003040005000700000605000500050401
10778070408476382680708252774650404272502083347022408085507080406330503080467052401
10003000408000000080200000002000200040005020000020406030002070005000704060002000001
18203222403050305033748333382056446050803030807320505080647020424073554050504823201
10007000400030506000003050008040600030305000200060002060004020004000005050800000701
10852340207370334028804030502060204440804282384442358050606060806344407070585720461
10000000600040005000700020300030004000500000000040000060504060400000400030000030001
10643385208063504824556760638370844070547352857050322842302047254620376375665730801
10000000505000700000003000800080200030700050300020000040006000200000400000000020501
10354380626260762775206047222040604436205040705474372030775560202622407533625025301
10000030600040500000004000000050200000005030003000004060000000405000206000300080001
18543650702060605022568275502633203650876045875078688040633622587060806040408450701
10000000504030705000000000805000500030003000006000003040000030004050007070500020801
10338338804070402423706460274050233038238550302445508045778020205046844030555050731
10600070007000800000500050300060007000000040300000702030000080206000000080200050001
12506020504633334480424330202678405072687086804250404037844860807768877286405068301
10006040302000000020000020402000007000006000802000807000000000800040004000004020001
10256080484063654045243024304030265665203760606026205884505457643050404050427070841
10002000500050008030005000305080000030007050802000605000400060008000700040006020001
10408585405050806050255380562022257020332040532260602080865084802038377566705084401
10700040008080400030000030002040000080200040000020004020200060007000000060006080501
10464030634070588428663060605040475720504625686086635450306540206338537060436040501
10607000500040000000000070707080400070004070008000000020400000706000000050008000301
10708474404056643878523780407080707045424020203044422080783246626047443360702746501
10300080306000000000000040800060008000008000304030003030005000000040000020400000501
10503030804067248285355070408024624730202336702060403047806752466220465060332850601
10305070003000006000007040208030000020800050002000604000400000000050300070000030601
10777070727584702054608070407020728064364050842374704520805777883040507022662060801
10000070004000605000200060806000200040000060000000504000500070000060208000002060201
10887857305057708070677840804768322670805675866430705042626760404832608745578020401
10300000608000005070007000700050000000300040000000705070000000208000003000200050601
10202680804322332357558042475050466767374260277288407050502322804048353060506550401
10005000703000400080005050006050800000000080004070005000400050806000003080400020501
10676047604020805030808070742060305048636022307050406620352020805685304082232060301
10003000500080304000600070005050005050007000004000700030803000803000308000008080301
10803260258370204842285473202077388230808477673846357080305020308080503224603050501
10400070300000800000500030003070000050500000400020004080608040502030500000200030301
10727030605773744250708070738080477040403780704050602050302066705060268850878070801
10006020707000200030808020000060007000504000805020400080403000404080000070005030501
14675040405030303060305062257526404042808083505050635320408660607047448084505050301
10008030403050002070202000800000705000708000703040300080006000407000407000203080301
10206080702050787650703830808360607770805840352080744056868547503530505070302370601
10400080406030003000403000702000302070203080006040002000000000700020506070600050201
10433550504075602058605063308066405020706030206025207554876460706020504040786050501
10700070608080006070004000003000002000507070500080500000000000708060308080007000501
10407040403027327070305836307445568258407070644860402622838235806080303025304624501
10705000208000002080800000300060002000005060000000700000002000007080306000600000701
10502587507733706030406630344020706088433062255720806722586042773070504362723080501
10506000802040002070703000600050506030005000200070208000005070500080200000008070401
10502630703040867050203023503370606050308220506020656046406080308640305664503050501
10506000200080000050207030003000503000500000606030200030006080700000400000704020201
10406073538745842720507042868040505432478326403052208420406060887443344480203360301
10600040002000000000806000000030300000000000705000007000806060000000002000300000301
10247530507080247744402335568385342387747380485285644040308068745582306056876257501
10000000700060400000400000600000500080000060000000007060804000000000605020006000501
10734425735220805330505720705870205040857038373250405070402734875570306085703050501
10000000000030207000600060004000304070500060000080200070400000004060004000004020001
10767250885750608065322035367080526040704440676087736770803655408060536873538055281
10000040004000406000003000200060200060400000800060000000700000506030000070000060001
10763054306027503656702344304237804340686420707380248356462760508026764050453680601
10002000207000406000700000600000405000800020602000200060000070500040000070000080801
17506480505670804070826220326840202040404026207066445040673860648870204332444087201
10004000300070704020000020000080806040404000507000002030400060008000300000002000001
10704058882080504026407046435030405053303850504077507060505086205062747580508257501
10608070007070007000206000005040003000400070002000804040303020004050000070300000601
10862024404085652470308565268022828630226082285370804030505030226060436064736030541
10008000303080000000405040000060007000200040005080702030204060800050800040005080001
14503640807070208533703050658320407030606335203050202020408040755820708270806086301
10007000505020400000700060000000302020700000007000700040002080004060400000703020001
10868023804060606460376655484657303080735358855245548883566025602080308822805820701
10004000005000800030000000000000500040000000000000000000003000002000800000200000401
11111111111111111111111111111111111111111111111111111111111111111111111111111111111
