11111111111111111111111111111111111111111111111111111111111111111111111111111111111
10005000400000600000000000000000200000007000006000002000000000000000000000006000001
14305050408024206850242640658450207520306040404023802070777524775083486454404728501
10000050807000003000800070000020008000500040605000600060000000006000000000700000001
10425280403044633023737047525058654030256250304560876220288842502536886480406743741
10000070307000200050008000400040005060700050400080400080000000600040000020500000001
10367070505363808744402580544420404060887020584030782048428040438070574040507024731
10500080007000200000300040000000600030400030007000500030004030700060003000803060001
10605552456020734880602062336382632440306875203084707340304540707732507353803430301
10400000000070000030703080000000000050005000408000506000600080400000303000004000601
10378642833276346070267050205447206048666020204238305026563070404340205682788034701
10000000008000800070000070600000508000000040500000202040000030300060300000000070701
10824077606040705032203570407230375452623060707670806083746580502040776635408650301
10005000602030307000704000500040000000006050300070005000000000703070000000600030001
10805560606046505340433060325077344045703040805076782872265578447072874280702052541
10600070307030003000800050002070008020005050707000000000300000006000002000702000001
15233030404070205028803053202066504430572070283637554330605023504440403028372070201
10000080602000802030007000804000504000600040000050002000802000600020205000003040201
10365260704342307050306760806260806070276386742070203044405560252030502787506022201
10000070800040702030503000600050007030200040000020500040008000700080800060004070001
10348063884080803060534044334066287083806080452020276320272074305666878530833030881
10600060007060407060004020008020002000805030004040700080200050400000000050300080001
10204080608070608046205330806055602040856060607270504060606580407537745080604848401
10608060700030008000500000803000004050600050200050403000500000503000800020804000001
10605670836442822550704285702025243250306860828077508064345628508040705030825067871
10400070000000003000200000802000800000500080005000006080006000005020003020004000001
10348032337284204074423737707050508235382034706645347680702785246040428057206533601
10004000400000408000500000805050400000005000707000200000500000000060005000708000601
15203020778350307356205860606040728044702440503060607338246687888547374680505580301
10002020000000700000002000804060005050500000806040503000003000005000700000400030401
10452350625468544256568083308036507020707888807080508054504026305040807022224070501
10000040800000500050002070003000204000205000500060808000407040008070306000006020001
10543056805020607030703050505767404056503020225450805450707860684040707025805042851
10004030002070808000504000306000002000300020000080204000500000500080002020207000001
10702020647640408083602556688062656248244442882440607030267532302064736050405655401
10307050000070007000400000008000002000400060000030800050000000708000004000708030001
10408083687030263680656073305585248040606060708080452325545050708523505668704030301
10205000400030000030008000300060007080403070506000600000004020200000600000708030701
10304820303732508078606450425080802820606020804380406552704030404780607240307070421
10605040002000506000200040807070400020503000700070200070007060302000400070700060001
10607026564780804420862060807070222040762024773076533050262420632055885880585072701
10207070000000600030004030007000500050005000600030005060400000800040000020002000301
10604060582086607062208056268665202035507250405650806050605556604756525020603860201
10300050002000604000805000700000008070002070300000306050204000005000007070504000301
10425534502050222838602330705550747340282020203870206075704053382070705070508424401
10000000005030000070007030800060006000300050200030700050002060005040200080402000001
10565428442080356050785020827034283030505540603038838440363080302060438655305030831
10000000405050002070300040004000800050400000703000405000500040603030700060003040001
10874750606088508040506066204320808445307554808720708030503880507030426050764075201
10006050007060003040005000505000803000700000508000803040700000800050000060002000701
10405070638020227055853220703034306030708320308037703064255066346280756664525340821
10406070700020700070000000708080006020307000705000003000004000600040000000700050001
10805070406845306744507647602020467440234026604254683662808080783035408275604034201
10204040207060008000404000003020000070006060006000000020006060004000600070006000801
10506050704050422050438025457078205024604040668030872070222085607230557020563748801
10200020300060000050005000007000403080003080000060007040003000700020002050000000001
10744850542683654788405855306040364080436020382837867075308040432034502720554826251
10007000700000000000306070003040000070200020008000700080403040006000400030000000001
10407356505072584830506030837567676480808572667040704730504367704650558040242454701
10500000406000000070200030000000000000604000300050005000706000300060008060000000801
10826370703070305080283048776758572667704780603486566030208060687486406030742848601
10000020003080305040003060000000000060300000407000300020705080000080006020002000001
14627030535030266060507240805555587060706886505020708020604073235050744044602032501
10400080300030200020600080506000008000600030003080002060803000300030006040003000501
10506040503740803372386070406886507020742050246063373030703220806726604056266260201
10002070400030700000505070300000807030008070000040000080600070800060006020000000801
10744840406020887420808020632030406068825072663575357020237028263070423080283566201
10006000305020000080207070002030007000007000000000002020004000200070008030400000201
10403048353030757230704030702038442830808086774247402363506240202067202080506040561
10302000400030006000504050305000200050602080002000008000800040008000400080006060001
16207570203623243044408058507030304028202640502055283063804078502730475278743427601
10004000500000007000007000006080007000807000303000002000302000200050000000500060001
10883083587227706468425488523026743740306026568760502240602240526660738630202040461
10200040000000806000000000006060000040200030200080200040305000400050800030008070001
10704860705733402048406847304030476030246420806030824020735056502050402068786033601
10200000600020003000500000403000307080000000407040008040005000005050003000003000301
10727266838070364720245680404753403062567277708063865053705033257030724688278588301
10800000500050800040400000202000006000003000003000800020006020007070000000400060001
10206030626750408030707525703067647237504084664480308460204022702072648330703080771
10006040000060804000703000007000000000005000600000700000806000008080006000706050001
16573232554020207368483086365657765357435760805246333584344265273080703080502247801
10000000000050007000000050000000000000000000700000000000000000000050600060400000001
11111111111111111111111111111111111111111111111111111111111111111111111111111111111
