11111111111111111111111111111111111111111111111111111111111111111111111111111111111
10000000500000000000000000000000000000000000002000000060000000800000008000000000001
12807020502245302725663564843640704543203020565056335050505030567630405070386775301
10004080003000205000000000600080205000603070800020004080205030800000502040000000601
10434022578040358080546880337060505060352085703740705040806420407545405020322480201
10800060000030006030000080000020608080005000805000200030400040400000300050000030701
10874820703372705080787060732870302028808280605045337770506040882720406865465080401
10003000200000600080003080000070605040700030503000000000508070000000400060000060201
10705050354760335577855024545020505030703050306636552338406048738066776040522270201
10306060007000400000003000007080402000604000300080000000606000008000004070007000701
14802080603035804437502384207350887242325832233040686820438574203053303077224043701
10003080404000004000300000800080000000000000003060204000300000003000804060006030001
10525020202435878050382828583058736734654247306050408034405536602550707030408020521
10003030500000000070005000000020000000000000608070504000004000502000406040300070001
10305040288558827863405085533850704855805660602370405075268040544054306050548046401
10300040000000000000505000600000800000702050200000305000006080000020006070006040001
10886830444476488370306340503434407770604080436546507036203027642370845075303430201
10400050300000003000300060003000300060300030000000802000706000000040004050504000401
10485040733523703064284060875240207040777847874850603888402050585022232040403057761
10008030000000003000200030200080502040000000005080005000002070006000800050505000001
16506030586756462050304422808020508062763287305058352064872052504020607750303843601
10006060000000008070300000303020707000007000602060000050000070002080700070300000301
10522070248257604860642020607030806330503080608050733274627520455260386060505320401
10003030000000500020005030505040700040200050300080400000000070800000403000200060601
10707085776640706077503040808080307050754460722830408553344040608527302765768050401
10308070000000306060007020004000803020800070000050300000600060704000008000008080701
10508070743578668040764040368638606086605056223080667480805220204035787527804030201
10404060006000000070200050000000704000605050007020000040700080606060000000600070501
10503062836027435380808826484660306550702030208063706030685078206066246340827640801
10807020006000006000402000800000402000206000204000206050303000002050002000300000501
10305070603646403068705067607582303078705244305560677060305428856040204052203537701
10600060300000005070002000004000807000004000700020600040005000000070806000506080001
10273860566047266076748372826040402383744080268060205764258062847650204320308040251
10500050005040007000003000008050200000000040003060705000000040000000508000700020001
10308073402220608545604020706020604626487473305070208040852760502327202060242385201
10008000400080600000700080606040702000000000507060200030500000600000400050200000601
10837640635080546580532867707260508060456250202040746384704642585860703533808430501
10000040005000400080500000600070200070004000203060000000006000000050600050008000601
10376035203082805080403320733070467475506046707022502325873342763050385850206032601
10600030703040006060002030004030600000802050002000800030000000000040000000805070201
10705480503570247047857020703040633840807070383730578620375044563083577363807070301
10400000400060004000000080704080000030004080000070000020002000006000000000508050801
10682267568058704765657480803077683060823075423057443084807433705776655380503080401
10000040000030003070003000703000400020007050003000004000003000006000200000704000601
10546080574850838040606058604060803076502060208325807875727675532080643622602046701
10008070000000700070400040003060804000604000204000004000008000007070000070002040201
18408030278736205220506850404080302420704643207088558365603020607328204050456080501
10405070000000700000606000507030003000803000003000000000700050600000406000500070501
10505027307520437384763064802080254234303080737246504660542470555320807560805580601
10004000200080700020007000807050007000605070003000500030000040007000700060502000701
10753540308030708078708860604038875060406028334030827636644047673062847073604060301
10008000602050007000502000704000400040006000003040000000003000000050008000406040301
10634086875052352250503025877250502357603334805020335854806587685580706350802060401
10300060007000000080007080005000400000700040500020000000400000002000606050700080401
18408870505554343044853080403447333660407030733638353880356725606086305020272548701
10004000500000700020004030300000700000404080200000005050400000207000708080008000001
10248345747430604822504028586550204586807080407072602050706050607353403047602030481
10000000000020500000504000500030003000007000207000300030305030400000308000008030001
10526046626040702870506630505047524038273056806560572780307030206570703080686023801
10008020000050700050008000307060700060005050005000200020008040800080008020007080201
10802860746460535045448087287020602540207450608028387034466030403072422060684080401
10200030000000300080003000300080300000807000606000003000200070404000203020700030001
10582035857343507770703380803830808567403045784328403760877320676260308020403443771
10007000007000600000600070008000200000800070008000300020000050004000300080200000001
10203074806380666776356023888020268436285660407050353060845020204088447450556224301
10802000800020000000007000000060000060000000400080003060200070605000000080000000401
10403623755056627346604488635722532670608673707644302027707880403360783045845420501
10500000004000008000002000000000000000700000804000808000002000300030006030002000701
10348770408488403020566060523326334540768820706078602044668044242073505060803587401
10000070205000800040600050000000300020700020605000004000007050008000702030400000401
17654084304080834875705260667750856040202770803868426273253050806070252080477360601
10005000200080000000800020400030000030600000400000002000000070706070400050003000701
13605050207524835860448040725078422777266832878544507077442420302050704873546030301
10003080600000000070000050000060000000000000006080003040000000602050303000500030601
10537220806043587032624877465660753775705478304060848050204678402280638040702472701
10005000505000002080000060000030008000200040007000800040600000800060000080002000501
16805020305676407080673030428034576050437650833458205060482070337057705875555060301
10800040700080003000700060008020006070000020400000004080005070007000400000600060001
10836445427040622442707556208040304024328070505553703527608447202760872240708644781
10200000003020700000006000203050400030002050003000702000800020002020500000200000001
10802023804060202825572080207030487670207045784080788040554070757030553447833886701
10008000700080300000000020003070000000703000000020000050000030000080000000000000001
11111111111111111111111111111111111111111111111111111111111111111111111111111111111
