11111111111111111111111111111111111111111111111111111111111111111111111111111111111
10008000400000400000000000000000600000002000005000005000000000000000000000007000001
16506060706053203550763360475870504670808060807057803080575627265082787648506567801
10000050305000007000500080000030004000200070207000500080000000004000000000300000001
10463820304083643065432045885036833070287660805560478320564377604544528370303225251
10000080802000500030002000600060004030400040800030700040000000500020000080400000001
10578070405867307627607470538850504040643060746030882082648020685080428070405035481
10200070007000400000300020000000800040200060004000500070004060400060004000805020001
10305746472050782530406032427684822420602375202055404270707820706573804483608250601
10200000000080000030508050000000000060006000702000404000800070200000803000007000801
10467285263833467040658080707443304088524080305457402027768070802760703484735023501
10000000003000500050000070200000208000000030300000408050000080700040200000000070401
10565033305080206026506750703740727325465070406460507025528540206070666587307360601
10006000507050502000604000300050000000008050300070006000000000605050000000700060001
10502780505035606260254030476075363026606060802022468466357633646068376230406023561
10700080502070002000400050006030004050004060405000000000700000002000002000507000001
18788060505040706053406047408084202420272080834268676880406045503780404082687070401
10000070506000605040008000205000204000400020000020007000603000500020808000006060801
10646460503567403070508430505450207030327675774050204072608460357080206823802044501
10000040600060708060702000300070006030800040000060400020003000200030200080008070001
10737045882080702070832068385047743032603030877060386540786055304326466640884060341
10800040005050504080007070004080007000503050008050400070200020400000000080200020001
10602060205040503056605560505045806050566070306280808060706220708824673060804626801
10404060700070006000600000702000003080700040200060806000300000805000600030202000001
10707850365837738760306355504076368440802530786065302074588722402060307040862055281
10200080000000005000300000607000400000400040006000007050003000008060003030006000001
10476052376246304022548575506080802778448055703527272760505447623040482074705756801
10003000400000302000200000208020700000003000407000200000500000000060008000302000801
17608050477230807584707270708050583088205320807080207622645377273783323230805760201
10007030000000300000003000608040004070800000805070604000003000007000400000600040501
10828580327886262386558033204087605060503575702080607027206088202070302062866060201
10000030700000200050002040005000803000706000200020303000302050002080602000008050001
10326077607070702020205060204378808067602080686450505350307840887060604073504067521
10005030005020302000505000307000003000300040000060704000200000400030007060705000001
10803060467540506057507886824024338345326434873440403020353247407083368020808468701
10607030000040008000200000006000004000500070000050800070000000806000005000603070001
10606086275070353650688067208722563080603030802050363485253050605774505768505020501
10503000500080000070004000800040007070406020607000500000002050600000200000308070601
10208330607627404042202820477030707450205030304580507236302020808630803560404040771
10608040003000505000600020206040400040705000600050300020003050602000700040400040001
10807062852620504480448030802020574060362078843022332030732770754085426240468087701
10307050000000700020007050004000300060003000700050008030500000600030000080006000201
10206050345047307037306027322238405056806660306850703080206828507542566020605330801
10500040004000307000205000800000003050008060500000306070602000003000008060306000601
10623632307040834635802520504660268620663020807480607053202057463040802070202774401
10000000004060000020003040400030002000500060500020400070006030004030500060503000001
10668686535040328020342050684073582040507750808088476850288050602070766526507040731
10000000704020002060600070008000300070200000803000508000200050807070500070006040001
10866720304052502030204064803770604334202424302720603020203860303080624040286086201
10005020002030004070004000602000306000400000407000203060400000400050000050004000301
10203050584060252032447760505037808020708360502056706038285033676830648267768830771
10205020800060200080000000603030006070607000608000002000007000600050000000500050001
10707030605486402742805868803030584370437042507423262448505030872084606766803083601
10505020507060002000802000007050000050006040005000000020003050006000700070002000801
10708070508080748040874038767038608066702040633030575070877026405230352050582622601
10300080200020000020005000008000407070006080000080002070006000400040003020000000001
10638750362458438342403257708020223050423080282485746048808070865088602430448765661
10004000700000000000703080002060000040600080006000200030208050004000200070000000001
10706784607064245370608040485468773860708473676080606260303667304720372020857857601
10800000308000000060200050000000000000504000500070004000602000400030007040000000501
10387650706060207030753067342765246838507870702375725030802020668335703050432528801
10000030007080502060008020000000000070700000708000500060305060000020008030004000001
12232080573040877050502220602735553060503864508020704050804022273070578084807085301
10800050300040800040300050303000002000400050002060002030303000400080006080005000701
10402040205670208742433070404733705050525020622033387030507230805735606065886240401
10005040300020500000503040300000602070004020000070000070800070200080007040000000801
10627830404040748720808060756040804085775046844326747060838036858030622020873232801
10007000606040000020608030006070004000002000000000004080004000600040006030500000701
10603073826080643480402020807024772450405042745745703565408840205053207060406070781
10702000400020008000706020807000400060504080006000003000800070003000300030003030001
13706640805222273023808062703060802022302280503073487066606073802860662242535652701
10008000700000002000003000006020006000503000607000002000304000500050000000400060001
10267077668377607484678564373023643320504022666460303450708570675330348420603080231
10200020000000408000000000005080000050700030500080200020504000600070700040002030001
10303620602223505024703237802030647080836670605020485020738087208020302056442085301
10500000500060004000500000803000503020000000308060006080004000008040004000006000201
10334542862080453420853370503648202078846442206076334062702074875060574528277753501
10700000600040700050600000302000008000005000003000500050002020006030000000600020001
10808030337650307050705283705062386374807083574360806230805072404078546870203060361
10003030000060707000808000007000000000008000800000300000405000003080005000605040001
14852775588060504252734088834265362282427350806835484655858246855050204020403457701
10000000000030005000000020000000000000000000800000000000000000000040600070500000001
11111111111111111111111111111111111111111111111111111111111111111111111111111111111
