11111111111111111111111111111111111111111111111111111111111111111111111111111111111
10005000700000800000000000000000700000007000004000003000000000000000000000007000001
16405050808065602580855360356570403450206070407077305040635847866088545552804488201
10000020808000005000500040000030008000700050308000400070000000008000000000600000001
10343660808047766042686076743087524030832320408560885550362427707227442330805264231
10000080405000500080007000500050006020500070200050500060000000300030000080700000001
10782030802843606345702380358420307030437050548040586057882070428060275030504035861
10800040008000200000800080000000700080500080008000200080003020300050002000703070001
10302253775060288480605044744273724540507842407086706870804440402464808873602730501
10500000000020000050304030000000000060006000403000206000400070200000503000007000201
10344854473453568030557030706864302048363020507538708072237080603550708586375072801
10000000004000500080000050300000706000000020500000804040000060500040700000000030401
10458062202020408027504340802520773278453030404230403077324470802030674752704530201
10004000306040704000404000700040000000007040300030008000000000602020000000800050001
10405550608038803340343070322056675055305080406087844374886758422085727270802024431
10800060206030006000200040003020002020004040308000000000200000005000006000607000001
12628050806020406043703067502056608250822060825774224330708062508880606058337050601
10000040607000602030005000405000407000500050000070008000804000700030302000006040701
10223830204353808040606270403560702020676572835060206057606520372060806275405077401
10000040500050604050408000400050007050600070000030500050008000400030500050003080001
10634073682050606070856073857043727073505030282020765520372056504555522740652070741
10300050008080503050005070005080002000304060004080800070700020300000000050700080001
10507060202040205085607450205054708040384070507430407070406680602657424040203262501
10805030700030003000600000207000007030800080500050404000300000704000600080702000001
10408420373258544620805882708055364370504250546055306074463877405060707040482088331
10500030000000006000500000705000200000800060004000007030002000006080003030008000001
10572067536347307032637243606060402286778023502565228680404832746020426078606448401
10008000200000708000700000705050500000007000506000800000400000000020003000706000801
17404050724250505273402640305060646087205840603040808828256254836764567660704270801
10006030000000400000004000208040005030300000504070406000005000005000800000600060501
10238650466342565755554032404028305040404577802040708024402036608060402058636020801
10000030800000200060004060005000706000506000600060205000603050004060505000004070001
10677023404060305080803020806624803067603060888850507850805520553020506063403077631
10003080004050804000406000208000004000400030000070507000700000600050002020803000001
10208080652550707065203457877044348768237256577820208040422828808083243020607436701
10603050000050002000400000008000005000300030000080700070000000402000002000806050001
10807053754030267470356037705622845060807060506080365688324080705773506343808050201
10705000600060000080003000600050002040406030805000300000007050600000700000404080601
10804820608482802052306320248050703750603070208720604623204060208270308670602020661
10707030004000202000600040202050600070303000300050300030005050306000300050400020001
10307073243620806670676050808080742050524035465028247040574820864033747840873036801
10208020000000700040005020003000300050007000500070005050500000800070000040005000701
10608050474033703085707027353576504045405370704660502040607874705264236080306680501
10600050004000805000706000500000008030002020400000302070406000005000005050408000701
10533633804060468352406780708230378370522080505540505072404082282050207030402438401
10000000002060000080006030300030004000500050800070700020006020007070200080607000001
10357662667050282080356040488085855050702520308082526870465020408060654885603050641
10000000202040003050400070004000300050300000605000603000400060402020600050007070001
10354270704063804040404045406560206323402748705360808060207220704020755050348064801
10005070003080007080004000705000303000600000808000208060400000800030000080003000201
10407030366070777087264720503058702040708430207043703075632025587330223626442660661
10303060500060300020000000207060005070202000507000008000008000700040000000300050001
10806040504775802875804733804070428540636082505875656638202060684045206345703052801
10303030606040005000302000005020000040006080002000000050008020002000200050006000701
10405050304030234020833054866054308085704050638040534020224072605650385040727345801
10600070700070000070008000007000304020008040000060003080005000500040004050000000001
10463440483382432876802547805050427070284050247336553055507060438036305630537247421
10002000700000000000408080008020000040500060007000400020503080003000200020000000001
10508887506038233850705080428343878350602335748020706250608883203740884040673467401
10300000206000000020700030000000000000305000600070003000403000700020005030000000701
10587670204050507060867034574387864535703380408574823050802070268272707040752843801
10000020006030605080007070000000000030400000508000500040707050000030005040007000001
12335020636040555050708730302425826020807533808020603070403067654080558037508075601
10500080400070300060800080207000003000600060006050002070307000500080007040002000601
10307030403670802222837020708436604030266020282072523060408870304884304023262250201
10002070200020300000604080600000803080004080000030000040500060200030008040000000501
10652660206050273270802020464040405056762055866785477060448052662060828030464885501
10002000703070000020502020005060002000003000000000005080004000400060004050800000501
10305074523030527280504030608023475380305067877528702467504670303082705040208050261
10403000800060003000206050602000500050808060002000004000500050008000700030004070001
15408480402885643042802032605030504073705260403068246024207047302650278237745454601
10008000600000004000005000005030004000606000705000005000803000200030000000200030001
10358074357242804245534373358048574270606073388370606250302370768740228240604060781
10700030000000303000000000008080000060800080400020200060607000400050500040003040001
10404280404256707056704257504050483070357830706080338070346033304030706074233088701
10300000500020008000200000403000406020000000602050003040005000002060008000007000701
10522552485070877230827530707883206057566582705046278042805054228040653355835852701
10600000600060300070400000607000006000007000006000800040008030003070000000700050001
10503060256420206020307568206063265647804073556740405750508058507073835840207060471
10002050000050404000407000004000000000008000700000500000308000008020008000405080001
12367683852040804636284036427762886663352860805648222544657325848050706020707828601
10000000000020003000000020000000000000000000200000000000000000000020700020300000001
11111111111111111111111111111111111111111111111111111111111111111111111111111111111
