11111111111111111111111111111111111111111111111111111111111111111111111111111111111
10005000500000500000000000000000500000002000006000003000000000000000000000008000001
12503050206044704770742450677880308580802020404088408030353762757076667734304777301
10000080402000005000800030000040004000300070308000500070000000003000000000200000001
10465480602048878022837044745048544040223550505520677860438634206632335220506644271
10000060403000400040008000500040002020500060300030700050000000300070000020800000001
10682070406576705382803820675280405060287020682060857047222070626030663020706053761
10800040007000800000300040000000300030500020005000600040003050600070002000608040001
10702862235080646770203024665552863620308833606074505580706580807524405564508720301
10300000000030000040508060000000000020002000406000605000400030800000203000008000701
10375683866646354080878080506323305082475080702482204036636070302760506466632086501
10000000007000300040000030300000606000000030600000603020000060800080600000000050201
10667022308050802075804370403730266624532040205650603052827370407050245557607280701
10008000604060708000207000700020000000003050200020002000000000707040000000200060001
10302750206058807630266020673076283047607050205044367822372737883074666460803084241
10300020703020005000600080007020006070008040608000000000300000004000008000803000001
14863020608020506086402086406037303860275050884586266670503085604530307057487050601
10000050406000805050007000704000606000800080000050006000303000800030708000006080201
10563360604447203050605770604230603020774762243070405036704750452060503485208035601
10000060200060205040305000600080006080500040000030500080007000200050500020004080001
10556056275020502050456035626053243028206070383020352730345024605763482460568060461
10700020002070804080008080002040004000807030002040300050300030500000000040500030001
10503060405070206042602730207065808030383080206550208040704420405436526020602443301
10707080300050003000200000406000006050600060700040403000800000202000300040804000001
10408520875623237240205786208072453230606850387037806065674258403030204030337085571
10700060000000002000400000507000400000500030002000002060004000003080007030002000001
10344073625344703057444672804070303222572086707438746230608845538050442077203447401
10005000700000303000600000608060400000004000804000400000800000000040004000603000501
18306080836570306435206870402050658053604730705020304646543876782774374450406870301
10006020000000800000008000208030002020500000206040407000005000003000400000400020801
10346530463253585637582044602052507060504265407030504063708087805060406043322050501
10000050400000800070004030007000605000607000700040502000606040002060707000005070001
10585076205040302080503020203276502057408050324770306820404450236030308084203088371
10003050002080407000203000408000002000600040000060307000700000800050006030603000001
10603040827860407074607547264088644366858866627560802030387222305077752020704453501
10705020000060002000300000004000005000800050000050600050000000303000007000302080001
10504023773080642330627086704458636030304050506020775382752030207467805623203040501
10506000700020000080005000300050005030308040404000600000008080300000700000502070701
10307850307686206027806630454040804560402070402440808584205020502360608540708070781
10406080004000307000700070507050200070804000600080200080008020702000600030300040001
10605038428370503880556050602080664020528023538023448020568660542046252370833083201
10604080000000600040007050005000300080007000600060008060500000800060000030006000801
10706020886037204023308085234223507086206530704780806070704433304535658020808550701
10400030003000508000405000800000006020008080500000707050506000008000004030406000601
10527342305080768384203630606770787540658040704220508058506077634060504070305538301
10000000006020000030004060700050007000200070400040800060005040005050700020408000001
10388648784040453060654040686066333040307550405076556320624020308020777266406020651
10000000806030005020500060007000700050200000507000203000800070405060600060007050001
10554340808082308060307062208530703872702224307680603020607260302070265060437053501
10003070006060005070004000408000807000300000405000405030600000700070000050008000401
10303050846040634086365540505067202020706730606082205076578032886660773363743320281
10304060300020700020000000604070008070806000808000008000008000700030000000500030001
10807060604732205336205544505030663870326084402536836575308050567025307323707062401
10306040304070005000502000006030000050006030007000000080008060004000400040006000401
10402030605060688050564036857036305053406050683040654040836028503780346020366552601
10200020700070000030002000002000508040007040000080007050008000400070003080000000001
10754520682653533752802785408060556020357070348378367052708060674068606580788754641
10008000500000000000704020003070000020400050005000700050805030007000500080000000001
10406237402053226760607080254343737820508258242060604470704467805760556080488885401
10400000606000000060600050000000000000406000400040002000404000500040005030000000301
10685240308070504050823046886677537546804360802436458050608080367436408070555758401
10000020008040602040008060000000000050300000305000500040807020000040005070002000001
16474070367080776020203760607437526030602777405060306050304068628070385088606088201
10500040800020600040400020507000002000300040005070002040802000400070003060005000301
10707070604340504736738030708623803060542060682054546020507480308767203023433760301
10003030700020600000306030300000202070004030000050000030600030600030004070000000701
10523720407050422540606070257050408022444036754374455030423083745020277030546558401
10006000706030000030808050004050006000008000000000005030006000300030006040400000201
10708043325020886370602040807088576770208083357366207334305820204068608030808080271
10606000800060004000702070207000600080207020003000003000700080006000500020005080001
14307680404254854052204036306040602088702720503076483042506074308220488285825237401
10007000600000006000003000002060008000603000806000004000703000500070000000600030001
10387073588733806366588474765088744360408027476270705460604470847320326450605040751
10500040000000207000000000006040000040300080500050200040402000500040800060006040001
10802720502642304045305367706060748080447470602070244030774022707050307027276057201
10800000600040007000700000403000302060000000308070006050005000006060004000003000601
10478442647040882420682770202887306065643863404057784024804083565020762425272642501
10200000600020300050500000307000007000003000005000700080008040008060000000600040001
10507020332230403020504278404046675386605037263240502280307022202024745660708030451
10003060000040707000702000004000000000002000600000300000205000008080007000808060001
14556625628040404282544073664855854573658680402254838734822256345030408040505386401
10000000000060005000000020000000000000000000200000000000000000000060600040600000001
11111111111111111111111111111111111111111111111111111111111111111111111111111111111
