11111111111111111111111111111111111111111111111111111111111111111111111111111111111
10003000600000600000000000000000800000006000007000004000000000000000000000007000001
18303030306088305280453460884430503650508030303075604040263537382044568734705268601
10000080403000004000200040000070008000700080508000800050000000006000000000800000001
10427830506055275084524023655055668050584230504450248640428366704234323730508584231
10000070406000300060004000800020006020300030800080500080000000800030000050600000001
10854060206282803627303840633640402040582040863030228027477030686080886050408032381
10300020006000700000400020000000400020400080004000400020005030800020008000208030001
10404575822070244580706078536774233550305748505082808640507550707422603652302240601
10700000000080000050408020000000000060006000705000403000800020500000505000004000801
10424234585736232040435070804728502084283050806372308062458050202760508277862066601
10000000002000500070000050300000704000000080500000704060000020600080200000000080401
10374082207050605073405260207240362376382040805720407042432730208070334776706840801
10006000805020402000403000500050000000007080200080007000000000204060000000800020001
10603520505063204820758050878053854047203040606075868658262738768072732270307042721
10800070605070002000700070004060006070002030607000000000300000006000003000807000001
12882080508060305066502047408027802460558050635824784240303085603470303077388050601
10000020206000202060008000405000307000200060000080004000704000500040408000006080801
10334660504288808060308540308670305070364386836040502053704280672020708724507077701
10000080500070706060507000700070004030800050000080500060003000300070500030002080001
10526036285070604020875072246052478022603020244030247250245053303746677580853060771
10300030008070603070006070008020002000302020002080200080300080400000000070600050001
10307070707020604024703550703038706050548020502530802030305270202483357020603544201
10606070200080008000300000604000007040600050200040702000700000404000700080605000001
10808620485362385440304354503068523280704320288028306077728775703030707040578054821
10800050000000004000800000304000800000700060006000004050007000003030004070003000001
10828088277827808045478448807020402484654035503582758270405457648020473088303442601
10004000600000604000800000503020300000005000506000600000400000000080003000304000601
14802050656670407344803360506080855088504660402030406325628254328624846830403450801
10008060000000600000006000608030003040800000502050606000007000003000700000200050701
10784620384667474358743035204066605040804266204050304058305087603060305037555020501
10000040300000400040005060007000504000703000500040505000504040005020702000002030001
10556048306070603060507050706853507028208080556330305770702320878080808088502077551
10002080004060704000606000804000008000200070000060403000500000800060004070308000001
10306030485240705076306365727086446346243635683470807050643826406083742060804342301
10302060000020006000600000007000006000700020000020600020000000603000002000705020001
10308057466080365670763062203687837040808050708060878654787080307834706666206020801
10403000700030000080003000200080008080405080404000700000008050800000800000405040401
10403750708247808066603470663020506730705060606320508768708070304670206540407020451
10606020005000805000800030402030400080307000800060400040002040202000600020500040001
10607053265870603820778040708070728020857064324085858060362250387087286630376047201
10407020000000600080002060005000400060003000300080006040200000200040000040004000401
10404060438065403075305024425858505043307480704220705040808737606783754080602550401
10400040006000605000407000400000006070007080300000606070508000006000003050806000601
10476236404060447382404820402620254570683060203220506054406037244030802080605825201
10000000008030000050006030500020006000800060300030800030005080008040200020804000001
10723274883050376050446070332027574060805620704037262250526080605020452547208050421
10000000407080007040600050002000500070300000406000304000500020707030300040003060001
10742230602037205040708055702740607835705234602230602050503460703020735060277056801
10003020006080006030002000605000506000600000506000406030700000400060000070003000201
10708080385040756044238730705058206080708440407038407037553054785320762857522760881
10507050200060300030000000702060006060405000404000005000008000400060000000700020001
10608070205363606678403633405040737680542044506786453733702050623063208525504036201
10803050402080007000202000003050000070002060007000000030008060008000300050005000701
10503030602060362070834077463037504058303070863040345030433053804860272040335242201
10700050800030000080006000003000708060005080000050003030008000400030007070000000001
10822230877886324626705785206030227070555030365286738065402080682053602280738223751
10003000700000000000605040007020000030800040008000800060405070003000200020000000001
10207253407054626440502050537534532250603656537080402270406365208370657050833543401
10800000808000000050800030000000000000708000800020008000306000400040007070000000601
10866680703030205020825063832852863675807880305344875030508020766822707060554378201
10000020002050707060007070000000000040200000204000600040703020000080003050004000001
14446080524060244040407230505743732040404737404060502080806025335020486057704037201
10400030600070600040200060703000003000600020002080005030708000500050003040006000501
10808020807840303245746040406352803020455020556077252080203780207845508025677430701
10004080700060800000607080800000306050008060000060000050600030400030006060000000401
10848720205080872520504060735080708058626075862564253060455056348080727080325333601
10004000404070000060706060004060005000003000000000003020002000300050008070300000201
10804065748080766770407050505022836270808052466452304222805740806083808080406020321
10303000300060005000507040702000700040202070008000005000800080006000700060003030001
17204330805478575056502038608020403088404380406077577037803048307530372847588282301
10003000300000006000008000004070002000707000402000003000308000500020000000300020001
10427044256553207262682888723083476220507042872320307720304520875350647840202070741
10200080000000407000000000004060000020800080500080700040602000800030300060006020001
10307370707273707085303362507080853040478780205030537040453055502080507042477046701
10400000700030004000600000505000407070000000607040005020003000006020008000005000701
10774563542050452640824320306448705078565357307057725024303074436050455748632868501
10500000700030800060800000807000006000008000008000800030003030002070000000600040001
10607050353260804050508668807054545637405024362630602770506058704085478480805030421
10007080000060308000705000005000000000006000700000800000807000003030005000804070001
15677834463020404752584078526564626678236640503646426788848286332020602030204324701
10000000000060007000000050000000000000000000300000000000000000000060600060400000001
11111111111111111111111111111111111111111111111111111111111111111111111111111111111
