11111111111111111111111111111111111111111111111111111111111111111111111111111111111
10007000300000800000000000000000200000006000002000004000000000000000000000008000001
16503040808043606340854450675760803620304050703073606070562862738045782485708263501
10000070804000007000200050000030005000700080207000800070000000007000000000500000001
10654280602065288048742055653048864070835520205860537740388564304677347240603446341
10000070604000800070003000800030004070200050300030500080000000200020000020700000001
10354030404224304233303570288720202050627030652030374043736050867050867030702088421
10700070008000200000600030000000600020700070005000200070004030200060008000704050001
10604557562070332860504056348884267760605662402053408520502750704327306528802740701
10200000000060000040307060000000000030007000405000805000500050800000406000008000501
10637357786438232020468080707253705076737050705536308026832050706370403567248072201
10000000008000400080000040300000205000000070500000806050000080600070200000000020701
10442063407040508024408730406360734836234030304370607043826360603060726467608740501
10003000406040203000508000400040000000002050200040004000000000403070000000800070001
10703880605027508830343070434046445064802070505032345446634227867028856450804076381
10700060306070003000700040004080002070002070507000000000300000005000003000808000001
12775020302070204032407058708023602540365070225272677870606078303370802034586060701
10000050606000203030005000803000206000600060000080003000408000400050603000003070601
10466470307557607030402280407540506050687533258060408058806470745080602532302036201
10000080500030508040307000300070008030500020000040400050003000600020200050007070001
10636056337050604030228072274032374058203050384020764620746084707347467670237030381
10200070002070402030008080006040004000706030004050600030300070500000000020800080001
10404070404020702045708280405076704030275060207550207080802850404855657070503753301
10703050300070004000700000204000008080600070200060203000200000806000300050505000001
10506240854745557660404278807066534270502570372033202035766587406080204060725056731
10200070000000004000700000303000300000700060005000005060002000005080005020002000001
10233058584426606036647452708020607627623025507626784440404354677070548052703822601
10003000600000708000400000705060700000002000407000800000200000000080005000803000701
16408080428620808833304530707060672067402530408030202248854242436228654640404250401
10005060000000400000003000503050004060600000803080706000007000007000700000800060301
10658680754585252247767077506065508060604373308040206038803026703080406062274050501
10000020200000700050003060006000604000407000800080307000706080008070202000007070001
10223064303040208020804040306226707086207020883560802780504650554030804025403054341
10002020004060607000403000805000008000300060000050507000700000600060008020203000001
10802030238520202028608254387034374566234875872680205020667775506038822050605656701
10405080000030008000300000005000006000300020000030800050000000302000008000305030001
10802054833020458780843087706475286060206050205080336765287040308387805624205050701
10805000800030000080007000500030004040704020508000600000007020700000700000508020301
10404760207682507088706370767080803220305080707360703886802040408270804220502070521
10408070003000707000500060807080200080306000300060600070007070507000500040400030001
10204074733760408360264040205020678080646037854044562050653480842075344530532027701
10705080000000600030005040007000400060008000500060008060400000600060000050005000201
10304050448062204024403043446322302027703350207570703080806557406528468080204730801
10300060002000706000708000700000008050008020600000406020708000007000004030506000601
10856856503060764225306740505540384740227060704380307043803074358020806030407888201
10000000005040000020007040600060006000600040200070700070002040002060400020207000001
10587843568030732020543060844066226030207360204023883760643020607060856347406070871
10000000405050003030800060002000500030300000303000203000200060607030400060005020001
10447450807043406070607076308320404577207426507250703020306880805050733080426065601
10002020007070003040005000404000504000500000803000207030300000300020000050002000801
10702060567050837065853250606068603080804660306045602082675027433230558362788760571
10507030500060500030000000703080008080204000202000002000004000400060000000400070001
10502070405523707722604562603020645840258038608737752273605080247052303822808037701
10406030307040002000203000004070000060005020003000000070002030004000300020007000601
10604050505070674040764062528056705055202050434060224050448027802340282040642452501
10800020400060000060008000008000605060008050000060002070002000500070002080000000001
10546360745356772425807236808060486050755080847333478075604070887043303220743257571
10007000700000000000308030004050000040700040003000400060502030008000600040000000001
10503733804022833470203030348274244580308782385070208360402852707420853040273254401
10700000606000000040400060000000000000406000500030004000303000400030006060000000701
10222860703050307070663075447627768726506750302774723070707060653786207070536234501
10000060006020704060005070000000000020600000607000200050707040000040005040005000001
14556040272060843060303420208822263080404366302070804030406023827080223082803034401
10700050400070700020300080208000002000600070006060002030308000600070007020006000701
10403020507620502232357040502785202020854020832063782070708250504748304056474340801
10008080800040700000606070300000404070003020000080000060200060600050007040000000501
10525850803030825670305040357070708085775043475362647060633058647020462080267237501
10004000506060000060502070007050002000002000000000004020007000300080008030300000601
10405072665040547320808020606042235720705062658255407727602580806025408020408030841
10205000700040003000508060207000200080605020002000005000400060003000600070007020001
17803320506435526062304073604070803088506750808034234065803046504330742586732626501
10007000300000006000008000008040002000203000505000002000404000600030000000200060001
10253043863385603432847888287047266870503052522480302230703860265620556550404080861
10300070000000507000000000005060000070700030400070600070508000200080200030008040001
10505340607434504084307323308060633040323780407040258030282025704030402063283028201
10600000700030005000200000607000805070000000507040002050006000006040002000008000701
10284567483020482320823880403583306036256344803082387028806038562080647556224363701
10500000700030200020600000506000007000003000003000600020008030005060000000700080001
10208040825230707070808635202075773546508025422450203370202026307047838480607060581
10003080000030407000706000006000000000007000700000500000204000002060008000403040001
12523763673060703323556035855568288285554830508343675282587643776070208020606852301
10000000000050008000000020000000000000000000200000000000000000000040800070500000001
11111111111111111111111111111111111111111111111111111111111111111111111111111111111
