11111111111111111111111111111111111111111111111111111111111111111111111111111111111
10003000800000400000000000000000200000002000002000002000000000000000000000004000001
14606020604023505430638420254830206840705060807082607050846544356083685278304264701
10000070303000005000800030000070008000500050606000400080000000007000000000400000001
10838540603074862057285087782037234070273470206460248420688828705636226480402884631
10000070407000200040007000800040008050800050300050300030000000500040000030700000001
10846070408426407632302770682580802040757040876050254035464040727060632060705076381
10600020003000300000400020000000700050800040003000200040002050800060008000802060001
10204854444060342750804034384274456650807322503047406750804830203432408654206450801
10200000000020000080805040000000000050005000204000402000800040300000202000004000801
10784247474328465070264020703572204072546060205544506055352080408230807738645083501
10000000007000300020000060600000306000000020400000403070000020800070400000000060301
10466084805080306058208780304540573552628030208840603082363280806060738354307580201
10008000607030806000605000300040000000004070400060004000000000606040000000500030001
10705470608052603560267030264027653028304050506063363738272456852047745240607026731
10800080204030008000300060004030002060005040802000000000400000006000005000307000001
17684050404060508085303033606036607860478060786448865860507047607540402074568050501
10000060208000402080002000308000208000400040000080002000408000700060802000005040501
10644880604672602080202470604480505030383348784030704062408550464040602233604058201
10000080200050707080308000600060006060200060000060300020008000800050800060003030001
10355035828070707070825083382073535055408080245060873820535022202238283560248040841
10500070002030302050008070007060005000803050008030300070500070600000000040200050001
10605060503060802056407660403032704050676080705440507070802230206736388030804664301
10606020200060005000800000302000004030800080700040207000200000606000400040506000001
10503560666454226540206558808086678470803870785032805022736387603080507070733023471
10400050000000003000500000503000200000500080006000007060006000003080002060006000001
10783056587736804078268276202050806277435068507733448520608376747080863043805556801
10006000200000207000200000808080400000005000606000500000200000000040002000506000801
14704080782540504475707620405070477087708360207080704378224887623343368480505560501
10003040000000300000008000304020004020600000608060302000005000003000500000600040301
10284380654367482756825065408042306060502566707050708036304028602020505024466070501
10000070400000700040004040002000605000502000300040207000306070007040705000002030001
10726052702080503040302080302267302062603080447860806670702350557030608065403044631
10006080005030206000606000808000004000600020000060202000800000700080003020707000001
10705040665750303063305367452066373332336885788430504030767665307062542080208374801
10406030000030003000300000003000003000200030000080800030000000302000005000403030001
10803038557070354570344032208344648020702050804020655622257020606448407577402080801
10406000400070000020008000600040005070606070305000200000003030200000800000404030301
10407540203223705048706680567060508760308040706840606662805050506550307840303080641
10303030006000504000300050504080800050803000400070400060003020806000200040600040001
10402077457430508530656020807060266050757058833065622050463350564077334270587048801
10408020000000400060002060008000700040007000200050007030400000400060000040004000201
10405020323085708065505075326583708023206370506630208030502266305325766070502820201
10300020008000404000704000400000007040006070300000804080804000006000008060702000201
10842372306060463474207670402740784250566070608350603082705037422020808070206848801
10000000003080000080006040600070006000400040200030700050006080008080700070603000001
10588654223080345080735030885042767060704730408037787830766050304030452736608060281
10000000506070005050200060006000200030500000506000708000300060508030600020008030001
10855560804038505060404022203660208885507585202520808020803580808020426030758068501
10005070006030002070008000506000706000700000203000403050200000800070000050007000201
10208080678070344022628470608033503060506480303036807056842032557560723223788550831
10508080400070600030000000304040002070307000402000004000008000500020000000600030001
10605080405675208352606523708040267870663087307565363583308040435054203685203054801
10204020605030008000503000004070000040003080003000000060008070006000600020003000401
10504030204070227060825034665034404048607050728050883040736076302360833080457862601
10600070200070000050006000004000507050002070000070005080004000200060005070000000001
10425220648386488678707787602060362060487020864725244027503080768056402460862532681
10002000500000000000604070002030000050200020005000200050604060006000800040000000001
10305548508063853830407080453632732650806358484040507670207782507530225030237542501
10400000308000000070600080000000000000608000800050007000403000400040004080000000601
10724380607040507080826027775343334364308660306278265080204070483843808040744876201
10000080003050205040004060000000000060400000203000500020303060000080006040004000001
15467080848050578070407470806663638030205452804020202050703067233060236046307032201
10500060500060700060500070208000002000800080003020002060708000400050003060006000801
10708050708770803455637060706866807060378060248032575020308870305758702022458850501
10006070400020200000808020700000402020005020000080000070600070300070004020000000401
10824320505070243760604020576040202033854086287275854040486024665040584080474563601
10006000705030000050407080005030008000005000000000002060004000200070007080700000401
10404057826070867530207040503054754870207024654873403237403670403084503040206060451
10607000800020003000704050705000700070804060008000007000800050002000200060005030001
12408580205338482063804055503080205032208220708033582076807025503870343523442573601
10008000400000006000003000002050005000303000407000005000705000300080000000500020001
10268037663337407278426383783023358520202036746440408620404360834770385240405070781
10600040000000408000000000002060000080600070700070500050706000300020500060003020001
10802350504845707085202332706030553070768720602020578070777067802060808074232082701
10200000400030003000300000602000303040000000405020004030005000006020007000008000401
10338346632060542740683720503754306087643367402066778054407027368060456832337444501
10700000600020500020400000408000006000005000005000400050007040006070000000200020001
10708040565880505020205267408037737527207063335760503870604048407035856750208040771
10004080000030303000302000006000000000002000700000400000605000003020005000607020001
15332674776020802756577074728655646373375440808647474825756636226050607020804764601
10000000000040007000000030000000000000000000700000000000000000000050700060200000001
11111111111111111111111111111111111111111111111111111111111111111111111111111111111
