11111111111111111111111111111111111111111111111111111111111111111111111111111111111
10006000300000700000000000000000200000006000002000006000000000000000000000004000001
18802050206078807830644620238820408470507080807034503060275536753075536744705688601
10000070608000007000200030000020002000300040602000700060000000004000000000800000001
10847670708026685022545055822063875040357360404250744550334676304747328260407436241
10000070203000300030005000800050002020200060200040500020000000200030000080800000001
10275080806286403648602440825680404020526080242060577065533080528050738050603027451
10200070008000300000700020000000400050800040005000500040008070700070006000802020001
10604844238050276640504083652757525430703786602086408280408220303288604826505370501
10700000000060000040705060000000000030005000803000202000700020600000402000004000601
10426676286642786070348050303332703044636080203353606086254020503780608223423023401
10000000008000500060000050200000605000000020800000407050000080500030500000000070201
10423067302040502054304870207850354465758050403580303078836550402080427657203870801
10006000402050605000206000800040000000007030300070005000000000407030000000400060001
10804280608087706770233050287023874087702050405057325544438633873036245660402062731
10700030304030005000700060007040005040007080805000000000600000005000005000603000001
14477020708070805053708048803074702380335080234745438380504046604740202087726060801
10000050705000204020004000405000206000600080000070003000205000700060303000006070401
10524880702887503020802780703470706030425278644030202053308640527080504475705053501
10000030500080408060802000200020004080700020000060400040003000700030500060007080001
10774058788060707070735068874027768073405070826050722720643075506522377670627030731
10300060006060303030008080008070004000802070006050800020800050400000000020400070001
10804060208020402057202670805058204060834050402820506020707340808342435070307653801
10504020300040008000700000808000005040800040300020402000600000804000500060707000001
10603830742872666660702258808043485630208280578088802085424683406050502050874028871
10800030000000003000400000807000800000400050003000006050004000004020002020008000001
10638023343233302075376347803030506324673083605442283330807338633080523038802476201
10008000500000702000800000803040700000002000302000600000600000000060004000603000201
17507080486480204676702770806070583057703580705050208353825445287837747480805880401
10008030000000600000003000306060003080300000205080803000006000006000200000200050501
10372580663283443277425067408077304040807453307070802086406077402050706074545030201
10000020200000600020008080007000606000304000400060306000708050008030603000004040001
10574057706020704020508080406722503087605040663530707830702330886070805024707078841
10004080003070607000806000307000008000300020000020808000600000300040006080307000001
10705030263480402085405422522023744847565666733680603030823247408047342080605527701
10208040000040004000800000007000007000400040000080600030000000404000004000502040001
10603068557070286460234055808584775020406070507070682233445040208885205665408020401
10305000400050000040006000500080008080807080708000200000003050400000500000206050801
10604280407388607074606760482040306550206050408450607828302050705780205380202030361
10803020004000604000600050302080700070608000700040800060002020406000500050300070001
10304025485540207380583020404080372040424033374057743080323330238024424540236085401
10502020000000500020002020007000500080005000600040002050700000800020000020005000701
10207070722067708024606067668883804056804760707880208020404588703722456060408270601
10200070008000604000208000500000003040008030800000206070803000007000007070708000801
10644885703060763835808370804450442650233060506220302053307086576060706030707262801
10000000003080000050004020500040003000700030800040200030007050004050200060807000001
10665584575040427060653020475048385060405460307053842330883070608070728224506040461
10000000804060004080300080005000600060200000807000703000200070208050700050008060001
10566480204034507030708057306270703223306636203380807030504830208070844070468063301
10008030007040006070006000503000204000700000707000505070600000400080000040008000401
10808030845070475064385350202055704080303240703056206035733027463470575255223360651
10602030800080600060000000203020006080305000208000006000006000200050000000800080001
10806070807336603536402468805080253420442043502674748874307070577038204574607054801
10303020207070005000207000007080000050005060007000000070005050008000300060005000601
10607020203070335070442084285024204047602060625070748050258053706730428040766343601
10300020800050000020005000003000705080003040000050004050003000500020005030000000001
10287460872728436725404424403020466080247020566757484068606080272027203550436877571
10004000800000000000707020004070000080600030003000300040204050008000800040000000001
10603758802046476530806030232383233730505375575040202280702455507680262040585268301
10600000705000000030800080000000000000303000600050007000805000800040007070000000401
10237550607070603080274055563876352752406340502485665080508040537683305040876334501
10000030007060403050008030000000000040800000506000200070202030000030005020007000001
14223060226050285060707350803368465080708547208030507060603042478020732058202077601
10700050400070800030800080704000005000600050007030008050207000300080006040002000401
10304080307560702742443070507878803080635060646085253040703350404478704063338460501
10003050200020500000502020600000606030007030000040000030700030500080004080000000801
10465580707050588340704030644060606068536062637546258070557022885050575080388427501
10004000403050000030503070004020005000007000000000006040005000800040007020600000801
10704055383050452650404050806032563640403062368853504423604730604045406080603060641
10504000800070003000306030207000400060802070007000002000200080004000600020007050001
16302860203775778078803053703080404085406430307088347024408022608430848634636574801
10003000800000007000006000008040007000402000304000005000706000400080000000700040001
10728088484853803627655778375023875430706044577320705570304280723750366780408020841
10500020000000704000000000003070000070200040500050600040705000200040600060006070001
10503640607675607045707372806070534080488580604060646070858087707040804083555068501
10300000600080003000300000304000204070000000508040008030006000003070008000007000701
10775542222070635550327230708386807038557337304084256086208073744060852246886225801
10200000700060400050300000705000006000008000005000500040005080008040000000600070001
10502040623320504050506772503076276824506065844580206660803072602025463230208060351
10004040000070805000505000008000000000006000600000700000506000008050006000606040001
14547636774020807674758066668783776382527240705542875854824262353030303040608223401
10000000000050006000000020000000000000000000500000000000000000000040400050500000001
11111111111111111111111111111111111111111111111111111111111111111111111111111111111
