11111111111111111111111111111111111111111111111111111111111111111111111111111111111
10008000300000700000000000000000400000006000007000002000000000000000000000002000001
12703040502027208360324860545350506880404040707035507030664352364068476658704678301
10000060404000006000300050000030003000700060507000600030000000004000000000300000001
10586640405027475062766088837036466070767420503560325880656432306466232550702473741
10000020508000200050007000700020005030500080800050800030000000300080000030400000001
10578070505766207425503430823430502020233070566040565038665030742030622080602033231
10600080008000500000700030000000300060800050005000500050005060400040002000506060001
10203472556060746430508048224242442660305478604025405630702250207722402755404240701
10400000000060000020807030000000000050003000806000406000300080500000706000004000601
10455228343337734030833080202857304077482070806234705054332070208270304736227064201
10000000002000700070000050400000604000000040200000806020000040800070500000000030801
10582023203050407087703720606360744433566070607260608073723330303070588234603360401
10005000507030808000205000700030000000002050700030003000000000808050000000300040001
10506570504066704360334050265065856055304070205048543228458578232036375620607065881
10400060803070006000600080008080002020006050205000000000600000006000007000702000001
17532050706070607048202086503083508660882080622455623320404086303720202024388030601
10000030807000808030008000602000708000200070000080005000805000700060802000008050301
10847340606647502070703320802680206020233433562060402068308460786040702867503086601
10000080300050406050806000300070008020600040000050300080002000600060300050006050001
10364024366080405080225073755053877063404030745050433280235023205438322640686060581
10800020002070703070007040006040002000604050003020200060600020300000000040500060001
10402050807080805057704730702025607030665040807220303050405280702825884020607656801
10604080500070003000300000404000007020500070500030406000500000405000400080702000001
10705560287243782220706688405038278250805520767036505075376528302070205050487022751
10500030000000004000500000805000500000400020004000003040005000003040002080002000001
10732057822762702084275866508070808324835044708233378420408873883070676086608743701
10005000700000803000800000707080400000002000202000200000800000000080005000502000601
13708020644740306855806320502020345087505270308040407636322475255764642560603220301
10007030000000600000008000608040005040400000702050607000007000002000200000300060501
10466770327835547284365067405032207020405664206020806062805038505020603065823050801
10000050200000400080002030008000304000402000700030403000403020004080307000007060001
10274064307070507040208030403885703023503080545850204420805670437030706028704074731
10004070008040605000608000202000003000400080000070806000600000300020004040208000001
10604080823850808085405623572086852247252487658830606030754883704064472050705485301
10807060000020008000500000006000004000300060000030500070000000602000008000404070001
10206036582050772750262036305758248070503040503030365358847080603257406363205030601
10707000300070000060007000400020002020306030405000500000005080400000400000505030501
10808250206677807048205850763060602450605070406380707475602050804630605370508050471
10607060008000604000700050803060400060605000500080200040005070204000200040500030001
10602038773550604240785020304070863040835027874055484050224260838062646550544035501
10306080000000400080008030002000600040006000800030002070700000400070000080003000701
10203080685076308047308033345356408024407830402860305030603763706386353060405830201
10400040002000804000408000400000005020007080500000502060404000008000007060706000501
10464543704030742637302730204830286280624020203440407032205034528020805040708746501
10000000005080000020006040800040003000400060500050400060006070008030400040507000001
10845784263060577050442080876053646030204260504026324240733030608040252425508050251
10000000504040005040700040002000500080600000305000804000300020805020800080008060001
10274770806036304040202023406450803272708668407560606050405240705050784050773022501
10007060004060006040005000308000608000300000406000607080400000300040000020002000701
10306020353050652025382850504068404020608230303082305082377077867550282844388860731
10507060300050700070000000305050006050704000402000006000004000600020000000300040001
10305060705652708752603684602040282480746076503727283568202060664085808676208058201
10207040602030003000806000005080000060004070003000000020005020002000200020004000401
10804040507040642040847077235023707085705070548020245070775086804740734080353832301
10300080600040000030002000006000407080002020000070008060007000300070007020000000001
10722360324363443527505622207060737020523070423244354072208020345065604430636863421
10004000800000000000402060005080000020300080006000800070204030006000700050000000001
10302227504053386540605020675423865770503687276020603320804465306530855070637428401
10500000405000000080800020000000000000802000700030006000803000800040008030000000401
10835520308070303060268065747863362375207480203452853050503040857863703050644224401
10000020005020303030008080000000000080400000703000300080806030000080003060006000001
14888050588060345050607860506437433070608358702050504070603046657020875046402084201
10200070300050700080700050502000008000800030006020007060606000500030008050005000501
10507040802530502482875080408645306070865050522043835040206450505746707056646750201
10002040500060800000806020800000508020008030000020000070700020200080007030000000401
10542560204060582650602040833030702047853025638544435020646074764020845080288574301
10008000407050000030304030002080002000008000000000002040008000200080006050700000601
10304047833030467240508040407082563780402057362322208326503850202046604020607040781
10303000200070003000305030303000800020708030007000008000800050002000400080007040001
15302570707858774087403024505030407055704440204077346053802047808420278226825653401
10002000200000006000003000007020008000302000705000007000307000800040000000600020001
10847042886864402644843445526043324260603042388550506680704780272650657370206080781
10400080000000806000000000006020000040300040600050400060406000400070500020008030001
10208240606752507046303248708060868060253640808030458080257034707070208044572038501
10600000500050007000800000207000505030000000807060004070006000003060002000005000201
10278623746030547880327350505484604052377737204034236083604055228060643857655524201
10200000400070200030300000306000003000007000002000600020005060006050000000800030001
10206060753540607080704532308084234328506074865560807570802074202035442830705030431
10004070000020406000702000002000000000008000700000500000604000007040006000704070001
12256374585060803868427053653756476634744560702743854472864735338050602030702248201
10000000000070008000000050000000000000000000200000000000000000000050200020700000001
11111111111111111111111111111111111111111111111111111111111111111111111111111111111
