11111111111111111111111111111111111111111111111111111111111111111111111111111111111
10006000800000300000000000000000700000002000003000004000000000000000000000006000001
15805060805052705720483430632560305460205040606057807040842367442058442645604684301
10000080404000008000400080000020008000800030402000200030000000006000000000800000001
10688820603053872076842062847062373040347880406740647760687372706356343240606454481
10000070504000300080005000500020002030600070800020600060000000300030000040500000001
10557050308234504272408240246650305020237050567080755074848040372030668060804026671
10800050003000200000700060000000500080300030005000800080005080700060006000405030001
10502655742040775250802052264652227230604784506056805640302780402754804756707450801
10400000000040000070308060000000000040006000205000406000400060700000408000004000201
10782477582286262030485050402248804034344060504545505053335040805430506562576047701
10000000004000700030000070700000803000000030800000806020000080200080400000000050201
10688028703040702084704580805360348675562050707540202057576380606050658566302280301
10007000508040702000805000200060000000007080800080002000000000402020000000400080001
10606840404038706840872050243047637074205070704073827643737765245022443370406027651
10600070602030002000300050006040002050004020303000000000300000006000003000505000001
13284080506050707054304023304034602660845020882638275560505023402620405067672020301
10000050406000405030006000703000603000800060000080007000504000500040508000007020601
10234530203652808040702830506650508060554782223030605035305680373030604253406053501
10000020700050804050406000600040003050600030000060400070004000300060700070004060001
10556066556060605060327022888086646038603020585070883670572083504853285470763060531
10300040007040702060005070004060007000202080004030500050800030500000000060300080001
10602070408080202085407320607022806080868060706420805030404480805537632080707467201
10805060200040005000800000506000004050600060300050304000400000605000400060208000001
10702880456464437620608648808063645640705450852022408034555575604040405050866077531
10600080000000005000800000202000400000400030002000007080002000007060005020003000001
10388076546864502023334536703040404257636054503537264240305275847080876054508354601
10002000800000203000500000608040800000003000202000800000800000000080008000808000501
18304060223830205354706270807080877073307580506050607683326648586825632580605730201
10004060000000700000005000602040006020200000604070704000005000003000500000500050801
10348350387676726345846037304024407030708535308040604048507046302060604078477070201
10000060800000300080008040008000502000708000300020207000508020003020703000003020001
10655062403070403080304050507273403045704060738780308660708880466080207025208044351
10006050008030608000407000706000008000700080000080305000800000500040003080304000001
10803070547620802027702745225046476864477838376770508060626556408025772060803757301
10805030000030004000400000004000007000400060000080500020000000805000004000607080001
10504055374020736860365027305886458040507020702020786432234040604637405583704080401
10307000300060000030006000400050002030503070403000500000007050300000600000707070701
10806440405678507034607760382050806350506030505850608474407060303830802770602030851
10608070002000406000600040406080800030807000800020200030007030406000700060800070001
10502085762750607440733030806080422050434077442085273040624730358036247450736048701
10706080000000600080006050005000600050003000800020007030300000500070000070007000701
10604020853085307054404087255656404078206640308550405030208345302457254080505860301
10700060003000306000504000300000006080007030400000408080606000002000004050303000201
10373768505060748338202870708760822280628040608820803056503024627070308070408653501
10000000008030000040008020400050002000200040400040300060005080004050500020208000001
10424342778080452080274060638023863050508780504025788280543020806060684573208080451
10000000207050002020200050006000800040200000405000308000500040503020300050002070001
10555550604032702060402053508440303274803526308860805050507280305070564050344074401
10007060002040004040005000505000502000500000605000805050200000200070000070006000301
10406050745040644036678660603042803060202340204062307068668048242260644234556680251
10608070800030400080000000805030007060607000703000007000002000600040000000500020001
10707030405636205386202835704040474830644076406633734553502080638046407626308026801
10606070307070005000303000008020000070008050002000000050007040003000200070008000201
10402030708070773040443064386052205045206030484020476060827074307520327020843344301
10300070700030000060007000002000206020004030000030007040007000200040002020000000001
10855770734373855336805458407030538080488050367537456072404060575032205220255237771
10004000400000000000304080008070000020200040005000700040305070005000600070000000001
10505422707028582730508040677776667550506544284040707870306727802850788020278573201
10500000504000000070200080000000000000604000700070008000403000300060002020000000201
10722880807030503070664038636746476728308240703276346050702060238525404080258657801
10000020004030802050006030000000000070400000603000200070207040000040002080008000001
17873070386050735030304680603252482050602382305030803060707046477030542045405062801
10800060500030400030300040503000004000400050003050003070703000400030003050002000301
10306070608250705862888070807785608020525060672057655040807540206877208037547420701
10005060200050700000407050300000507030003070000040000030600080200040005040000000401
10576680303060677730402020245080206085433068445628823040578057582070742070327388301
10003000308060000020802050002030008000008000000000003050005000200050005040800000201
10503075446030642420802040406046258370307022762237405536206530604044607060704040821
10502000600040007000406070808000400040502030002000008000500050004000400050007080001
15808280702354386088805027405030503036608560508085752035202073404750726848583276401
10003000700000008000008000006030002000702000803000004000702000800050000000700030001
10324026758524203776567464326077742830408025285820403720808340864520835580407020681
10400060000000303000000000006030000030500030500040300020607000300060200040004050001
10803840307252405074704832207020857050527420507070752060328047305050504057375034501
10400000200020002000300000203000802080000000707020004080008000002080008000003000601
10226884764040462880524850704666803025827354404084457053807086275040338557555577401
10300000600070700040300000205000006000007000004000500030007080008060000000300050001
10607080633430804020703882803083627772206082522830305570208067603077746750706050781
10002050000080508000702000006000000000006000300000800000705000004060008000707070001
12528485532050706475654074557247224752724580406553873485523538526040707080602432501
10000000000030003000000030000000000000000000600000000000000000000040600040700000001
11111111111111111111111111111111111111111111111111111111111111111111111111111111111
