11111111111111111111111111111111111111111111111111111111111111111111111111111111111
10005000300000700000000000000000400000007000003000003000000000000000000000007000001
17803020602033704770382670588280803660408080806064804020734868382027582543407757201
10000060308000006000200080000020008000600020507000200060000000007000000000600000001
10522720402037374077685065482047843030844230207240836870447753504428488350206542741
10000070408000500080005000500050008080300060800040200040000000800070000070400000001
10734040206563805842802560665440208080883050832060686087553040887020322080706055721
10600030003000700000400050000000200070800060002000400040004040400030005000605020001
10303582772050533830508067555576566780408732504078505330404370405426606748808430601
10600000000080000040405050000000000050002000203000704000600080700000702000005000501
10572663847335423060252050405637602085537070403352706078765060302870408674887048701
10000000003000700040000080500000705000000060700000504080000040700050400000000050501
10555055707040708032306220403360767852764050207460404027653430805030852782307660201
10008000806060705000208000200080000000006050500050008000000000704060000000500050001
10502370308064306650785050276024428073207080505057555728682575556067452870305058781
10200060408070003000700070006050007050008080604000000000700000008000005000802000001
13246020608030807054306046802063504260345020874228747280407084307620705063443040401
10000070602000803060004000304000607000300040000040002000302000600020207000004030801
10342660305353405060708870204770408070763323744020303088702240255070708585604067401
10000040400020203070808000700030003080400040000020300050004000300070600020006050001
10743047584020805040277067442056457055704040852070433730853045205345732350226060831
10300070003040507030006060006050002000302060005030600040200070600000000080600080001
10706080506060207023704550506072302080846070205430708060804470705354446020203622401
10506030600080004000600000207000004020500080700060602000600000205000300020202000001
10808820588754275320504552505044842270604650622052804023783335208030402060867044851
10700050000000004000200000606000600000200020004000005050003000003030002080004000001
10535047436886202066768376606050202456236034203867777450407278758030325067405888501
10002000400000706000800000405070200000008000306000300000300000000060008000406000601
14603020755470806534704830606070275084203640806040707568283443778228627370603470501
10002020000000600000008000605080002030300000306050603000007000002000200000400070401
10463280682387825738525046202034204070607776702080304077204034806080702028685060201
10000030700000700070003040007000205000207000800050407000604070007060708000005070001
10883082705060708050507050503337703078407040762820203780406570275080805087305057761
10003040004020404000305000505000008000700020000070807000200000800080005070504000001
10406050276480305037205267765076833657253747588680204030565733204057687020403673401
10504080000070002000600000003000005000500070000080600070000000702000003000702020001
10307024732030286730754047205246374070206040302020755558274030402863704662404040401
10506000300030000050005000200050006080706040203000300000008080200000400000805050301
10805680602556407042503740738060302380708050407340205774402020603440708240505030541
10804070008000708000200030707030600080208000300070400050008080202000200050200050001
10405078548860207560266050205040675080778055744034758040863560654044625680622025601
10603050000000600030007080002000300030002000200040006070800000700080000070002000301
10704060853078805042306088324574402054206270703430406060507825303574466070706380201
10200070007000505000603000500000002020002070700000508020304000004000005070703000501
10763552405070768476607770208540266280538040804280208058506056525070507070306743701
10000000008060000020008060600040003000700070300030300040006040004060200060808000001
10382338288020334060347070753083458050404750604086344650282060607080346336706020231
10000000404020002030800070006000200080700000603000508000700080506070800080008030001
10445240504066408070304047503840206856802267407470704030804280808070348070737078501
10003050008060007030002000206000203000400000605000805020300000600080000050007000301
10707060577030346083236860306052207080503580706065406053724087275470237652363340421
10506070800060700040000000407080002030602000705000003000007000600030000000500060001
10802020704388405842804265504070623360864023702886264832602020246027208552806036201
10706040806070007000302000004070000040002050008000000030004030008000600060003000301
10704080508040348060876043632073604053705040242080587020834074203240268020384787801
10300030500050000070005000007000705080005050000050006020007000700060004040000000001
10645370244522525524303586606050325020725080435437563086604020233052606520226744271
10003000200000000000306030002050000040800040008000600060506080006000400050000000001
10503875207035666830603020866564262440805242387050504530805345206650273040244523701
10600000507000000040400060000000000000608000400030007000308000600040004070000000201
10673730702070808060728066554837728823302570304632262050403020524832207050555423501
10000050007070708020003070000000000020300000706000400020802040000070006070005000001
17764080646080226060604660305674857040505386606020706070804065668050222063602077801
10500020600080600040700040705000004000500030007020008040704000400030005050007000401
10503050708340606732323070808264304020458040474026286070604450703536607082437820701
10003080500080500000803070300000302060006070000040000050700080300080007020000000801
10673750604060452230404040682060703087386078885437838080842057328070425020357876201
10006000802030000080504040004050002000003000000000002080002000500050007060700000801
10305062582040527820206060808044772260402036354848408436608870408082203060802040751
10806000800020007000602030308000500020603050005000002000400020002000800050007050001
17603870604566283047604023606040606037705680705047556084802073706380855848862725601
10002000400000002000004000008060007000204000606000002000805000200040000000300040001
10483077676464808767824447727054856270306087656560702670607580655350734540206030271
10300030000000707000000000005030000050700080400070700050504000300060500070006020001
10406870602472507064608752807040265020457560404080473050734067805040408082745048401
10800000800020002000500000508000608070000000507050003040006000008030008000006000301
10436487342020587850823560706554604083323644505055432086804088663040828345243472501
10400000300070300030300000505000007000003000004000300030008020003040000000700030001
10202030642760603070408836703077634577203087838620508580206042207073368650406080331
10005080000030308000405000005000000000008000500000700000305000004060005000505080001
16657866865030702434564055374778753358568380503633384642375475785050602020405876401
10000000000020006000000020000000000000000000800000000000000000000030800080300000001
11111111111111111111111111111111111111111111111111111111111111111111111111111111111
