11111111111111111111111111111111111111111111111111111111111111111111111111111111111
10003000500000200000000000000000400000003000007000007000000000000000000000004000001
13404080307062308470337530432720305350202060307067603030677886437037726835408225801
10000050806000006000300060000020008000700040407000600030000000003000000000200000001
10467580503086656048448023764054536040887650402320534260878753707252386820602442241
10000080207000300020002000500060005040700050400060600070000000200030000070600000001
10727060704686807665508770372470607070688020276080424074288030442050758080406063331
10500080002000400000600040000000700080800050008000300080003070700080004000803040001
10408835267020534450806022682236552540203756707083707220604340407538505424203720701
10300000000080000070602040000000000070008000606000702000300070700000408000007000701
10262338527464348020868040707836602044288070704574202075477050705480607377623072301
10000000005000600070000040600000806000000080500000608030000080500050300000000050501
10842037306080502054402860608380855543784030404380605076252840205040887832606460301
10005000703050607000806000300080000000003050300050006000000000308080000000200070001
10702370306088404830844050523087584086706060307067638684648484334083585780208044371
10800030206050006000800050003030006070002050507000000000600000002000007000203000001
13578050305080707026405045203036602260357060536727624430308023304750607035526030501
10000080606000403060003000402000705000200040000050008000206000700020802000008050801
10727460607783706070606470203870403030532682453060308047208650265020508742406032301
10000070700030407070207000700060006040400060000060200050002000300080800080002040001
10474056722030204030525087768048426037708040722030335820688064204857264240528070721
10500020003040306030005030005020005000207040006040500070600040200000000030700070001
10808070202040502024307460502043602030358050702720408030507760305358723070205528301
10804060700050005000300000404000002080400060700060202000800000804000400030703000001
10706750458525833350707723507076358560608860236068505084275747707040608050786043381
10300070000000003000500000206000400000400070003000007030003000002060007080002000001
10647033558263207043266756803080705336376075607344285660805378756040533083803664601
10006000700000308000800000503030200000005000305000400000700000000060002000305000401
12402030653620402587303770208080745062507570704050205784242686425837824540303530701
10005040000000200000007000507060003060700000204020603000008000002000400000700080801
10222240558558767846243036606074505080405345207040405055405038204070304062533060401
10000030300000700070007030005000703000303000700060407000305060006040302000008030001
10867053805030807060808040305243202023403020552820803750202770746040805037507032881
10003050007080205000704000608000008000800060000070502000300000800020003060502000001
10603080642830607067808344368038775577542366382460603050467728403023626080706683801
10407020000040002000700000007000007000600030000070700050000000207000006000203020001
10506023388050586440452044405554748040202040306030688743323020506346703675204060401
10803000800080000060007000600020004070304040604000200000004020200000400000406060301
10706520508246505083802260537030203480802060807670504433707060308360702760702070841
10807050004000503000700050805070200060802000800040700060002020506000400020500070001
10207055777480803550832080707020655080754048437032325050385320785063853640244023301
10804040000000600080006040008000700040003000600060004040500000600050000030005000501
10505060777035808077404027285844306083402380508320204030204686702754277040703240601
10800060006000707000308000200000005020003080400000504040407000004000004020303000801
10774632408070868478303780606480887340342050506870406055304048374080503030305748501
10000000003020000060006040500060006000500040400050600030003050002040700040604000001
10256266465040583030253070576073356070308750502043473450842050306080663377503070461
10000000304060006040700030004000800020500000508000405000400070703020700080002040001
10353570703027508020305078403530603335606245606520606030704480806060364060347043601
10007020006060003030002000507000404000700000208000703030500000300080000080004000501
10703030463020628034263770608047302050804730604056204082373065677670347783677480471
10405080800030300050000000405040004080207000802000006000006000300040000000700020001
10802050503283604864402236506070375580563066406375232546206080848048502884303042801
10304030707020008000602000005050000070008020004000000080008060005000500080003000801
10602020202050826040544082456058606063302040766060683050452083208750475030566527601
10500030400030000030003000006000706030003020000030008040003000700070002080000000001
10757470743884638675502434804070577040777070366845736085707080647088306780362588871
10007000200000000000408060002050000060600060006000500040707050003000200040000000001
10302476405056786230304060823266546540203736343030204830707358706460464050367667601
10300000402000000080700070000000000000505000800080007000204000200050008040000000401
10257380204030805060867074547362454278406740407834353080306050374268705080372776701
10000050007040606020005050000000000020300000806000700050303060000070006030005000001
12337050428020387050802460602432267070705535604020803030807054347080585042506086301
10600050800060700020500070304000008000400030003020004020504000800030008020006000201
10706030505760602467386040306456602060423040722032473040308830507685604087725380501
10002040800080200000506050700000802080002030000060000050500080300020008070000000301
10382230407040774850404060838040302058536082244285762060464023632040588060546623201
10008000307020000030208050002030007000008000000000008080005000600070007040800000201
10504082384030658870702060705033262380308045762485302653608670403033407020208070341
10503000400060004000707030306000200070308040003000006000300020002000800040008030001
15708570702654246064308033306020702042604260402073583065703052705540627524686628501
10008000800000005000004000007060002000806000704000008000604000500020000000200030001
10452024778535306386253447542077337730806063622380206870707220587480324350408050551
10800060000000603000000000005080000020300080300040700080608000500050200070006080001
10202250203644807065404335208040343040745870203030542050255038203080306083365044301
10800000800070003000800000206000407020000000307080006020007000006030002000004000301
10278624564050338880646820403366505084446255303035452046508025776040534634438273701
10800000200060800080800000607000008000006000007000400030006080008080000000400070001
10208080822550708060608837505046662836502088786570308230804037605056424460205060551
10007030000040207000408000004000000000003000400000400000307000002080002000604080001
14538482355030208242383078348255325745284660603223538475667323584050303030508375201
10000000000020002000000040000000000000000000300000000000000000000060800040700000001
11111111111111111111111111111111111111111111111111111111111111111111111111111111111
