11111111111111111111111111111111111111111111111111111111111111111111111111111111111
10004000700000500000000000000000500000003000006000007000000000000000000000004000001
15405020403087208580658280686730702680306050807037506070837465345074576778204273301
10000050703000002000300020000060007000500040804000800070000000003000000000800000001
10628580607067653083428076748028324070638370808220628780475774204687572270407742671
10000080402000500040004000400070005020700070600040200030000000800040000070800000001
10847060506334504875806650876570804080356030883040246057766030328060263060708047751
10600080004000500000200030000000400050200070006000700030008030700050004000504040001
10706487264030452460305055378353255340602752207047404430404730405658708264802650201
10300000000080000060304060000000000060005000207000605000600020200000508000002000601
10587668287823452020357030403826803038775070703352608075277070706880206737484042201
10000000003000500030000040300000302000000080700000705020000030700080600000000030601
10884042508070608062508820402660583336676070705820305056653640406080343247602420601
10006000205070206000805000700060000000003080600070004000000000808030000000400070001
10505430303024406550284070448048637087806040606086326465334725438053543460605036671
10400040608030007000200080005030003070005040603000000000500000004000002000808000001
18627040407030506033805084405085402430363040372657846630406065602320808037344080201
10000060606000207050002000808000404000300060000080007000506000400070706000006040801
10547230202757803070203380407730205060266255882040604046403370827050702285508023801
10000040700060708040504000800060008080500070000040200030002000800050700050005040001
10255038548080306030754044322082283042204050648060424780562072406857766850467070371
10700040004040308020004070008020003000203040002080800060200020200000000030200040001
10302040206040504057605550606034502020755020706340803030708440507377777050707766401
10308080500050005000300000206000006060600060600080606000200000404000300030508000001
10502550762823427760504565308023645650308440424074804083528857304060302040372057361
10600080000000006000700000603000700000500030002000003050008000008030004060006000001
10336052546762807023535846805030203857823053206557565430807265685060377047607678801
10007000700000808000500000407040700000005000806000200000400000000070006000704000401
14603030287630305464606320404040384024304670807020502868384888274726443760608540801
10006050000000700000008000805050004030600000408060308000007000006000300000700050701
10276240864364558585452064805038602030307767506030505022203052702080407025623060201
10000080500000200070003040005000806000604000500030706000306050003020605000005060001
10345047808070304060802080705368208055307070676560603550707860828080203038605032851
10007020006050807000205000604000005000500060000070508000700000500070007080803000001
10803020237720506088608228323084366584563842423740308070552234307028388020205823501
10206080000030003000500000008000006000600040000060800070000000608000006000507080001
10804045825040485270656066408224278060807080303040286687726040305375402322408060301
10405000200070000080006000600030004050304020408000500000003070400000800000404050601
10608480603852307037308350442080602830202030607850805575303080503770306820607070771
10305040002000203000300030407020600040808000400030400020005030305000700070800030001
10705042662330308560366030803070353040536078356033824030736240485082544450422083401
10203040000000600080004050007000300070005000200040005020400000500020000050003000401
10508040286055706075602083832355606075505580708860702060306784403274846070204720201
10500040008000302000406000400000002050008070600000205040406000006000005030606000201
10432888205050834657804470505860856260826060802660507044408074672070803030304227301
10000000004020000080003030600030004000600050800050800030004050008020400030604000001
10525234327070743020554080458078463020708860607057256530477080405050262543508060661
10000000306080005040500040002000200030300000603000402000500020608070700040004040001
10262560202022304030207023306280508844708248605840604060402680307040223020264076301
10008060003050004060007000303000602000600000507000405050800000700070000030006000701
10405030354020487076578620306038503060606780208082208022548044826570727324775620721
10705040200030500060000000206040005060602000204000003000005000500020000000600050001
10605020605327802326508664508050823780287042708876465365303030446032405567402036801
10207080806030004000708000008070000070008060002000000050002060006000400060002000401
10302020807030538020468075678023603066607050666060846060453037704850276060284577401
10200070600070000040004000004000303080007040000050004040002000300020008080000000001
10648280478528355452604327208020777050257030288378435046405060672072505630272544681
10006000700000000000402020003060000060600070004000300080403080006000400020000000001
10704874607083447680805060734836843820203678522040807240807847606830448070464284501
10200000506000000060700070000000000000507000800050006000206000500040008040000000301
10535370408050603020772074425246373888404870308755768040303050656885504020356485601
10000030003070602080003040000000000080500000705000600040705040000030004020008000001
17288050363080387030504830502545664040207523203080502030803084228030738045607032701
10800050800050400040800080402000003000300020006080006040807000700070004040007000301
10703040302270804853583070206743502020434080222073252080704740705587605037544660401
10005040500070400000205040800000603080002060000030000080600040300060003050000000401
10278680704040735340608040376020503036362046547234575070552055522080787060345572701
10002000207070000040203080003050007000002000000000003070002000500070008080400000701
10504047883030562240608080704046657830202035835638304338803640402024702060202040771
10205000300050006000502080606000700040406060004000007000500070008000600020008050001
15605270205586835056407082203080805022308870203034465057702034306380283565876748201
10004000500000003000005000004020002000206000808000004000706000700050000000800030001
10557036223887503854624753567068443240203055488550608250205560528730764230603070741
10200080000000607000000000005030000080500020700080300060805000600080800030006040001
10507320505366505048504722505050262020532380705040842050436022202030707025435064801
10300000600050004000500000405000504050000000203070007040002000002050006000004000601
10328885225030882450682650403283604023523264802022565072404065435030564273523258801
10600000800050400060700000703000007000006000003000500060003040008080000000500020001
10206060767820308050203373306063667438602074245840207880506053207063325430704050531
10002020000070603000308000005000000000003000300000500000304000004080006000402060001
14848724668060702656438026645884372778827450405878277342438862544040605030502624301
10000000000080007000000060000000000000000000600000000000000000000080700070400000001
11111111111111111111111111111111111111111111111111111111111111111111111111111111111
