11111111111111111111111111111111111111111111111111111111111111111111111111111111111
10008000200000600000000000000000600000004000004000002000000000000000000000005000001
13404020205062604480288460337270207430404060405036803050483638638048685873605823401
10000040607000004000300040000050008000600030203000300060000000007000000000700000001
10476630403046823054673056732047546030646720606240545740883544208463735420602557261
10000070407000500050008000400060006060500080200060700050000000200030000080800000001
10435080203272405528807660323550802040267050357020444026245050388020524070604075781
10500030006000500000200060000000500080600070002000600060006030700020007000705030001
10402428558020526470507042855874427330608675507082302260704660706277704445503340501
10600000000030000020707070000000000050002000708000806000700060300000706000002000601
10577885638383252070638070203583505077246080203433702076662080204830502243352023601
10000000003000800080000080700000707000000060800000302050000070400070300000000050801
10833023205020203076708820808720276323346050604430202023745630208050488786808440401
10004000303040304000308000700040000000003070400050006000000000307060000000700030001
10603540703087608330328080336046845036604060704034575782366252777034285640807055571
10200020203020007000700070008080007050002080802000000000500000004000005000703000001
16272020402040807088406052308062803740453070664757725260308037308550806037542050201
10000020605000403060003000802000706000600070000020006000507000700020803000004070201
10735330404438303080808240507580505030734583565020306075808660377080803786604065801
10000070800060605080606000700030004020700030000060400050007000600020500040007030001
10334078358020707070486064733073863035408060852070252530887076308642786330333020431
10300020002050703020002060003050005000708040003020200080500050300000000050700070001
10602050802020502078502820707043703020763020805830204070305440208535542070804866601
10405070500050002000500000607000003080200040800050708000300000805000700070705000001
10306540788235845320403427407022866650603850633082406082625457803030407030444026271
10700030000000008000500000704000500000300050006000008080007000007030007030004000001
10478076574565207066665234508050404838648054404238487640702828486060755072204545601
10008000600000708000400000804030600000003000808000800000600000000070004000704000501
16605070884760308745504840503080472068202830406020608432763477776555762760706860701
10005040000000500000004000502020004070800000606080606000004000002000800000800060801
10482280254775737435336074505075204040404552602030403028405078806030207024477050501
10000080400000700040005050005000802000302000200080605000508060004060205000003040001
10524085705080507040702050307664208084208060338380404370306240255070702077307043441
10004050007080706000602000207000006000300040000080205000200000700080006020508000001
10508040783850304067602427763072623773766347458240806080575554803028263060804685801
10704040000020007000800000006000008000400070000060800070000000806000005000502080001
10804057572060645380883083302272532070602060403020568323253040302222808644404080501
10206000800020000020005000400020003050707080706000200000005070300000300000407040401
10203470208388803068505680838030205220803050306440702672207050707480307740407030321
10606030007000604000700060503040300080306000300070600040004020603000400020400030001
10407045855720608820626070207020644030753085728043572040383720247044627820784065801
10702070000000400060003040005000300080002000700070004070800000200050000060003000601
10204030858055405053307067534542808066503330304780807050802875608574268060702270201
10500040006000504000202000200000002040005040700000703030807000008000002070404000801
10235643207030585764606670708820673740786070803220503076707072688030407050402644601
10000000005050000060005070300040008000400060800070600040008070006020600060705000001
10237268686050864050528030742048438060505340505087457350643020506080644862707050331
10000000504030004040500070003000500040700000807000207000300050608030600080007050001
10448650508084203020808043808340503484808284307220806030805230205060335050577076801
10002030002020007030007000208000303000200000703000705020400000600030000040005000601
10605020455050457043584850607073807020402630503045402068323063655260278773775460441
10203080400020400070000000206030005070705000704000008000006000700070000000300070001
10708070205342203648207752704040848850635036802664864758307040467056808462803088601
10408050702040004000608000007020000080003030007000000080004040002000400030006000301
10306060804070745080666043444046703045805020866060237080272058208370875040835533501
10600020500060000040005000002000402060002030000020006070007000800030008030000000001
10273320836366457538706476408060262040326060277643226045608040255035808650833638831
10006000600000000000705070005080000050800030004000600040304080004000700050000000001
10707882705042546280504050865575656460205672787060305240708638202630285060255667601
10800000304000000050300060000000000000803000800080002000305000400020004050000000201
10528720208070804080573044424573273648304720302776366030702060863787808030467558501
10000020005020804020007070000000000040200000408000600070708050000060008070008000001
16346080877050873070802440406522248020302235205030502040608036324080758055606033701
10600040700020800060700060408000005000700030004040007080204000400020004020006000401
10602060408520304584828030204774308070622020626074562020802570804456405075458820701
10008060400080800000406070400000504040003060000040000030200060700050005070000000701
10355630807080677450206050845030508087246068225332285020627078254080565060537844601
10007000507030000080407080002040005000004000000000002040004000500070008040800000801
10603076673030433380603070708032274740606084233368602727206460808028507030403030381
10804000500040004000803060303000500060202070003000005000200050007000300060006060001
12808720607454827074808048708020205067203530503043868074405062208730468253486443401
10004000800000007000002000003070006000302000307000008000305000800070000000600040001
10268056635878808232274562665066366280707074585460503480604530377260276550504030371
10600070000000604000000000003040000070400030200060500020708000800070800040004080001
10504660304652607047702765703070548040277380602080452030678062602050503048534024501
10300000400020004000400000802000308040000000707040008040002000006050003000003000501
10633573853040573780777530408557204068657652306022657085405047524080435648258635601
10300000600030500050300000404000003000008000002000800080002060002070000000400030001
10504070226730802040303243205057235858707076364430206820705022603025647770504030351
10003050000020408000403000004000000000002000400000600000306000002030007000406030001
18847324622030804852774085582423545364842370305242228355847565333050302060804882801
10000000000070006000000030000000000000000000700000000000000000000070400070600000001
11111111111111111111111111111111111111111111111111111111111111111111111111111111111
