11111111111111111111111111111111111111111111111111111111111111111111111111111111111
10000000300000000000000000000000000000000000007000000040000000700000002000000000001
14706080307283603447785534642350205862204050836073263030406080464540604020274868301
10003070005000205000000000200080802000608020800050008050303040600000508060000000701
10843088342040783080778240222020406020732045204240203030303870608234808050636680401
10400040000030007080000020000050204030005000302000200060600070600000200020000050801
10224530207664305080836060386850802056305520502062832730602070553880503857875080501
10005000600000200060003050000070708020500050405000000000507080000000500080000070201
10507020623780642537373034586040704070308070505664488248207048355064852050747450501
10703050005000600000008000006080407000503000700070000000204000004000003060005000401
14606060406072404284206672604750728623278854632020767350888866606054708054337082801
10007030607000006000600000200060000000000000002080302000500000002000707050005080001
10378040702473668040853358444042834334347576506050404078602425503560305020604030421
10004060500000000020002000000070000000000000607040603000004000307000403070600050001
10307070562624868582304082246480406276203460404760704065486020543073402020857073701
10200030000000000000807000400000800000206080500000506000002080000070004020008080001
10522320745728724380407450205678405850407030364335407034702028676470426046407340301
10600080400000007000400040007000700060700050000000408000806000000080007060804000501
10735030786436606028865040423550805060446528663350708772505020882033533050502044721
10002020000000008000600060800070402050000000005050008000007030003000500050505000001
12602080754875455030702467705080502033646682407055243037854077408080406270604754601
10005070000000008060700000403030505000008000205050000070000060002030300050700000501
10622040857325704620482020602020204660807080506030663734456840334430335020403330701
10004050000000300080007070807020700050800020200030500000000080500000502000200030401
10507025577240507086205060605030707080566830354250406533624050507527703278568060501
10406060000000608060002070002000704060700050000060600000700070602000004000003060801
10805070446283835040426040262453706067804083453040453220505220203028746686206080401
10503040007000000030500080000000708000207060002020000020700040508050000000800070801
10206078286042635550306566743530602320506050705077306060675087703078875280322870401
10805060008000008000208000400000808000606000505000206050607000003070006000300000801
10603070402533503066307055803632403042305562205450853080706783783060706072208455801
10800050200000004020007000003000407000005000400030200040003000000020407000503020001
10662540832076647047877647374030202282246070734050304877467088238620603320402030461
10800060003080003000007000007040700000000070004020205000000030000000403000300040001
10504022702770202475804020402040605323647286405060407080864740208727802080344635401
10003000700080500000400020203080807000000000405060500050200000800000700040200000801
10527270638080254860658643507450305060547560602080726482207242586830406447404550501
10000060006000400060300000400050700050003000706030000000008000000050400060006000601
10634047302046707040707260686020576888306076605032205477746224486030285450705024701
10300040607060003040003020005060800000707060006000500060000000000040000000208060401
10507230307520572087574030605040856370302050632230247670633046364078858636408020501
10600000200020007000000020206040000070006080000030000030003000004000000000207030701
10568475537078604543274520306066663030352076647067263088503777704427585820305030701
10000030000070002020004000708000700060002040006000004000007000006000200000203000201
10388050465870555080408028803040707077405030606742507255422458484020668382608084601
10003050000000500020300070004070804000406000408000004000006000005020000050003070501
16305040253834602860208580605050206370706356608026536588705060508345605020845050801
10506040000000500000805000405070004000402000004000000000800020300000805000800050301
10806073803450843837275043207060758354603050624857505650843670843250606520802220401
10002000500030800040008000506070007000804070005000200050000070007000300020803000701
10772250208070602063404440308083544020504088733080674657784088584025282073704030301
10003000805040008000303000307000600060003000004050000000004000000080003000706080501
10373054352068725460505066482720404838606277702080282468704456877530303240605060701
10500070008000000080005080002000500000200070800050000000400000006000404050300030601
12502760705646445063688030707438763620405050836655568750565857704038407080342528401
10003000400000200060008070200000700000802070700000007060200000703000605080005000001
10752483425430305543704082866340607538702020702082503040802040707224805063406050431
10000000000050600000603000300050008000007000803000400070706030700000602000006060001
10763032267020803620806340705087655078472067208740383850503070506250602070654036601
10003060000060600030002000805030800030007030008000400040008040700080006030004020501
10208340767280842047875067534080503760606670508047773087452060808037722020885020401
10500080000000700070005000800050400000405000505000004000800080704000303070500040001
10737035745252207470806570404460502228406073443738507230874250483360202020604827581
10006000007000600000500030004000500000500020008000500070000050002000600040500000001
10503022408360233722267038555070886668673320607080676040886070805056883560443584501
10607000800040000000003000000080000040000000700030008040600020508000000030000000401
10306677644025528773203488737378888340403383405732306068304420308720663046878860401
10200000008000006000008000000000000000500000806000508000002000700050005020006000201
10353430506246604080723060522428838660584250503076608074868056466044306080405273801
10000020802000800070200050000000300020700050203000004000004060007000207040600000601
16632025702060652728702540778840435020705230606244457238766030503050746050842760401
10006000600080000000600060600020000080600000800000002000000060206060800040002000201
15408040208844547360546050353083464276387547782655606067555670407030402282868070501
10003050500000000040000080000080000000000000006050003060000000206080202000500030601
10844270303035732052354224543250532762203753708020835070206655208680746020808564301
10008000802000005020000030000030004000400050006000200070600000300070000040005000301
16703040807556204060526030353048762050383560655566302020675050566048605562383040301
10800020700020004000600070003060008020000020500000003040002080005000700000700030001
10368434247050375325704458402050307076773050607777504727508726403780377660306234241
10700000004060800000007000408040700080006060005000207000700020003070300000300000001
10602045404080706857285070602040377460807068837040656020342050886080854875868346501
10003000800070700000000050002080000000606000000060000080000060000060000000000000001
11111111111111111111111111111111111111111111111111111111111111111111111111111111111
