11111111111111111111111111111111111111111111111111111111111111111111111111111111111
10006000800000500000000000000000700000003000008000007000000000000000000000002000001
16306040306052206640674630524820202430503080408048207020238242652032244237205633401
10000080304000003000200050000030003000700040504000200050000000004000000000400000001
10867760504073647028652053747044357080886680406340578550647662704534262560708857551
10000080505000600020005000600030005020700030200030300060000000400070000080200000001
10687040304442704722504230554740602060553030882070628088237080377050732050707075231
10200040005000600000200060000000400080200020008000800080006070200060006000702070001
10807253352030352640306086532863646860307438507086605850607770705764602255602450301
10200000000030000080402080000000000020003000507000603000400060200000604000006000801
10453482346288488030466060204236607052645040207833807023547040604270608846674052201
10000000007000400030000060500000308000000040300000405070000070300070800000000070301
10572047703020506064208660705540755737754070508880304028482580408080766686602770801
10006000404030305000806000800050000000002050400080007000000000704070000000200040001
10805660504075206830544060454077475025603080502033465773262325678076866730705043531
10400020502040002000600060003070004030004060608000000000400000005000002000706000001
18678040303050202073308025808062803270276060726732233480306062704850303074823080201
10000030708000803060008000705000603000400020000060006000708000500070606000007020601
10243460307655808080706340404630507060386477877020603037306640553070406473806023501
10000070300050208060302000400060005050800070000040200080007000600040500060008030001
10557075373030705080353045442068566058202050787020763550832023507723684750787080651
10800080003040506030004070002050003000605050006040300050300080600000000070400080001
10307080403060706063305240203034203020822080502230803060606240303386724080602234301
10704030400060005000800000705000007070400020300030502000500000507000300060206000001
10502370236447527430708343405046227640202320448088604054562534607030603080673034361
10400080000000005000300000705000500000500020003000004080002000005050006040003000001
10584084652685403037827888206080207343522073408322825380504648582060667078408746501
10007000300000207000200000402080500000007000807000500000300000000060006000208000301
14404030257440703826406480705040384083303850303050702267232378584753473580704360501
10006060000000200000008000803030003020600000607080306000003000005000700000400060801
10645840544836674656336068406054405070704382506030307068302084508080405045847030201
10000070500000700080002060002000308000808000600080502000808060003080508000006060001
10875055204050804060507030806232602045404060644470504550408370464020307047404047821
10006080005070602000306000205000006000600040000070706000500000800050005080703000001
10302070347670303084203242736022367325873236775770806050224657408035736040204873601
10806040000030006000800000005000005000500040000080800040000000708000002000307060001
10705067826080568580327085808224252020606060302040733533375040505446705554805060301
10805000200050000020005000300060002050408070402000600000005040300000700000408040201
10408760406458805048504760474060208830206060207650607473604050804220406850706020661
10407060007000506000700030306030300060705000500060400070006020505000300070500060001
10706075366420206340837040808030532050257074858054572050478760865066424620887065701
10806050000000700050006050008000700040005000300060008070600000500080000060002000301
10708060668036507067605027476553603032608820202670308020608528302666575030205640501
10400080002000304000806000700000005030005050400000502040304000008000004020506000201
10665224404030478532308620605640747620662050204480506052704023253070602030607223801
10000000004070000070003020200030002000400050400070400040005040002020800060802000001
10723646484070553030365060645048856080206430508032654720425080303020583686602040651
10000000807030007060800070004000800020600000702000803000700040304030600070004080001
10237740304052307020308033406540406648302582804340703020205260707040464080272023501
10007030005040006050004000706000802000800000303000506040300000200080000070007000601
10504070224050455087532830307076807020504330506036402026888053767870376673726270571
10304080700020600030000000303060004030607000703000004000008000700040000000800050001
10405030507824602586403476707050555250487088807742773457403030572067307732503045201
10206020403020005000708000004080000080007070003000000030008060004000700030002000401
10808080805060385040644053667083603073602080873040743070657082702220864080333647301
10600080600030000050005000002000305040007080000030005020005000700070005050000000001
10552260378455386887303674808060477060388020446264352074803060256045406840454627651
10007000400000000000604060002040000060600070002000200040704050006000300020000000001
10605878304072233870504030386885588830204762476040208570403835807430283050755372501
10700000305000000040600060000000000000406000600040006000504000800020008030000000701
10272360207060506050425082733622347764207770703623252030206030747668802030766477201
10000050007020306020002060000000000070500000508000600030707050000060007040008000001
14362020356020474080505280205783722070407648602020304050402073768020266082208072301
10800020400040400070700030703000002000700060005060002050703000400070003070005000201
10204060403360708447643040706757207030466070658057572050503480704264705083722750801
10005070500040600000806060500000302050008050000050000050300060600080002040000000501
10743460703030368470203030853060402066888043766732488060462065742030764040533574801
10002000306040000070707050007030008000004000000000008060005000300030006060700000401
10602067367040384240702030608032762370303058453578703486308670202076808080207060621
10308000500070004000202020506000400030705070006000003000700070006000200070006020001
15605440507628735023308074602050204056603850503085855036503046808360587623558672301
10008000300000007000007000003030004000202000605000003000705000400080000000400030001
10638028247283208288687236254032263450204026564720808280805750486870638850502080831
10700050000000804000000000008020000020300070600030500050207000200060300040007050001
10202850704277402063207735502070263020658880708030438070248083403020305068553035601
10400000800020006000300000604000805040000000604070006060003000004080003000006000701
10223686435050776650328820508823304056585724407043268046604082778060236346574257801
10200000600040800050400000506000005000005000006000200070007020008060000000800060001
10308030345680304060402224307033848584202025354250808580602036806052828230705080721
10005020000050806000307000002000000000002000500000300000508000007080005000403020001
14443878236030803564547023543372762562576670407346874554533568542070805040207523701
10000000000020008000000020000000000000000000300000000000000000000040300060300000001
11111111111111111111111111111111111111111111111111111111111111111111111111111111111
