11111111111111111111111111111111111111111111111111111111111111111111111111111111111
10007000700000800000000000000000700000002000007000008000000000000000000000006000001
12205060508083202540375530274450708640408050604028805020742872383068537652705684201
10000020203000005000200080000020005000400020608000300080000000005000000000500000001
10835740508033678032275068477084666060773570802420632830727573708257624330405268581
10000050305000800030008000800080002080200080300050300040000000600040000030400000001
10222020703485603275708530876440505050558030368020673065885080878060458080207072781
10800080008000600000300050000000600060500020003000400020004030400080005000203030001
10706685363020555440805054478453253550308648405063503230506560407763506457708780301
10300000000040000030708070000000000040006000506000505000800060500000807000006000801
10233534482646486020875050706442803086672020706275202052852060604830503736773056501
10000000003000600050000040800000802000000070800000304060000080800080400000000040801
10534055204060306022306260503280222552264070506770704022544750708050634383602730801
10003000508080703000803000700020000000004080700050003000000000306080000000700040001
10608270604082607260468020374036536036405060208074773437523542432053584260604052451
10800030307060004000400020002080006040002050305000000000200000008000006000707000001
12384080706020706026703023406053604780282070578636662270604027708630503087633050201
10000030804000503080007000604000608000300020000050008000808000400040302000002060701
10822860307455702060207320407620405040858786843080404057408860256080703354806068301
10000080400030806040202000600020006080700070000070500020008000600040800020008020001
10622067744020202040745058437034558085406030728030536260653052808867324820478040221
10500080005030806070007070007080006000706020008040700030200080400000000070500030001
10205070502040702045608470502044802060868070207580703060206870804638733030404635201
10208070500060008000800000505000008050600070600020408000700000808000400040507000001
10602350654885826580204233307054463560604350547057407054272258604070305080827054831
10700070000000004000700000603000500000400060003000004060006000003030003070006000001
10245066542875505055747573504080603362676066406386328270204552528030724057506844401
10004000700000808000200000304050300000003000506000700000500000000050002000505000601
15208030478480702327708570204080382077303880307070508784457235868528554420805870201
10006020000000500000005000406020007050400000504080603000006000004000700000700020601
10246350234235846478575072407053404080505724404030504065507053207040603022856060801
10000030600000600060006020002000406000208000800020704000506020002050605000003060001
10257063505070507020208050305263303065308070556360303420808370747070406085808028341
10008080005070502000208000706000007000800020000070507000500000700060003080503000001
10507080755520705044608263585074562322856868366760707030774385304087362020806423401
10306070000070003000500000006000006000600060000020600030000000704000002000604080001
10808026377020437550284036407565245050203020408080666468522070805757702455508020701
10606000500060000060002000300050003040602030803000800000004040300000700000708020201
10707250305533606068504380585030707580803050408720506846407070803760407840306070761
10505060003000704000500070808050800060303000600050500060005080306000700040600080001
10707067668270605520736030203050248040534023438075548080266260478082844270683073501
10608050000000400070004020007000500080002000400040004030300000200050000080006000201
10506070374047606078607026826235407063608880702650503060408224508822836070602570201
10800080008000408000705000300000006080003070300000207050308000003000004070308000701
10535653307030353657206430503370645680332060505660607083306073787020803060606582401
10000000008050000040003050400070007000600030400080400080008070007020700070204000001
10255748824060725050364050224026534070603750706025846270676060606070463878204040831
10000000707050005050300060002000700020400000602000203000200030203070500030002080001
10742380708084706050308055708240405843405678503830805070708650605050325050324058201
10005020005030003050004000305000504000800000505000403050500000800040000060005000201
10404030446060633056457660502028304020702580606065706028374054682620666777382880851
10603080800080400080000000208070005030707000704000007000005000600030000000800060001
10707020303846505252803752204040635250586028406563223738204020425052404366605023201
10306080408060007000303000002020000050004050002000000020006070006000500080008000201
10808060307060425070382078423042706087806080762050672020545064306760274030683882401
10800030500080000060006000003000308060005030000060008080003000700040004060000000001
10564380743365332427208636405070867070555020324636637034407060286052405320334448481
10002000200000000000405080002040000080800070003000600040602050007000600030000000001
10306276403058376430707080823333655520808222282040303580804724704670245020353687801
10300000502000000020700050000000000000707000700020008000506000800050008040000000701
10524680504050507040326056744465455826602430807876326040603060563784605020825756201
10000050005060205060007050000000000080200000203000700050602060000020007020004000001
14243040588030734030305330304565445060405872704060207060308048878040622068206033701
10200020700020600070800080306000007000200050005050008040506000300050004080007000501
10307030304270404878587080402527205070688070484032823020206870308273603088264260301
10006050400080500000605070200000807040005080000080000070700070600070003020000000501
10236370608030764620608080826050704047223057487576332040673027263030444040464564801
10006000807060000070605030007060002000004000000000004020008000500070008020200000301
10207033885030854420404060804046534480504023527748202275605480302038308040808080781
10802000700040003000203060702000500050306040006000002000700050003000600020004070001
14502270404254462068204032208070704082504450608063524082604025308540476624368587301
10005000200000003000006000003080006000302000405000008000603000700080000000200030001
10263035286435302485247644686052748340708064547670606270308430545450372430703080331
10200030000000604000000000004050000080400060800040200020805000800070400070002040001
10204480308576408052208572708050647070655670406040362080873032307040803076542023701
10600000700070004000700000604000405070000000603020006050004000008040002000004000601
10754455567070464650282240804447603026766263804026755076404035727020628823236376201
10200000200050700050300000803000007000008000008000700030008070005080000000300040001
10402080468680605060403585708035624734208057838830704730604053507047723670507070351
10004040000080607000602000002000000000006000300000500000708000005070002000605040001
14427685558080804726328055884444475843865470208284366345355823247040703050205785601
10000000000060006000000050000000000000000000300000000000000000000050400020600000001
11111111111111111111111111111111111111111111111111111111111111111111111111111111111
