11111111111111111111111111111111111111111111111111111111111111111111111111111111111
10000000000000700000000000000060000000007000000000000000800000000000000000000000001
14708454677530385660706487664053407075807520504042205240728060806754535345285424201
10007000000030000050600000008000605000600000706000702000800080605000000000000080001
10206686483020287050846462805740807820625883224370803034808730722050777864685080651
10707000200070403000400000800080806000600060003060503000008040002030000020002080001
10306050208040402248205070342040807085803065408030403836655050305032267620707020401
10400060006080003000008020608060005000008000807000700000300020400040000000400060401
10745035648460368040685030405024566340224460708665283570604762356760283326328070501
10008070000020200060004050007000000050000080806000000080500000000000700000008070201
10304530407047303077405053737825653060626030603030838030884333547745504382305280401
10600020806000007000708000000070000080005030003070004020003000800000502000500070601
10362040407673425340705633245740708327708043547023605053805020206370804070377077701
10007000402000000070600000006000400070005030000020603050004070006000302040004000001
13203385505050506083752383688032752070607080803270506020575050387048433030803276501
10004000700060708000003020006020700060504000200070005040004020004000006070800000301
10588870505330852045305020604020208470303543265835627020604070207857403030423750671
10000000800030006000700050600040003000400000000050000060606030600000500050000040001
10367736706052205372422360828560587030822466474030435822502053536330573443665430701
10000000204000600000004000800040500070500070200020000040005000500000400000000030701
10252580362820654766606084544040602786207060402378678020724770205376803645777046501
10000060600020500000003000000030700000002040004000002030000000607000504000400040001
12824350502050503032353686403875806720337058478032577020264485784070608020605360801
10000000608050804000000000406000500030003000004000005070000060008030002050700030601
10465337405040202643504720754080535033342280204435706034338070403036777050333060651
10200020004000400000200060200070004000000050400000608060000020802000000050600040001
14305050206662885340783880802684505046242027208370406043483430506567383253205034301
10004060403000000020000030204000004000002000706000608000000000700040006000002070001
10556040254043372043887026807070436454308260208038602565302777528080705080487060651
10007000300020006080008000205070000030007050807000806000200060005000200080005030001
10802545303070704040873830235047786050253030585680605080846066608076362533505084201
10800030007020700030000040007060000040600020000030002050700080008000000020006080401
10572080886080524264853060803060452880706627774022362860207270305227727030567080201
10208000300020000000000050608040700050004080002000000060800000307000000060004000801
10703476705034262387688270704020508045378030602066587070845628288078477630604737301
10600060608000000000000080500080002000005000707080003020004000000030000070500000201
10705080603074723343274040402054386270703774706050608064806652774530473030663260301
10405060008000008000007040306080000070400060002000506000700000000050800050000050201
10438060588468704074808080608060455025433020825377302540703387352020703044872060701
10000050003000505000200070205000300060000030000000404000300080000050803000004040201
10366224603036403050675620806646342220203857628660508032867680708662507472362040801
10200000207000004080006000200070000000300060000000308070000000406000006000700080401
10508440302386254266478084555050232486836350472348607030307733206055437070702850801
10007000603000800020007070005030300000000080003080007000700030404000004030400030301
10246038802070706080606070622080803065484054306050505270745080507232704023352050701
10003000800080505000600050002050006060008000008000600030206000506000704000003040201
10604420226380808472568523808042847730702725488555346080702050407080403465708020801
10700050300000800000600080006030000070500000300040007020305080208070300000500080701
10564080302343327740707040457080373070705330404050607020802088805060543230232040801
10005060707000500030602050000020004000306000707020300050805000606050000070002040201
18653040605030608080406076465674506058803038407060232270202560204052766077408020501
10005060404080007050408000500000404000505000603060400050006000602000804000403030801
10803030504040248350507350308760603330605240222050856073864425808240806030407430501
10500070705030006000303000305000804040507040003070006000000000400060502050500050401
10472360204056204065805057406038207040804050702033506356425750808030306070858050801
10600050202070007070008000007000006000502040200020700000000000604080504060008000201
10307080602076676020604484303347726345505080628660807573826874602020706086802422401
10304000406000004050400000200060004000008080000000800000003000005040204000200000201
10402762802385603060306580462060808082375047857470307248723062257070306865344040301
10407000604070003020702000300060705030004000200050405000006060200020400000007070201
10308640407060343070308085203720708080508470206060527033605050303870605244302030401
10302000200060000070803060002000708000800000608030600030002020700000300000706060801
10403042774324258470604053863030202566288653704076606460804050278235644560206580401
10400080007000000000707000000070700000000000604000005000805070000000006000300000701
10462650308080383535506836888638682867447350332874724060502044866885607035265225601
10000000500070800000200000500000200030000060000000008030706000000000605040005000401
10355236235680608230503250803840708020482046425830303030402274274630708063605080401
10000000000040607000500020008000203040600080000030200080200000006080006000007040001
10768250444630808045845082746040475050203320868028438850406684803080668555437063271
10000060008000804000008000400050400020400000800070000000500000605070000020000030001
10582032307086705772404726307837308730886430403520263574878820404055343070785480701
10007000203000708000500000800000808000300040805000600020000040500020000080000040201
14602730403530302030745580442270705030407023608085627080827750855660805822727077501
10003000300060803020000020000070403080507000807000002080300040004000800000004000001
10305075535080308053704082346050406035708380305045704080407047205082657640504376401
10406080002070007000708000003040007000200030007000605030803040006030000040300000801
10567027407058425830305546445027846430753022386730503020703060275040862027373020321
10008000503070000000602050000080002000200080004030604040307030300030200070006050001
18303870506070303552505050862780602080407637505020803060303040878660704260405074801
10002000406070400000500020000000502030400000004000600040003040008040500000807060001
10886048508020808540685244673237506030733778288274254446872042807080307838202880601
10004000004000700050000000000000800060000000000000000000003000007000200000500000501
11111111111111111111111111111111111111111111111111111111111111111111111111111111111
