11111111111111111111111111111111111111111111111111111111111111111111111111111111111
10000000000000600000000000000020000000008000000000000000200000000000000000000000001
12703575667340357660502468564074702056602450602044805470654040207425533684363435401
10004000000060000030600000006000707000700000402000304000700030608000000000000020001
10708454532080387040348432208450202250375426224840302023207820522070632388577020841
10303000700050308000500000700060406000500060003020305000003050006080000050004080001
10307030305070805738208050675030607088802056606040204862544060806064572460605070301
10500050003060002000006060802050005000002000807000200000400030400040000000300030801
10677025386750655070487040607085836330264240303755646430705356274640732585335040801
10003020000020400050008050007000000050000020705000000050500000000000200000005020501
10408820504084302023203046373665843060863020406050432050244848556734702347405870501
10800040507000008000203000000040000040008050006020007040003000200000705000800070201
10478030805287643470702382652360602425605088663025703022502030302420205060884083601
10003000806000000050700000008000200020005040000050704080003070006000402080002000001
15503387403040806048623747884073238030203070805730402080463030586035726080403263801
10006000500060708000008080008030800060808000200060004050003060007000007070300000601
10836440607350573076803050508080205820205225277633432060402070704246707050587440221
10000000300080007000200070800020003000800000000050000070803020200000300040000040001
10776276206053404566838220346840824060333524625050547258704052467540878524877380801
10000000404000600000006000800060500060200060500060000050006000600000300000000030801
10285420722750423456704025365020308527204030806444322080348240202447705644462026601
10000050200030700000008000000080400000004040008000003060000000203000205000400030001
17385440505050208036547872708588307680226042444084266060548832647050608080403720301
10000000703060407000000000405000500050008000007000007060000070007050002050600040401
10627734602080406742602480868030877056833370405378707072673060806062455020736060431
10600070006000500000500030800040006000000060500000407080000020604000000070200040001
17607070702264544740884730408577603054437033607760506062675560707557453674402082801
10005070407000000070000070707000005000005000707000407000000000700070005000006030001
10777050448078436045852056206020454824305470403062605437808353223020708040267040531
10007000200070007040007000603060000020005030605000306000700020008000800080002060001
10402232306070407050486740832075763050262060542480602080656057802062867385205042701
10400020003080300050000040006040000080200040000080008050300050008000000060006040701
10686040588050228322335060406020752520603485642023637850305430405746585080822060201
10307000700060000000000050407060700050002060002000000040500000207000000050005000501
10807228804046256782467640506050302055738030804043787020644546437042356620407757301
10300080603000000000000050200080008000006000802020008040002000000060000060300000301
10502080702084278858236060602037342740708348407020707032708827354340888040657650401
10502020004000007000005070202080000070700080007000602000600000000060500030000020801
10457030842663203042603020608070836057432040387373506570703877673060808037843020201
10000070006000803000200040807000300070000070000000704000300030000060507000007040301
10788582403043308070663420806584823620807632754860405048488480407723407747454060701
10600000502000006080006000400080000000400050000000503020000000306000005000300080401
10305380203374467283488085833040538343662350333265207040208682703055648080204750601
10003000503000700070002060003020300000000020002020008000700070702000006050200050401
10885072505060205070205040585030803027326034404020507880867030804747705067762060701
10007000200080306000400040008050004050006000005000600040305000702000706000003080501
10503330577860603563553667503075375660706384488362452050306050502080308784308070601
10600040200000200000700030002030000050400000800020002080603020406070800000300040301
10468020704454733240604080253050324050505870307080306050703023704070765550247050201
10003050704000700050407030000020004000804000707030500060203000202040000050008050301
18477040805050608070508078456425508024703044307080762720503660405085437073506080601
10004070406060006030502000400000303000202000408070300020008000708000708000607020601
10705070306070444370602720605220203360304780668060564065544666404760607050608460501
10700080407070006000306000303000703070405070005050005000000000600030207030800030301
10257440604078702055507035302068307020608060302037302232647730204080605040446070301
10800060206030005060002000006000003000805050700040500000000000306070405080006000701
10404040405025378070707434602576842856703060468820505353456336607040603076606872401
10805000304000007080800000600050004000002060000000400000002000008080305000200000801
10602255607647206040602560826080706083772066882850608533285046244030705655773070301
10402000304030003030604000200070202020004000600030303000007040200040700000005030601
10805650805080824020602066204260805040408760702030556026304020207340502678203020701
10804000500070000060407030008000504000700000305070300070003050700000600000508060601
10404055365626853680605072887050705477784634604032502340204060656753834380703670401
10600040002000000000408000000050500000000000607000003000506040000000007000600000701
10248770205050288653807532885656367353672830875628854030504037645755203028546576201
10000000400050400000800000800000700030000050000000006030603000000000403070007000501
10772452423230408320703540606660305070328028723880504040302885227730302033202040401
10000000000050307000800080002000506080700060000080800020200000005060006000006020001
10576680873680704077725063365060664030403850323023525570605536502080623788345053531
10000050004000305000003000500040200070400000600050000000400000605020000060000040001
10573032803054702674802442603688304680222380702720587648748430304036886030674420501
10002000505000807000800000400000505000400080707000300030000020500030000070000030701
15406720705550208020487630367780304060405033604076545030446360674250802325453024301
10003000800060605070000030000060802060808000505000005070200060002000600000004000001
10407046468040302024802077685060303038705540305042503040304067604056474370504322601
10205040004060006000706000006030002000200020006000602030806070008040000030200000701
10735032803045543720807465776027868350837055467820506070302020547020383034645060831
10005000702020000000602040000050007000200050007050802080307050800050200060003060001
18404870207060407667207050646520202080707858405050503050504080844520404730207087301
10003000208040400000300070000000308040200000005000200060008060005030400000802020001
10684073803040607830754724756526205030854866573443682773425088308080203434403880501
10007000005000600020000000000000200070000000000000000000002000008000500000200000701
11111111111111111111111111111111111111111111111111111111111111111111111111111111111
