11111111111111111111111111111111111111111111111111111111111111111111111111111111111
10007000600000800000000000000000400000002000005000002000000000000000000000004000001
18603030607074302370763330648260207840404080304057605020486833576073355752802455701
10000070805000008000500050000040007000500040706000800080000000002000000000700000001
10737340708072683033223062426088724060353350408350738740247225307453726370402556241
10000020607000500030007000200070002050300080500080400060000000400040000070500000001
10757030402822305474506470585430807070383020368040537037533070856060742070406056681
10500040008000300000300070000000800070200060008000600040007080200050007000305050001
10203256427080626320808067474782683760307736203072304450805430607632505772203620501
10400000000080000050204060000000000060006000807000207000500040600000403000004000201
10723626285246356060663060502546805087437060403588704053235070402550602658426026801
10000000006000700030000020600000803000000060500000408050000070700070800000000020401
10666025503060204053406350507260472324657020207820504035347880302040223267508330601
10007000508070707000806000600060000000007050300060002000000000407060000000200020001
10406330202045306440425030646025372024406070708037823653666655452068777740608072521
10700050507020008000200080003030007030008030205000000000500000003000004000702000001
14655040505030802066305074403043407520527020656455364450508054302770605078774060301
10000080808000308070007000504000202000700020000020007000506000500060404000008080501
10688270304736607020406640608850604050372628527080304034806780548050604633402042201
10000060500070704060302000600060007040200060000050800070002000500040400080007030001
10865053484080803040582078568073628074207050734040428470663073604847362460768040541
10800060004070804080003050004040003000606060005070700080500080800000000080800020001
10304040603030302054502780705064605080478060802770708080405520202422376040205254401
10606040300020007000300000606000004030700050300050406000200000603000800040506000001
10205730337566862770608467205075778820207680833077508074428736803040406030283086671
10800030000000004000400000408000400000700020007000007060002000002020008060004000001
10874072245262808066333466205060307634663043507278387660803557357070372037305346401
10003000200000804000200000807040700000005000403000800000500000000040002000504000401
13605070372670703574304780405080434024702370305020202437625756773368485570305740301
10008080000000600000002000208080002080200000206080205000005000004000300000600080501
10478660652373887576427084503035604080406258603020707032602074803060408062878070201
10000080600000200060007020004000306000404000400030404000203050002020807000005020001
10266078603070605040408050603887306038702060258750204620602480623030604025804057871
10003030008080802000503000305000004000200040000040604000700000400060003040205000001
10203050452420507076606535883024646352324686555640504040382634803087287060208283801
10304080000020008000800000003000005000400030000060800040000000408000008000503050001
10203026556040528880788073602626622060504020404060362324235040808456507485808070201
10507000400060000050003000600020008060502020407000500000004030300000300000403070601
10606530506353705066805230724060606370302040803450402225803040308880607840503040751
10803080004000602000700020506020200060505000800040800030004070204000500020600030001
10708048756260203280564050207080675070764036768047753080333570647082485740378045201
10402060000000400030003060004000200060006000500050006080200000800020000020002000201
10808060243062804028403036555288407024207330704470308030503687207243687050708370201
10200050005000202000607000800000002080002060600000204030308000008000007040306000701
10547845508040474684503220806670752350623070704220708034204083653070207050406266801
10000000006070000020004030400070005000800070200070700020007030006070800050408000001
10538337248080473060543040538046837060702880704088553680667080608050655655405050671
10000000608070007070700050007000800080500000405000406000800050208070700060007020001
10763880806024306080308054307860707256602276205440802040207280708080368070823068301
10007020004070008020003000505000806000800000306000708080800000400060000060005000801
10305020863080782084322350208075403080205880804066605042574088834620475453452830331
10405070300030600050000000607070005060703000707000006000004000800030000000800020001
10507040807644402473704463306080268680835047804455583388506080765064805428502072301
10404080304060008000704000002050000070005060007000000070008060004000700030008000601
10406060608020388060472073355078504067302040488060877040488065806660326080767846601
10700070400020000080004000005000706080007060000070002040005000500060005030000000001
10874770224858335653302386507030753080638070728775765054207020678024306550646445861
10002000300000000000505070006060000030700020003000300080706040002000700060000000001
10206584406084748670503080424856534360802233555020304420207427705650642060445858501
10500000205000000070500080000000000000307000200020007000408000700080006030000000301
10375620602030207060842052226377753723505570504844873030704040653523805040846276301
10000060003050203030004040000000000020300000503000700020305050000020003050003000001
17866070472060344020805360707543574060203276505060505070704073848080446088805055701
10600060400030700040700020702000004000500070006050006030202000400070002040008000601
10305040605820308874548040502355804070468080552036545040603740707266606078826330301
10006020800050800000403030600000202040005060000050000040300020800070005050000000401
10724330708020578480508040785050605025462047583645843080383057284030273060332386801
10004000705040000050406050003060006000003000000000003030004000600060007060700000601
10602025886050533430407060606073532460403028257542607322707250202023802030403030741
10502000700060008000302070504000500020503040008000004000400030005000200070004080001
13804550403554836028205038705070205088403640607024838054703072402850458585366236301
10002000600000003000003000007020007000604000707000008000404000200020000000500060001
10786086427344508554635358243056352880202057576230204540804380552780728730204030721
10200080000000304000000000004020000080600050500080200070803000500070300070008050001
10308540202635304052703563602070333040376640207040277060353052202020702088857063501
10800000700020008000500000307000707020000000703030008050003000003050004000005000501
10888747428070547770285540704885302056828656603078224065603033863020387386736666201
10700000300060300060700000603000008000004000005000700070005050005070000000400060001
10303020678830308070602746608055888755402044468530605340507038608034252330705050451
10007030000050305000504000008000000000006000600000700000703000005040005000602030001
18342288248020208427436027667876252536767720803832254488882362522060204020807858401
10000000000050003000000020000000000000000000600000000000000000000030300020600000001
11111111111111111111111111111111111111111111111111111111111111111111111111111111111
