11111111111111111111111111111111111111111111111111111111111111111111111111111111111
10000000000000000000000000400000800000000000000000007000000000005000000030000000001
12783050237554742620606526805027703720348388367425608550503427448065803060267320401
10000060008000000040600040008000500040000020000000600000400050002000505000600000701
14406275203070527080638260507840828034353064335540704042485080604550605068304884261
10002000600040700040300000800040200030007000008000707000503000500000703000400000001
10858070625860708760708058855070807464803355207083307060803072782528803230576735301
10008080600050404050004000008080003000802000600060005050007000000000300020000000801
10304070402064507040523357406072248050502060403640736040848074228830747060433370701
10600060704000800070600000005000000050003040300070408060006040008000600040007000601
10763420272470528282403027468837878267553840707460207032804470802020406227546078401
10000020000000500070005000800000800050000000706000400040708000505060700000800030601
10526037506332233070633677804050703040835853602080343670604028407067823720205830401
10004000406000000080700000407040504000405000002050700000600020007000006000400000801
15203680337060278520606320603050307736304065585070308555755370472787708052805478501
10004080000020000050007000303080406080004000600030300000300060300000606000600030001
10837050255833735024373020402060508080465080408273232520703020308440306880563070831
10004020000000006080000060302070002020007080607000000060005000600050700060300040601
10804040442564507070303276803068276070404230607083386082804478703076623030332780601
10600060000040605020704000008000000050200000205000702000305000802050000030300000301
10357387864020504050444080475673358670706835608280608250478070368040328830402833601
10600020005000405030007050000000500020403000500000500060000060005080300070600030001
10504050703753402082804073406340802030407030886758766080673634405040304030766070271
10008040802000304080003000500020306080400020800000002070200040008000304000800020801
10372020502030604040326380538660204050768045404068704050304750433536203450204480801
10400020208050005080000020007000208060004060007000405060202000500000700050300000701
10702530505067446076732035705038606037804360257680704030707062406040303062682447501
10400020706000300020007000702000005000200030000020500030005000002080404000600000001
10632070606780608786505480406083784760475032484074767424766256672030667330804077441
10008000600070506000207020003000000030003000000060003000000080000080200050008030001
12248035356070604030703070284378862033407765306420608080485040567760203830662080801
10007000600050700060405060000000007000807000505000300020006020004000700020408000401
10302436207850668830208055203423442650708050524025284052404070877076273040205868701
10300000003070000060007000600050000000800030002050004050007070800070000040800000201
10254627448060674074478640304040606434765524704070605630436048703870602040888750201
10005000000040608080000000603080700080008020002020700000400030005000607060003000401
10607037564660802050304243507020636860204020266060625554605070362040205680802050501
10808030000070202000500080207050000000600040000050000070004030000020200020607050401
10608020285030807075666020408020426532225523665585346060425888675040552040707060201
10400070300040008000305000803060000000000000000000007080000040003040500030600070501
10328746607056426820205074803020752732256675228550504033642040604340305874532430301
10006000002000003000502000202020000000000000000040202000006000800030305000000070601
10206033456826402087705460805042707755866242435020403426403022454080505362557020301
10200040000080008000008070502000200000000000004020400000205000400080400000006070301
10385520885030424022705050505480246085665045504024787730703720307230682673802084301
10800000700080007000206000500060006000003000606020000020200050800070008030003000401
10387286807063803850323468564237702668708070306050835050378050602028402070885220201
10000000702000502000700070000080002000003060303080500070004040708000505060000040501
10507640306550705046507060504080403566237570304030704458405040848020505030762070701
10408000603000302070006000406000803000000070504000703000706060005080500020400030801
10365065707047207480572278863528577028533020203058803060206028202050227050408670401
10003050007060004000600000000000002070007070208000808060005080307070008060300000501
10404030635350477065708075822347506670605046602752703052364020504232304070866422601
10203000600000600070008000000000300000405000006000008050008060005000004040000000801
10705684704646806280307628247837378856206026762087442080707024246065577744673580801
10808000400000507000700000700000000070306070007040002000407060000050000000003050801
10803020578320806026363460508643448070603350205320307873232040723464687586304040301
10300070007000600080003000406000005020700070200070208000700020000000400000005000801
10303543203038637658506057705075804040708060727050307040806085752870802034384867401
10700000808000000000003040005050207000406030600020706070007000000030606000000040001
10856783703065882646574440302070403874608040305640202022482478634070206053652040641
10000030005060000020000000708060800030806000400000206000008000000070005000800060001
10555070255430704030864875508030568080808028637536806678605385436568877060207732201
10008030000000504000400080003070800020002040000040700000800060000000007040700080201
10702030875585406846702040304020407874486560374060623660504040206877307280507070501
10503050000000600000005060607080407000000000604060000000408050207000006000307000401
10507030326232854036537650787070402028865467607086867664407060603030824064375565801
10305040002000003040000040500080506000000000002000600000008080203040008000007000801
18207026262030803650282022302040404027723340685040604844683060507064504835305050501
10007000000070500000602000203070506000500070003040800080000070405000608000600060701
10838545608360882878508030504860704070284026802240253050664480207250543028852030601
10200000200080000000006070402000603040004000406000700050800000800030008000005050801
10586670848053444228645370605056806033606750703045245480203033473048802844504650801
10000030007000000000000040807000007000500020208060000040005000005000700000700000301
10378035407035657772874060204687644367322080208024562025725026402560357840277240501
10003000005000003080003080007000004000005000803000600080004000302020002000400070201
16206056322480503050808076375080802030702436307020604060705830403064438054405082801
10004000600070800040600060000080200080300000804070602060708000700080003000004070001
10783080666060748250834780204770726250604638803560308380205638657760403227853080461
10003030000030700020000000500070404000500020008000600000800000000000200000000060001
12408087243230282024788747428470607072322080353075758576428256262764725743842875501
10005000000050000080000000000000800030000020002000000000000000000000000000000000001
11111111111111111111111111111111111111111111111111111111111111111111111111111111111
