11111111111111111111111111111111111111111111111111111111111111111111111111111111111
10000000000000000000000000500000800000000000000000003000000000005000000020000000001
15742050333252456820605533806037607840428562436752604550605653628057603050642570601
10000040004000000020500050008000500060000060000000500000600080003000805000400000601
15205527206050323060468530707450876053646026525660708048388060208440304074806587771
10004000800040700050700000300030500070005000008000304000605000300000602000700000001
10662030376780408320505033776040408723804724802034702040806037668643702540865568201
10004030800030603060004000006030003000405000400020006060007000000000600040000000601
10803080606047805060645384506045784030803070703270666020847073645220646030248540401
10600020604000800070500000006000000060007060400050805050003080003000400030003000301
10887480232430326253703067572574454335262350704660808046805340708080802832485033301
10000070000000300040005000500000700080000000206000400060405000302020500000400030501
10664073706757242020378284208080807070786357307020278860303028303082554850308620501
10005000204000000060800000805020508000404000002030200000300020008000005000300000401
18205530437080783770706740505020203648707057888020208528643570657288704044202536401
10006030000080000040004000602070205080005000400020800000400060400000507000200060001
10283050524256538052423030707020705040875020505378558870306070304870803880567070621
10004030000000005080000070405050002020005060803000000070003000800030800050200070501
10506060852346502080502357808065548040305620204035888042408848603047843070634720301
10500050000030707060505000007000000020400000302000706000504000603050000060300000401
10347872278050405020442030448686753750805236605220203370587070445030752430403264501
10200050004000804080004040000000800060207000500000200060000040006070400020800080001
10807060603655206076305034302630505060502020625472257060365255504060607070242070821
10005040404000404080003000700040204040200030400000002040400070006000307000300050501
10377040603020203080362220834220407070528064404067202020405260282265603420304250601
10400070503060007040000040002000204020008060007000803080703000300000400040700000501
10304350502084854037857072704036608024807530748840608020505056405020207025747723401
10600070402000400070006000303000005000300050000060400070006000008070602000500000001
10347070305550505268206670208085262780448082844024443623822246858020526660607087221
10004000500040805000307040004000000080002000000080002000000020000050600030002040001
14372047535030403040707060785868826068306587508440603050722030554850402450473020301
10008000200040300040706050000000008000403000508000300050004080002000800080802000701
10303637204230847860702056608363466480808080428068567047708060273057685020302722601
10800000004060000080007000300070000000300060004050004060002030200080000060400000301
10274465442040737048234720304080402544874687202070308520385057606320205060777260701
10004000000060508030000000807070300080008040003020500000500060008000808070006000601
10406043652820707040406234504080332270205070738040642726408040553080405640604030301
10204050000080704000500020805070000000500050000040000070004050000070500020802030301
10802070578020406075556040706070734278872632333663246050532862828040472030605080501
10300080500050002000602000508080000000000000000000003080000060002020700030800030801
10646276203028877320503025702040434724275582453350803026737080503460608856822730801
10005000007000004000602000605080000000000000000080808000007000500060602000000070401
10503044667382804057804580807046808342653473234020206425508086747030602685882060201
10200020000050002000008050702000700000000000005060400000603000400020600000003060501
10283450435080658024807080702530732057527045608032333830402650708820734438208028201
10500000300050003000303000500080002000004000408050000060200080500070004060002000801
10755452507048503650845662773524506663607020507030588080726020505076802030344720801
10000000607000507000500080000020006000005050406030600070002070805000803050000030401
10702370304320402022406030606070802522372330205040202754605050283050305040624050701
10607000308000504020003000807000208000000030504000504000403020004060300080500040201
10355074807075406640678343587326787052544020606048708050607062203070244050502270501
10007080006050003000800000000000007020004080606000205030006070806020004080500000401
10302080873350443043503036887756207640308065203584406084822070405254702080778458501
10302000600000800080006000000000200000405000007000004070006080004000005050000000501
10207524705338203280802772253767272575803034482066856030406074487043732572677830701
10208000300000703000400000400000000070606060006040004000604070000050000000003080701
10308040743340308076328420805238783020806840407280503462774050336736237667704040701
10700070008000700030006000306000005070800050700040804000800080000000200000004000701
10305647808026458738607076805085708030605020876040202050304047466750505082875588701
10500000607000000000004020003060608000204020400040407080004000000060403000000070001
10355667607087675327222320807080407532504040208870803022886285476030706038772030571
10000020003040000040000000505030600040708000400000606000004000000030005000400020001
10633030532770208030875665807080865070807035226484206622203857777827248050504865401
10006080000000804000300030005040700060007020000050400000600030000000003080600070401
10307070552245303584606030503080207258783440386070745680607050305743206570406020401
10405040000000200000002070803070702000000000206060000000505040502000008000708000301
10605040478837634044255730357020507083555686508088637456706080605050753074475722501
10304070008000002020000020200040604000000000006000500000005030302030003000006000701
12802054336080204660722086605050404058726680836080505338428050305075502876605030201
10002000000080400000602000605070603000800080008070700080000060203000307000500060701
10445382705350867264402080704330506030288072702370382060737680308640232057542040601
10600000800050000000003080504000308020003000406000500060800000700030005000003070601
10656270274032722846677560804057604023807530208033225820606087785024304762204660501
10000080005000000000000030402000007000600070304050000080008000008000200000700000801
10765054708074546642386040604477478484437070706025572054368047406560664430454840401
10005000005000007020004070007000005000003000302000400030006000205040004000600050701
14703062837440203030308085386020703040607363507030704050506330804034467024607043701
10007000200040600070600060000030500040200000406070406040206000600060006000005060001
10466080473070738480776740405860546740706855508770304750508387223250505685576030781
10003030000070800060000000300080506000600050003000400000300000000000200000000040001
17402078647850888023324622554550207028577020687053647448834376348638375362558584201
10007000000020000020000000000000200040000080002000000000000000000000000000000000001
11111111111111111111111111111111111111111111111111111111111111111111111111111111111
