11111111111111111111111111111111111111111111111111111111111111111111111111111111111
10000000000000000000000000800000700000000000000000006000000000002000000030000000001
16376020228562527450305274706023602550248488232227206760607463673024808080628520801
10000030008000000040400030002000700050000030000000500000800070003000807000200000401
15305276602070745060563730207570883077424083654250507062773050603670607063305654721
10007000800080600030800000400080300060004000005000504000705000400000405000400000001
10588040568660505880604047857020707743805383608042407050606023543657208520332467601
10005040200070202030004000007060002000603000600040002040006000000000200020000000801
10304070804053307020822672503038485060508080204680327030735054384820728080344460601
10700030605000200030700000004000000070006070500020302030008020006000300060004000701
10487550834230522857707037588784772858475760208280408047503350802070202544745025701
10000070000000200080003000800000600020000000807000800020508000504060300000800020601
10323055805737542070774276604040305070546224507050824660708036707053578350206650701
10002000805000000030200000506020304000406000008070800000200050007000006000200000401
14402830436050337370808880705050703228203065487050207824324270342563508066708522701
10005060000080000030007000302080807040007000800030500000800050500000504000400060001
10552050536757584065652030303070208020855040305652763870405060408260405650882060831
10005070000000003070000020705020003040008040803000000080005000500040200030200050201
10802080722243602080405744707058767040607760507052534072308426403082247040582830301
10400030000080706050708000002000000070500000607000503000807000508050000060300000801
10442556652040406060366060642253836840502335206760302350287070557080487570808232701
10300020002000804040006030000000400050305000600000600080000040003080300030200070001
10608030704488703072708027505870403020807030252834525060822424406050504080687080821
10003070704000207060006000400020805070700040500000007080200080005000504000600030601
10674060802080504050626860782470708020533045508067502070208230684536406730504360801
10800050304030003040000050007000705040002040005000202070606000400000200070200000801
10604270408077333057888057406056303068504670746320608030703023604050608072288545601
10700060302000200030006000507000005000300060000040400040007000002030604000300000001
10463060705720203628604770303027424440382058386054585624235583262070585250707035481
10002000400040504000507060003000000040005000000050002000000020000080400020006050001
18253032737030402040608080225748852066605553505560203060345040837240207260637060601
10002000200030200080806020000000007000507000607000300060004040007000200050807000801
10804732606440345850507025303648526830403040875038564078602040385087347060404752601
10600000004050000080002000800070000000500020006030008020004020600070000070600000401
10446777658080527076278440804050703237634485307070606370772042303450608020257580301
10005000000020504020000000304040700080004030002040300000600020006000802060008000201
10702046746470406050703373808020664220205030766080886726708050472060807720503050301
10408070000020605000300050503020000000500050000050000070006080000070300020407060201
10607030258080707077624070507080286654363363242328845050288575628050853020407060401
10200040700070007000607000802070000000000000000000008020000070005060500060700060701
10462534304075272380202056705030445826728856255820402053463060505880306736568360801
10008000004000008000807000208070000000000000000060407000006000500020404000000040201
10608032457675205034208530202086404586872535825060505562604086347070804476648050201
10600070000070007000003050607000200000000000004070300000207000300030400000003080701
10558870346040526084505040504280554075555087304046884260505680603550827388304056401
10800000500030002000603000700050007000002000505050000080700020800020006070008000301
10555636702085403880528542434735804725606040604050787020734040606076607050464270201
10000000302000207000700070000080007000007040404020600080008070508000603050000050301
10506720808520602075403040803070408748454360503040407636708050772060408020635050501
10402000603000505040003000507000702000000060702000405000406060002050200070800030501
10877052506055206430747485348453365078883030205074208050504064204070686060604460401
10004040005040002000500000000000007030003070502000606070002050202020005080400000301
10507050556430876034302035673724602340502048404283204072433080207438302050772637301
10406000200000200040006000000000600000405000003000003070004030008000003070000000801
10802866804353405360206676568544576522808086535044253020507057433036737358225730501
10804000700000308000800000500000000050304050002060003000606020000080000000003050201
10205020482220306074277450505856268040807720808630303838344040635788868274204070601
10700040004000400030006000503000007080800040200060205000300060000000500000003000601
10408533304063284478603035505072302050402020286050804080707054633740406056488788601
10400000408000000000002080006050308000206040300030805060008000000040207000000020001
10366333707088226378334840302020704667703040206770708087866654553060207053376060271
10000080007040000070000000307050300080503000700000503000002000000050003000600030001
10238040557680503050835582502070624060403087266784608567802682874682626020403657801
10002020000000208000400060003050500030006020000030300000500060000000003050700040801
10202030732256706726302040602020202847327760433040726330706080402222603320406060201
10306030000000700000008080205050606000000000704050000000604070808000005000703000701
10506050584447684083326240262060607044352542202077673483706020605080838075378463501
10608030002000008050000060400020303000000000003000800000004030707070008000004000701
15604084858020206620823065402040403025427780653060702667744040204036208556403060501
10007000000030500000705000403040602000200040003020300020000030502000702000400020701
10723638705560645776406070606460307080652058706370867050358380205420235084553060601
10800000700040000000003060306000307020007000308000200070600000700070003000007050301
10622570654076344538652420706045805033508820605048428420706048343085508362806240501
10000080002000000000000030402000006000700030604070000050005000004000600000300000801
10642025503023846226455040404438667538262030403022862067463087204770542470335230501
10002000002000003060006060004000006000008000605000800070006000203060007000700060701
15603054852550402030203027735060306050606677605020706050603580405048282043602083601
10005000700040200020400050000040600030500000804080504020606000800040002000004030001
10687070655050674850655830204740756870807247605730304660206488854450606638633060541
10003070000020700080000000800070605000200030007000500000200000000000800000000080001
15202073342340766064648325848220602034255080857072644686352668258686846442265283601
10004000000050000060000000000000600060000070005000000000000000000000000000000000001
11111111111111111111111111111111111111111111111111111111111111111111111111111111111
