11111111111111111111111111111111111111111111111111111111111111111111111111111111111
10000000000000000000000000800000600000000000000000005000000000003000000070000000001
13484020576743628530505225507047806720244364584483306360802332256043404060872570401
10000040003000000070600020008000400040000080000000500000600030002000707000600000801
14302643605040532070547740505770627046886067553350507064367030606470405027803634771
10004000500020500050700000300050600030005000005000603000502000600000206000800000001
10522030584740507870502025226080502374207865403034402020605065463728306880264358801
10003070300030207020002000004070007000203000400020005050007000000000400020000000401
10302030702037507060583856502045553030305030707330425070676024382820672070355640601
10300060305000800020500000003000000070007050300070507020005030002000300060003000401
10888450524520642455407054843644647536844850704680307055505450205060803442662072301
10000050000000800050008000200000300030000000308000800050206000406030600000300050501
10875048302357646070585867208070604070773357602040883340608088707054728640306550301
10005000303000000080300000402030603000704000003070500000600060004000007000300000501
17203830376070625220606240408080307222608047635050604575452380646854808052605443201
10008030000050000060004000706030308030003000400050800000200060400000306000200030001
10672060827626356023872050203050202050656040808587432850507080603820207330462040361
10006070000000004050000070307020007030003070808000000080003000500060800060200060201
10304070642853602050808776706068845070808830403084426056703373502067372080746280801
10600070000020708030607000008000000050400000608000605000205000604070000030200000801
10486534728070605050548070525563347660407735205530202330466040557050675370608838201
10200020008000605030007030000000800020804000300000200020000060008080200060400020001
10505030202272307077707036606340804080203030256455442020224722303030205050366050721
10005080403000804070005000700050208050400060200000005020800060006000803000700060501
10457070206070404070848220837830704020674058503065805050708570864272206370704530601
10400060702070005080000040004000702050003050003000206040307000400000500050700000601
10302770405053755066868086802062606062503570255680403080302054808050302043476826401
10700060808000800030004000703000004000300050000040200040006000007070707000500000001
10222030608750206258508660404057832360524045353068365365886655568080757370302057561
10002000800070603000402030008000000020006000000080004000000050000080200040005070001
16253052745060808070607040872378858045303472304280402080336080588770503830338030501
10002000200040700070804050000000004000606000705000200070007030007000700050206000501
10708657803230654360602073302854444580707040862064358044805020584032772070507558801
10800000002040000050006000500060000000400070005020008080003020300030000080300000701
10275235634070245043372860707080202223268648708030503860583052803740706050847250701
10005000000070303080000000204060500030004080002040300000700080007000404040003000301
10707078774360207060808256502030386230808020566080465237407050644080608250808040801
10404070000080802000200050206030000000700060000040000080006080000040600080505050601
10206070688030705078573020306040877476277282725726432020727355284060675020607020401
10500060700040007000403000607050000000000000000000002020000040003070700070800020501
10468257405077284780806054604040872565358577648560808044635070302240302366436680601
10002000005000003000707000608060000000000000000030308000008000800020404000000060501
10705046862727608073705420507052505828254457334030303664305037224030505525468040401
10200060000040002000006040603000200000000000004080500000605000800080500000006060401
10855750482020837084505060708580735026384083605077428220805620306540632276307048501
10700000200050002000604000800020005000005000802060000040800080700060003070007000801
10445666707025806520272463826238706782707020808050775040342070305046603030722620801
10000000606000206000800030000070006000007030302060400080002070804000502070000050401
10803420707860706053402080607020708455775540605030608458706060333080807060678070501
10208000205000305040004000605000205000000060704000704000807050004030400060700050401
10478063808068708780625484528564866027583040504057307080403065405030374080802670201
10002040008040007000800000000000002050007050704000603030008070602080008060700000501
10703070236820633025606048838256302480804082303283208072658080702746808080623837601
10806000400000400050007000000000400000405000004000004030008020004000008070000000401
10306374802682608470208756337242724373308058284047724050406028288088753655436350801
10205000400000406000400000800000000070805050004040002000308030000070000000008080601
10302030358230806043387220203327266070202430604820808554583020284528228765803060601
10200040003000400060006000304000003020400060200060805000300040000000800000004000501
10308234207028746843706075803033203050404040684050805040208085687640605057562555201
10400000403000000000005020007020204000304070400020204020007000000060707000000060001
10887355405078227372323330404030704364607030706250705064456862482060507035744050851
10000070005070000030000000303060200040606000400000402000003000000080002000200070001
10727080477630803070485586804080334040407064778645208642505876752454246080205768701
10008040000000304000800060008020700020003060000050300000600080000000005060700070701
10404020354684505626405070707040205323682830342030686720603060703384707730602030201
10706050000000500000008040807030306000000000408060000000606020507000007000203000301
10608050855684435037658740656040204054264562603036363442702060308020832038622352601
10306040004000007080000040500030505000000000007000200000007030205030005000004000401
17306054522030403260275032707050302055654250336060604347877070203075507328303080501
10008000000070200000507000308080204000700080002080500060000060506000603000700050701
10432344707750562586507080604320808050267026508440223060385340702550486034525080601
10200000200060000000003040203000507060004000504000600070700000400020002000005030501
10285360436052226862448380307055602058207420205064468880407077488055604374702760601
10000040007000000000000020305000004000700070503030000070005000002000300000800000601
10625044202057266536563020303424776282534080608042435086573084706480347730424380801
10004000004000003020008080008000005000003000402000200080006000407080002000600030601
16706057862230404020506086466030508070602445503040602050603860603074546047803083401
10003000300040800050600040000020600030300000406050203070707000500080002000004050001
10567050656030474350283370802480654570404237202340604870303288728250808244682050281
10004040000070300040000000300020705000700080004000500000800000000000800000000050001
14707038686820387057856555323350207065355060448042364243867226554362764336386842801
10003000000030000030000000000000700070000040003000000000000000000000000000000000001
11111111111111111111111111111111111111111111111111111111111111111111111111111111111
