11111111111111111111111111111111111111111111111111111111111111111111111111111111111
10000000000000000000000000200000600000000000000000003000000000003000000040000000001
15248070468785787640708767802052807620343538682358303780308465748073807070833860701
10000030006000000030200030002000700050000050000000500000800030008000808000300000301
18302632504030742060336450406660864046444022643820602022855050308670408073608636821
10004000200070400080800000400050700080002000008000302000307000400000202000300000001
10227020282420503530402068373080803582308526606043402020207074332236507650845578601
10003030800020303070006000004060002000306000300050008060008000000000200030000000201
10303040308072403060438725205043637050502070806420663050587027735780832030854720501
10800080406000200060200000007000000060003020700060203080003040006000600080004000501
10686420287620377478605047747788862238252650406750705066708460602020205375432044301
10000070000000200040007000300000300020000000405000500070203000802040400000700030701
10753086706872676050288644803020305020747224308040742670307046403042246640303580501
10006000608000000040400000703020405000503000002070600000500040007000006000300000201
18606840833040666450508560305070406762204026255020407538855340232367707033207486601
10003080000070000030004000802060307030002000800050200000300020400000204000200050001
10436040652284768042543020708060805040856030308564733720602060706750206270573060371
10007060000000008020000020208050006070002040705000000050002000600020300070400060701
10702080883288705080803248804027545030504680505068852024308276604026383070447420501
10400030000030607070304000003000000030600000205000707000308000606070000040300000201
10354384476050708050635040683624375880804834603580705740664080473080433660703487501
10500030006000803070002070000000200080808000500000800030000050003050400020500030001
10804080707342803073205027208580504030602020246844658020887265202020705060638050521
10005080706000703070002000500050408070500050800000007020600020007000808000500060601
10382040307030806080648630576780705080575045808086404060502820885334208420407720601
10800020406070008020000040004000707020008070007000303050303000600000600040500000401
10208570403022756046443054603028404044505870863580502030805068503070607053658744801
10200040307000600030002000606000004000300080000030700020005000008050506000800000001
10782020503420308378506620207072458650252057537054654225446372833050275860802032571
10006000500030504000803050002000000050007000000050003000000050000070600070002020001
13724056275030408020505040546625628065704655703280504050352080684240304850422030401
10008000300040500030203080000000003000602000403000200080006040003000500050206000201
10306256308520786350306074707624656560603060567056477086503030382024644050602452701
10400000004070000070007000300050000000800050004030003080002020700050000060600000701
10262382654050247057883720208030705873238562507080302850488046606540402050277540201
10007000000060504030000000703050800080007040005080200000200060004000405020005000801
10206062625660406060706333504030785720703080333050634553403070627020402530804060301
10507050000080605000300030803030000000700060000050000060004080000030800060606050701
10206060573070804066852050803080863822448743788677487030554536776080668030203060801
10800070800080002000407000608070000000000000000000005070000050002080200020600060801
10224556705047253850206063402030658473284782263270507062554040505230203643473540601
10004000007000004000402000402080000000000000000060602000002000200080605000000080701
10202076826768302073806360504057308585254877383020606754204053667080205682662050401
10600060000080003000007040505000600000000000006080600000308000700070200000005060201
10483660322040584023204050605480372025423086704078864340306480508370878685807078801
10500000600060008000606000500060003000006000805050000070200080400050003060008000701
10423622704054502280863386777264605443306080605070244020336030803025706060438620201
10000000302000305000300050000080002000003020602020500080004070508000307070000040701
10302380602860608086305030804080308774442520208050608836705050458020307020667040201
10307000207000607050003000705000506000000060703000507000407040004080300030400020401
10387088404088206220543237268587572043634070802078407060506052308030783020505680701
10003060004040003000400000000000007070006040208000703030004050204080005050600000201
10702020572250275042805067632246804260205052703864504035666020508336606020776756601
10208000500000300020007000000000700000405000002000002060004060003000007080000000401
10304878305538606450704736558285747636507088482082276080307046232078483777634820401
10303000400000305000700000400000000080203020008060002000807020000060000000004060801
10407040683680303076738530407343653060505830802860708647888040782255448478506050201
10300020002000400030004000708000003030700030700020303000600030000000800000006000601
10405257306042672258702038403035802080307070654060505050702047662350804075687452401
10300000203000000000007060008070505000604020700030205030004000000050608000000020001
10866332202053866435263320606070808874604030404370308072662373587070204065765080331
10000020003050000040000000703030800050408000300000706000006000000040005000200030001
10747080467580504020585523302050878070408054587827604826304857642666882060705447801
10003050000000305000500030008070200040008070000020300000800040000000002030400060601
10402070363264207372506060304060502345872370644060726280206060604667508260407050601
10806040000000400000002020802020404000000000505060000000204020606000006000205000601
10604050543267546026734360832080507055585435703076487453202040205040587027862567501
10402080007000007080000070700080705000000000006000500000004030502050008000004000701
14807085468020304480437036504040606055275530825080806575876040803073405227702080301
10005000000020200000208000508030307000400040005070300040000050406000805000800020801
10777227405820436424803040606440405030888032405630667080463820602480235058382060701
10200000600020000000002080204000407080006000804000600020600000600040007000008080701
10867260273034487367738630304052203044608230602082835470605037476077702244606680601
10000030006000000000000020803000008000700020208050000060004000004000700000300000401
10687028207063454245835080606827473584677060302067647075678057208580252660234350601
10006000004000008060004080002000002000002000202000300080004000603030003000500050301
15506088458780703020807087222020405030802557805020707020507380607033833086407085201
10008000200020500060200060000050200020700000404030704050205000200080005000007050001
10342070777050778840774280402320266670205245805430203470406622757560205247422080651
10003070000050500040000000500050308000300060005000200000300000000000200000000070001
13407056358380323076277762434730504063226040365028762388527422676334577276356627501
10002000000050000060000000000000700020000080002000000000000000000000000000000000001
11111111111111111111111111111111111111111111111111111111111111111111111111111111111
