11111111111111111111111111111111111111111111111111111111111111111111111111111111111
10000000000000000000000000200000600000000000000000002000000000005000000040000000001
12426020838723423570307767208067508340535475582243808820208748668048508050547740301
10000060002000000020800060006000600050000060000000700000200060002000306000300000401
14608364504020857050354240607360524077423068584330204033763070707630607042604342881
10004000300070600060700000800020400030003000003000605000604000800000505000800000001
10262060773420308460802034648080202346503678206033804070705065785882603540777822301
10008040500040706080002000007030002000304000700060002030006000000000200070000000701
10406020403073302050765232202066352020705020606280523070562048864380655020823260401
10600040206000200040300000008000000060005060400040704030002070005000400060006000401
10426860437340333834702026838577272586222250404350405083503450707020706346637063701
10000020000000800050004000700000200050000000404000300050604000403070500000500080801
10352056504585654030657426405040307060232243502040642370508053805028456230705630301
10006000803000000030600000704050804000704000003080800000400030008000005000200000201
16606820827030683870203880408060606525307037834050706263356240874763207032304338301
10003040000060000040003000304020606030003000400040200000500080300000503000800070001
10676050638368276072375080302050207060425030407876235240202020402470608430768080221
10003070000000006080000040602040008040005020407000000050003000200060400030500050701
10305020236876506040606876705082452030502860608043525054604355807086623080784660501
10400070000030208020704000002000000080300000804000706000508000606040000070200000601
10453324562060607040787060365284834470605786602580606350244050287040225470605758201
10700070003000605080006080000000300040502000700000400070000060007050600070700060001
10507040805573205054202053504230603020305060353755735070346476307080402020655050651
10004070204000508030002000200020708060300060800000004080500030003000807000300060601
10833070306030705050247230756760604040842054307028207050702740457477702830508850701
10400050408040002050000070005000702030006030007000407060503000800000500020800000601
10704740304077422047824076708048408062508340374570607050504084808060407055326463801
10600080508000700050007000704000002000400040000030400080008000005040807000500000001
10337020703430306654504730207087568630542084637073353726435388242030785280806028361
10005000500020605000504070008000000060004000000020007000000050000030700070004020001
13573047757030403040802020878828433084305575304270606080858070364850406770488080301
10005000400080700080807040000000006000207000702000200070006070005000300060705000401
10704458503860476250203047607582365360208060466056756084802060476033636070304278401
10300000002030000060007000600070000000700060002020002040005060700050000040700000601
10865565338060528032723630807020608448822357806030406570264022803450602030524620701
10007000000070303020000000704060800030006030005020500000700070007000607070005000301
10504024466420203060704864204040455740404020235020625666407060345030404660706030301
10705020000050303000600050303070000000700080000050000070005020000020200050802060601
10607050272050807074235050203060728242232872227424374040454544575020362040402050501
10600020400030002000802000803070000000000000000000004040000040005070300050200030501
10574752304072878350205067703040337426686266282530202083846020706370708588252340201
10004000007000007000402000707070000000000000000040306000005000200040508000000020401
10405047558373506057304530305043703884666785368060207628603044645030204334825060601
10700060000050007000004080604000300000000000007050700000708000500050300000003030301
10652650238020548022806040805330852057833025305042423870704580805860827766408042701
10600000600020004000502000700070007000003000302030000040400020300020008050006000301
10635457302054303840336834232354205486602050804040445040852080205083304020433470301
10000000402000704000400060000050006000007040605020200040003030704000303070000080601
10407730407370503054203080306030208223552380606020807323502040465060804080623080201
10403000302000804050005000806000604000000040706000202000606080002050200030600040301
10623063704084407470228667822775247064668060706077706060605088706080564070302420801
10005050002030003000600000000000004060008030606000405060003070403040005020300000601
10706080485850442067407078824324307550404074807448403083567020806643506030483742701
10503000600000700070006000000000800000203000007000006020007030007000007030000000501
10608852507284202550205456548427458677308048628024843050508026627044284284574320701
10303000500000307000500000300000000080603030007050008000302080000060000000007050201
10704060583770804047643720708456234080206720708720807832287070677823877746806040401
10300050007000500020006000202000002030800080300040707000200050000000400000007000801
10202237502033367386402022508048605080603070363030708070707078388530505067764775501
10200000408000000000008020005080508000807030400020704080007000000020404000000050001
10832433808068445788344230404030202666302080804370602048472753265070807058236040321
10000030005020000030000000508070800030302000300000407000005000000040008000700040001
10377030644350504020224747506070567070708064423658604522304838236732647060808233701
10007060000000508000300080005050300020007070000080300000200020000000002080800030801
10805020753872205682804030502040804873334470577060476780204040507586603460305040801
10603060000000800000003020808030707000000000803060000000208030604000008000708000201
10205050444474362035385350675070705057664724804066336283504030405050757063527624301
10508080006000004060000050800080504000000000005000300000003020704070004000006000601
14507067356050506660476025608020804038258860427020406747436080502034607558302080701
10008000000040600000306000406030704000800060005020300060000050303000305000600020201
10288462505470223284502020802730302030326044802660644070762640308380825038266080401
10600000500070000000003020707000502020008000806000200020200000600040005000007050301
10272760346036443382253240808062306076704240803026364670702068546043408243803550201
10000060005000000000000080302000004000800060706050000080002000008000200000500000701
10573053205045488823767050402555885423837080505054227058825068303430287880657360201
10006000007000006040003040008000004000004000708000400070006000605050007000300080601
17604058328440805070304042234040206080302357408070208070403680206023868057503025501
10008000800060300080400030000030800040400000305060603080706000300080005000008040001
10388050747060437320353240207780488830807666506440306450505773453880607825246020581
10005080000030500030000000800050308000400080007000200000700000000000200000000030001
13308066562420253034645335867240306056427050464088722564386585485875757328233747701
10007000000020000050000000000000500060000020007000000000000000000000000000000000001
11111111111111111111111111111111111111111111111111111111111111111111111111111111111
