11111111111111111111111111111111111111111111111111111111111111111111111111111111111
10000000000000000000000000800000200000000000000000007000000000005000000030000000001
15468030485554553540806463508074505280272458542233405240207283646035204020354230501
10000080006000000020300070005000300050000060000000800000600040007000806000200000301
13403754507070447040663870602320225072653044242260702058866040602430402055608636261
10006000400040600040500000500060200080006000002000508000308000300000603000700000001
10335060523250608550302052334040805762303336505053506040505048665668704740566368801
10007030800060704030002000003020004000407000600080004070007000000000300060000000601
10805060208086608040563546403037644020608070503580522060652028256860448060378650601
10700020306000300070700000003000000060002080500080302080006080006000700030005000401
10553770683780242487207055682875563568826380706330507062602520603020407432783064401
10000070000000200070006000500000300070000000803000300070405000606070600000700070701
10274087802783574040366453204040808080828333602040646540404048807088756830702880401
10007000702000000060600000402020607000307000004070300000300060005000002000600000501
18207320824070557840806550607040607475706046238060404728464680734644204026403756701
10008070000060000040007000403080408060002000200050300000800020200000802000500080001
10426070757268424047437050204020408070685040303664888240208030203680505520535030721
10008030000000006020000030204040008020002060704000000030007000200070400060200040801
10603030587866703020205382804044875040404650602037573054407445208058324080455260301
10600050000060702020306000006000000060600000703000307000208000203020000050200000301
10787483662020407030543040525474877720503746406580204340828080664040363380205436601
10700060005000606070002040000000700020607000700000600030000060007030700020200070001
10708080405743507044807036506570606020305060422376558080476854203040606060424050481
10007080203000805020002000700060403050400040700000007020300030008000504000300030801
10226030305030205060663730452230204020863022708028308020506460444586205420203660701
10800040606040002060000020006000308030004070006000604050708000800000400040600000601
10504620305086348088764055604025202052807260448640705070405085207020303023248825801
10600050202000300080002000408000005000200040000020300050003000006030507000300000001
10884080302780708852602250606052583480788077744025623622468388762030368240202038621
10004000300070605000704060002000000080007000000050007000000030000030600030006080001
18268024385020406060708070382763226064708887203240802030536060334240504470634070701
10003000400080600040607040000000008000402000805000800080008030002000600060304000201
10404465703830358370303056804232377230205080536068274053707060264022242080504274501
10400000004050000020004000600060000000200020002080004050004080700070000070200000801
10463335647030727058737760708060202544684438307050707770386086302570808020875230401
10005000000040203070000000508080300020007060002060700000300040003000505020002000301
10404067283740208070406336306050772770502020377070347377505070346070304720704030801
10705030000040308000600080607060000000300040000080000070007060000070800040606070701
10203060337030304027332050508050322264278764858637844060828728334030673050407060201
10500070500040002000704000503050000000000000000000008050000070002070300020500080401
10286286707025523370604066808030328844355648883260802047245060606480707826842440301
10005000008000002000304000405030000000000000000070207000008000600050304000000040501
10706082562287204044704540203076603362528257746080204786507024367070303482243020201
10300070000060006000005080402000800000000000002070800000202000800050400000003050201
10736530587030777085306020807520562034648078307038336440503860708320682462808067701
10500000700020002000802000600020005000008000704070000050800060700060005030005000401
10226525406052607850433755424348506358704040802030342070778080506045305060382860201
10000000705000305000500080000030006000005040804060800040008050404000504060000070401
10408380804230306063302070403030706576553360706080805483708060764080202030836040701
10807000507000307050002000806000208000000030506000407000703030007040600080800040401
10625077404022607330868664577436677026428030707056806020405032806040886020208370801
10004080003030005000400000000000004050007070703000507070004030205020008060400000801
10302070643430588067308055853864403330808037607857208056725040402742408040884652201
10705000700000400070002000000000700000705000007000008080003050003000005030000000701
10405354208577204840602562368247882427806065424042552080303025745023278738367830601
10303000400000202000400000700000000080408050002070006000307040000080000000006060301
10804020468340207084253730703344755080505580405280406372324030436433778843702030501
10500080008000600060006000306000004030300040400080603000600080000000500000003000401
10804325407025868236207046707072502020204040846050702040407028343770707073764285301
10400000705000000000003050003060405000508030200030505040003000000060802000000040001
10437843507052478455475250306080504822708070704680406062277285478050808067377030381
10000080002040000070000000508040300050402000800000604000007000000060005000800020001
10538050332460805050388878704070663020407064785422207722703674522722226080603683301
10002070000000807000400070003080600030004040000050400000300030000000005080200030801
10408070834768404486708060807080307627246760784050345540504020803746607460508070601
10208040000000400000008080207070805000000000508060000000407040708000008000507000701
10208040663658747043248780354060404053728353704022657535307070504060587032282657501
10604080006000004070000050200030207000000000003000200000007080207060007000003000601
14604037343050702840854035408080503047757650773050803788285060702088502863205080301
10008000000030600000208000606060404000500030007050600070000030804000406000600060701
10834282603630268235408040206680605020636027302540263070428520607530464055784040801
10700000400040000000003030607000707050006000605000800030500000300060007000005040501
10884830327074366757665340507034306085706370806044254380308027846076802425803250701
10000040003000000000000040503000005000400080707020000030005000008000400000500000601
10274072502077437622246020205758884485562030604077825026352048703230547670345850701
10007000007000006030007070003000002000004000204000400040007000206060002000700070201
14305076462270208060604056375030608020806462606030803030407850707043344053708043501
10003000400070500020500030000080400020200000703070203040803000300080005000007070001
10448020436040448420736450303320347220805238707480208350206255566420202572355070371
10004040000030700060000000500040307000200080006000500000400000000000200000000070001
15503028747520338046378737728680804076547020683024732282343224885563278747242265801
10006000000040000020000000000000400030000070007000000000000000000000000000000000001
11111111111111111111111111111111111111111111111111111111111111111111111111111111111
