11111111111111111111111111111111111111111111111111111111111111111111111111111111111
10000000000000000000000000600000800000000000000000002000000000005000000020000000001
12358070362536225740802242506082407370432276843663404740808626558087308030255660501
10000050006000000060800040004000500020000080000000400000600040005000402000600000301
15207463302050736040723660605620633034835035834240407022256080807630402055408438871
10003000800050600060600000600020400050004000003000806000508000200000803000800000001
10583070656780602360307083533030606827705365402038806050503086677328406670722542401
10006020800030403030008000006060005000204000700030008070003000000000700040000000501
10702020707064602020728853307078386070203080608420773020854072435640253020424320701
10600020504000500050400000007000000060003050300060505030005020003000600080006000701
10466380224560546763505045576847682468765220602480307027404360406070203757776068401
10000080000000200020005000200000300060000000507000600060803000307050400000200020701
10263026408667533060254682404040208030633222404030653440202085608037848880803270501
10007000406000000020400000407050203000408000003070600000300050007000006000700000601
12706230838020486530707470707080703337503037235020803385542780385558404052706367601
10006040000040000060008000708080704030007000600020500000200020500000802000700070001
10325050455264325084488030305030606060784060304453633370302060504380504720374060861
10002020000000007020000080803070007070003020807000000060006000200060600060300030601
10508050854848606020308633707073888070203260605064375062604523606028263060637550701
10400030000030302060507000006000000050300000403000505000605000506060000020200000301
10725687458040302080734060264854883840302472503670706220724020668050444750606426501
10400050007000603060007020000000200080605000600000800020000020003030700020200020001
10608080206726706048407085306330402030504080752325252080758354405060707060355080851
10003080502000405080008000400060406040800020800000004050200080007000207000300070801
10665040303070603050336530764650504060554028304072304020304430633446205470207740401
10300060403020004060000070007000502030007070007000805070507000300000600060300000201
10403760202055556075456053406084502043703440375720208070707047508050403048372526401
10200080205000200060006000608000006000700020000080700080007000004040307000300000001
10573080407460505685803330205076482850575064844032665378388273788040575380702055541
10006000600040208000306050008000000050006000000080002000000040000070200070008030001
18458062273070805060703080867855385072802834602720504080344040524850603360224040701
10007000800070500040205020000000004000703000406000500070006050007000700030406000601
10402522707280824250303066805442742420708060222043782054207050664052676040306243501
10500000002040000020003000400040000000800040008080003040004040600050000070400000701
10653442275060383043346780502030407254436225802050207870576025404830606030565450601
10003000000080507060000000205050300060004050004050500000700060003000205040008000501
10507022627340203020503674304060563820404020624040528865802070764020705220207020701
10405020000050403000200070404020000000800080000020000070008030000030800040204060401
10606080788070607084343050706060728842234767273465488080825724264020287050408040601
10300060300070004000704000707070000000000000000000002020000070003080700060600080201
10588727704023858440504057708070625844374863385850603023528060407440605255482570601
10007000007000003000305000306080000000000000000070703000006000600050403000000020401
10707043288734302065203830506074706258336823844080508522408077634080606427587040401
10700040000060006000003030702000800000000000006080800000707000800070700000008020701
10858520524020235086707030304570277046722046705073353530402750408330428683603045801
10700000800030006000805000600040006000007000807060000060600060500030008070004000601
10837524507076708880364486488555807674403070506040872030633030605074606050872660401
10000000804000702000300050000030005000007020808070400080004050208000603030000020201
10306780707780204072308080602020406644884580202070302353802070368030604030435070501
10602000803000308060004000403000405000000080505000207000806030005050500060700020801
10523043305087307520652472385634845057454080603037507080302072505080763030805750601
10007080005040006000700000000000002040002070708000503080007070308070007070600000701
10202020364870774027508062336672807660807075307774505064374080503458602080786224301
10803000500000700080004000000000300000402000002000002030003020004000002080000000401
10706272705638606830405773473256347682408067842078426060306023233033376344876260601
10308000600000404000500000500000000070505040003060005000508050000030000000003050801
10605050424570608048576620307463837050803650503530607877884020366577522722304070801
10400040002000500060006000302000003040800070300050208000600050000000200000006000701
10708346208074258685208034605068508020802040844070405030806053578760307043826345801
10700000808000000000008070006040206000206080200070407020003000000060706000000050001
10335858807062863537553680408040304888605080408280507084854363833080803057633040361
10000040007080000050000000308080200030502000200000707000005000000030006000200070001
10627040672620803070424268407040355030706053253652803547206785358474325070505584701
10003070000000303000400040006030200050002080000080700000800070000000007040300080501
10808030357448302528306080502080402853638330722080746870708050604324407820203080401
10605060000000800000003050602070602000000000806040000000606070202000005000408000301
10406070747244886042827540233030506074432465608074367782304030802070727054343757401
10704080006000004020000030700080702000000000004000700000007060404060002000003000601
18603038887080604280874034608080206074738320472050705522637060804072505835302060301
10004000000020500000603000305020207000400070007050700030000030802000304000600020301
10858488507860773735606050508460505040848048404850636020323740402650546036466040501
10800000200070000000007070206000604020003000803000700080200000200040008000003040601
10632360437022344375627760403044705066807460606026838560408072673084502738403730601
10000020003000000000000030606000002000500060305060000080007000007000500000200000601
10342052608034724388722080808763654757368080807027775055885056308330763660257720301
10008000008000002060008040005000005000006000704000700070005000203040003000500040201
15707062843820707080306072268070806080805344703030604080506380802057427036308034701
10003000500080500050500020000060800050800000802080306080408000300050003000007020001
10643040425070828230626540502350646620802363502640207570308846475570305853732030781
10003040000030500050000000700040704000300040007000400000200000000000400000000020001
12805028435480456024747332758550208036527040864047435258584667236248558575546777301
10007000000070000050000000000000700030000050007000000000000000000000000000000000001
11111111111111111111111111111111111111111111111111111111111111111111111111111111111
