11111111111111111111111111111111111111111111111111111111111111111111111111111111111
10000000000000000000000000400000200000000000000000005000000000006000000040000000001
13528020536257827340703245806066508840634325363445208470802863826085707060786250201
10000070006000000020600020007000200050000070000000600000200080006000807000200000201
16305565407040724050588730206850356067727087758520606065825030704370708068203863481
10008000600050500030300000400020400050005000002000303000408000200000204000200000001
10386050233430307660407044447040606884204754307028203040305046674683604870827288501
10005070300020308020002000005040002000802000600050005060002000000000200050000000701
10505040706082203060322466707026427050308030704250842020562087843630443070876670701
10400040205000800050800000005000000030005040800040508070006080006000800060002000301
10628630372680574265805077828568353222284580702270303037703530807080804374253056301
10000060000000300070002000200000700070000000706000700030306000702070200000800040801
10446053202555342020753667803080708050835636406040584250603042706048372460208880301
10006000803000000030800000204070706000803000005050300000500020007000007000600000601
17607680487020622620404280604070604877308078823030205325522850375838605058608277601
10005070000080000060002000607040405050003000600060500000800030600000502000400080001
10744020654727543088635080504030302030777030202326472640203070305340805530225040681
10007020000000006020000070305020006070002030803000000080004000700060800030300080401
10804030258633403070607525208064485040408540506088388047202284304035283020233360401
10800030000050408080406000007000000080200000202000603000306000805030000080800000201
10233454822020806070654020788276322860403472802420207460375030574070873270703252401
10800080005000808020004080000000700080504000400000500070000030006080400030500020001
10207060704352604055306045204370504050503060254762384070625435805070807020746020331
10007080206000406070008000300080603050500060500000008050200030003000307000500030301
10726070604070502030267340253470502050483047503064603080204780676222705470402640501
10400080305020007040000020005000504080003040006000506060302000500000600040300000501
10308860202065664072226065605054603036204440544440407050206046307040602074443238601
10600080607000400030005000307000008000300070000070500030003000008040805000300000001
10244080402320508477705660404053277450573057522087724347587585746040264380802043251
10004000200080805000202060003000000040008000000080002000000080000030200050004070001
16357066225060306080308040284265788067603436804520805060483030585230205630286040801
10008000200060300030403070000000002000304000705000700020008030007000400040608000201
10307863606580526840506022602428875770805050548044322083802060566084444060802462701
10800000007040000040008000300020000000500070008080004050005020500020000060400000301
10565274625030382086885830808050504464578526703060307470887085705480302070678430701
10006000000060607040000000502040600040002040005030500000700080002000704080008000601
10504025735250407030307356605030757320304030786040473676408080727030703520302080501
10308060000070703000200040704070000000600050000080000040004020000060500070408040401
10805030436070506045265060508060243555452582585467283080277772567070734040505040601
10400030600040006000305000808020000000000000000000004040000020005020500050300020301
10754544702035538270802056508030585263675476626420608062656060605530702386623840201
10004000007000005000404000807020000000000000000030705000006000800030705000000070701
10205048327847505068507440806024603462457578455020603673308045843070307262842060801
10200020000050003000006070405000300000000000007080200000403000400060600000002080601
10265770372050576046504050204670267073842077604046842820807650505530535633204035301
10300000300050003000702000500040003000008000805040000040800050300070003070006000501
10265882704085206330765726387728602366603080405050338050432040706067702060345830401
10000000204000407000700080000030002000007040402070700050005060608000704070000070201
10408360405860405025805040807080604373272440602020703276705070272050306060776050701
10607000605000606060006000206000802000000080606000307000303040004040800060400030701
10527066608075803330528234585773566062424060404042702060306075706050632060402330801
10006040008080003000300000000000007080008080407000608040003060807030002070300000801
10208060743630845075605053658745705860407023205455207056387040708344602040375657301
10403000500000300040002000000000300000204000004000006030003070006000007050000000201
10707427702256508850403686842555354248508076582062845070404045468048665242256280701
10705000300000605000300000400000000080602060005030008000305040000040000000002080601
10804060735220806072433460307856447050305470607450803375355020677738835227606050801
10400050002000200050004000704000005070800050200070208000200080000000400000008000801
10506868207037342284505068706074302030807020678040504060805082632760505023337233401
10800000205000000000006050003070207000704020600080707070005000000020702000000070001
10424746308048747344763870408020605733706070307460204044432854744060308044355030651
10000020008070000020000000707080400050203000300000706000006000000040002000600030001
10777050534670605040723854806060587050402044645732308358304265325472683070704652501
10006050000000202000600060005020800060006060000050300000500070000000004030800080801
10508030574233402644805060703020202824724540433020747820402060807863805770702020801
10803050000000400000002030702060202000000000503020000000703070502000005000803000601
10205070728875742054766540353050207046764778608078347572805030306070668067833263801
10308040004000007050000050800020502000000000004000800000006080308080007000004000201
18508035624070702750683047502050802073786580426080306664735030706073405685506040801
10005000000050300000508000706040202000400070002020200060000070404000402000300050301
10527853803360682742708080507280608030434027708740453040272220508720367038338040601
10400000400060000000005040702000406070004000608000600080300000200050003000007080301
10543270637033684382333660602025807077403620708083736350708074663028402323603760501
10000030007000000000000070808000008000300020702070000060006000006000700000200000801
10323073705035274724884060703722533235258050404056343082376066505220224360428540601
10008000003000004030008050006000008000003000507000700020005000207070005000600050801
17807067228450807070705044746060503050405556805050305030605680407047784037306068401
10005000800080300060400040000040400020300000204050303040308000300070008000002030001
10445080583020734470287520803470844250502237803580704650307443288330604444527080851
10004070000060200020000000300060508000400050006000800000400000000000400000000020001
18206045768360556086522488583250205065473070346055565655564456248337867863745656701
10008000000030000050000000000000200030000070002000000000000000000000000000000000001
11111111111111111111111111111111111111111111111111111111111111111111111111111111111
