11111111111111111111111111111111111111111111111111111111111111111111111111111111111
10000000000000000000000000700000300000000000000000007000000000003000000020000000001
14278070832278787650204724404056207370756757387454604520208565878063608040256350801
10000040006000000080600040002000400050000060000000800000700040005000603000300000701
12507834202070427030743440206280525086636025758250307036442070508740504022504842571
10002000800030800020500000500070500060005000006000607000703000700000207000400000001
10553040538420608280805076348070602376607785303027307020502058352742204460787254201
10006050200040606030004000004030003000308000400070002040003000000000200030000000601
10606030406073204070788778305084683080206040503340243040533054727660535050732460801
10300050802000200060400000005000000070005020500050504070006030002000600040007000401
10228250653460248326207077675475586727452580703330608042803460204050508743348063201
10000070000000200050002000200000500030000000808000300030803000805040600000500020601
10668023205343355020747685404020406040856765308050745860705083805082447720704770501
10005000504000000080300000203070407000403000005040300000400040003000006000700000201
14507530276080278470604730708070302484808057852030503745277870758724604085206667601
10004060000040000080007000506060803020005000600050700000400060500000504000200060001
10585040536867884047246080203060205020628030208372665580306070206860703620357080781
10008030000000004080000060704030007040004070308000000040004000800030200070700030801
10603020563833202050808367704032466060503880206048635024307352802027242030255630301
10200060000050706040804000007000000070800000603000307000203000305030000080500000501
10727378648020207060424080464568473570306844307280807780527040726030333350802858301
10200040003000202050008070000000400060606000200000200060000040003040700030500030001
10307080404333205056403052206330303070706030327545586060857434704040408080448060361
10008080403000606070007000500040407030700050800000003080300080003000305000300040501
10632050605050504060572540622820504040266054706078306060507440522762506280302660201
10600080708070005040000070004000505020006060006000703030703000200000300020600000601
10408240807064785055488076805077405062302620887540306060705042302040206037642522701
10400040605000700070008000202000002000300080000080200040002000006080502000500000001
10378030604440203442702240804047574340858038524026783254488234776070257850204075351
10002000300050404000408060007000000080005000000050002000000020000050400070002040001
16243025728050406080403070445436344035807737703320705040284040358380607470575080301
10003000500030500020707030000000005000708000206000500030007020006000800040207000501
10406523408420836450604065204322678250806020428085424082602020567026883060408342301
10400000005080000050008000200050000000500060008060005050002060700040000020600000501
10453262638060873025357380805030505285225276607070705580388068307330304020438580401
10008000000080704040000000806030500050004020007080800000800070007000204060003000701
10203035237370203080302753708030757880408050272030766463808060627040502880207050701
10708030000080807000200070606070000000700030000050000070008030000050400030602050501
10506040672030807072658070205020664827874888855887883020877752632030642060304060501
10800070700060005000702000507050000000000000000000005070000030007050400050400050701
10385455608085536330506032508030734576375683268740707032542030502270308882782480201
10005000008000004000702000806060000000000000000060802000007000200080507000000020201
10308087422235404042406570702066706284223687772050406322304024667020502384455030601
10800080000020004000003050606000500000000000005070700000304000700020300000004080201
10672370884020886025308020703420765063475053802057842520302760602320334288202085301
10700000600060002000404000300020003000006000407080000060300070500020005030006000501
10578662408027207670537824764755202863503070607020835040846020807083506050678520501
10000000207000404000200030000030002000007070502080200080005080606000802070000050801
10806260705680306087708050205040508724466240207070306826306020677080603060265020701
10706000508000704050004000308000608000000020707000604000405060002060800020600020801
10828044507043506760876354387475576046588060702088507030304078306080566030706680301
10007060004030003000800000000000004020007030507000503030006030802050008020200000401
10208060548820373053806078567272307540503025506647304044633050603462406070346742301
10607000200000200040003000000000700000604000007000002060007020002000005070000000801
10508366602635603650203236374743685532302026485055827040605028224052643586275420801
10804000700000307000300000600000000070507020002050002000203050000030000000008080701
10607040827240306062667860802626722030306850608450802667352070365428728834508060201
10800020007000800080002000403000006080300020700050503000700070000000700000006000401
10505727808038668583205055503023602050306060525020706050502047853770404034258647301
10400000308000000000004060005020603000402020300060202070006000000040403000000080001
10837658502083325623758530402020306263604060306370604046488683477080306024235060661
10000080002070000080000000404080500050207000800000403000004000000020004000300050001
10333060277470605060544765408070543050702034377254204665206227585433723020805246701
10003050000000708000500080007020800050008050000020600000500020000000002070200050601
10407070738848207824808050307070808484668470686060788280304020404726608370605050701
10305070000000600000007070806080808000000000808050000000704020202000004000304000201
10705070554623724047756380755070806038672587508048342343505030405030255066223837701
10603020003000004040000080200050407000000000002000300000008020206040005000006000701
12208053652020406340566073205080407048832580536040606788456080508072805637708070701
10006000000060800000803000806020502000500030006050600080000020804000306000800060501
10622765803840477366306030202670705080683084205430343020783830407450348065535040301
10200000200060000000007070304000704050005000705000700050600000800060002000007070701
10487550532045233875288430505067506085204270503063627820306034443084702676504860501
10000060004000000000000030606000007000600080308030000070003000002000500000200000801
10834072606052457647822040205688385543658040404042685038742034705450562450453650201
10004000003000003040006040008000004000004000702000600020003000407070007000200060801
18403066446460508070404087572070404030703275807030204030505250704026446055405084801
10007000400050300060400060000060400070600000803050302040204000400070004000005070001
10642020582030727670724820406850524270304325704730202570203735477850703843322020531
10002080000030300060000000400050503000700070002000300000300000000000700000000050001
13204075475420488023634224567760404076783030574048544538635358653286665286338257701
10004000000040000060000000000000700080000080008000000000000000000000000000000000001
11111111111111111111111111111111111111111111111111111111111111111111111111111111111
