11111111111111111111111111111111111111111111111111111111111111111111111111111111111
10000000000000000000000000600000400000000000000000004000000000002000000050000000001
13883070585782386850406673307055307570573838534286504570402385837035705020267560201
10000050002000000050400030007000300070000070000000400000400050007000605000700000801
18807667307040652050584360603460478066276062265220605058743080302320704028206636821
10002000500030700060600000700040700040005000004000807000308000500000305000300000001
10845080725730504820202078863070407854605564205068206060803045287543202850654522301
10007050200070806030004000007070005000208000200050004020007000000000400020000000701
10308030408033803020867448802083472080206040502440644060444063663580332080374880801
10500050307000800050200000007000000050005040700060208020007080004000400070003000301
10657450575340454457405082877883252644532450303380308057607360304030406264368057701
10000020000000600030007000400000400050000000606000400030402000802040600000700080401
10787062805262868020738857206060306070858468307030386230503085303032476220703760501
10006000406000000020300000608060803000804000008060500000400050004000004000400000801
15802420837030643820203640808060608355707065875050806382334540756737208022702854601
10005070000060000050005000602020302060008000500040400000700070700000207000400050001
10437050438623643062435060406040604070472080604877378420505060707330607550473020381
10007050000000004020000070803030005050005050203000000080005000800070400020500060201
10505030724335708080605385308043332050403430206082788034403844302077254020477560401
10400040000080304040705000006000000020200000504000602000202000406030000080200000301
10728634877070508040325080878226685720806753506850405640636070627050237860504838801
10400070008000608020008040000000600040803000300000300040000070008020200080600040001
10702060402472408063403022608580402030708020388863864050587284305040607050463020251
10004040605000304020005000400050603060500040300000006030700070008000305000200030701
10572030705020608080637420578580304070558065207072403040205820264726208250507460201
10300030304050002050000050002000308030007040005000306060504000400000400030400000601
10403740808072483083582074604043402068503730883460605020408053607020504085277847601
10200060802000700080007000708000008000700030000070600050006000005050508000300000001
10376080502350808353403630302046342830523067264055688778727373323070825350507035551
10006000300070303000205030002000000030002000000070003000000020000040500060005080001
13753033563020708080407030633446245025602535203770406030324070773620702250422040501
10002000200060400040603080000000005000405000307000500070002070006000600060807000401
10703247508820327820606074202757457880808080653028772068205020474033663060503663201
10200000005050000020007000800020000000800030003060006040008030300040000050600000701
10365624684070386036868840403050702338686536504020205370435036605730608060437740801
10003000000050504050000000408060600030004080006030600000400030005000808030007000201
10703054755540706070802334407020776580307080283030345433204080846040804420406080601
10308080000070308000800070405050000000200050000030000060005080000030300070308070301
10403080846050605044656050604070267544843265544653725070564858224060568030402020601
10400070500070008000508000207060000000000000000000008040000080005020700070300050601
10862222203042364880302037706060633852644654448880307085437070407750404276835640601
10003000006000005000702000405080000000000000000020802000003000300080503000000040401
10404053786367406036807630703054505444844575725050708685302064733060804373273080301
10500040000030003000007050302000200000000000007030300000502000300050800000005060201
10462270455080433067204070303460786053564036707034775650206320604360445766606068801
10200000200080004000707000500050005000003000302070000060700050200070008040004000401
10882775404027805330464674352735604832505080402020662030644030704053303070266860701
10000000402000507000600080000020003000002080804070400050004060408000206060000030601
10603580805520604068504040808060807746873380507020408465808030628070707040373040501
10308000404000405070008000203000303000000070208000702000502030002030800020200060301
10338056202054506520268467374885436078342040508028706040506072603040833080805860701
10005070006030006000600000000000007080005080608000605060007040708050002050300000301
10504080376380525035807084872638503450708046308623205076385060307684402080668866201
10608000700000200060002000000000600000505000008000006050007070008000003030000000401
10807346506477803720205274467863648364605053484035573030408063668034342874884520701
10507000200000805000800000200000000080505050002030007000302060000030000000004040401
10705050723270808034562680405866623040705860704660602278253030473826285622705050601
10300020003000600030005000505000005040800030800080404000200030000000700000005000601
10302832302053547342503076407033405020803070663070704050404085265650305055462273601
10600000306000000000003040008050307000404040600040802040002000000060404000000030001
10336757302074632267672830502070403527204060608660708086664837445040305066875080681
10000050004070000040000000208070800080608000200000405000007000000080008000200040001
10266040276620407020466528403070432040605047787725502264204234858236353040604442401
10008030000000803000800030003080700050006060000020200000800030000000007080700030201
10302050377772205723307030202040408858377250353080727760403070702423505780807060401
10502020000000300000006070808020807000000000506060000000405030604000006000806000301
10802070828844383084672250253030607058243456206055762378203060708050742033756273601
10403040003000002040000020800080605000000000005000300000002060308020004000008000201
12407047847040604730332038702030607022756870722020606763635040507048608657205060701
10002000000070800000408000306080302000300070004040500060000020505000302000800020401
10256274705770482684803060705750206080882076803430456060743830204340833082843020801
10300000700030000000006060305000307030008000208000600070700000500030007000008070401
10687230857065674377372220608086407057506530704038574570608032566026406747804220801
10000040006000000000000050204000004000200080707040000050008000002000700000200000201
10357045703065336874544030602555374284543020407046457036347062503830447660537260801
10004000007000006080003060008000007000008000304000700020002000303060006000800040601
14805055233270502050704072533060804070302866702020305030708250205045443024207048801
10008000700060300080600080000060800030200000502070708050603000500030003000008030001
10276080485060787470677640705820337450606776408730404370304478635750502782378080321
10008030000030600070000000300050502000300060005000400000600000000000700000000040001
15204024832440276088853733236640508073735060648064442644532483785473342266684545401
10005000000070000050000000000000200050000050002000000000000000000000000000000000001
11111111111111111111111111111111111111111111111111111111111111111111111111111111111
