11111111111111111111111111111111111111111111111111111111111111111111111111111111111
10000000000000000000000000300000200000000000000000005000000000006000000020000000001
14682040464676887330505327805034507360626275773328205830302658243054607060768260601
10000080008000000080500080008000300040000040000000800000300080004000207000700000801
16702373505070265020267250507850663033253085783840706074554050206370705047506883731
10004000200060500040400000800030800030005000007000408000807000600000307000200000001
10733080342680604760804065435020408372603847404077306060305053272885804430538676301
10002050300040803050006000006030008000203000300030007070003000000000700030000000701
10706050307088206020362884703057474040402020707470476040622064554550352020543640701
10700040708000600020700000004000000080003040400020603080008020005000500050005000801
10267280558680723354803026655277722633233440702860507085302640508060302668732088801
10000050000000600060006000300000600080000000708000200060808000803020200000400070501
10352044802743653070787743506020206030322385707020743820404076203024583430807840801
10005000502000000030800000206080406000708000004020300000800020006000007000300000201
12205280378060268420803280804020303346805034655060807755322430823436204066507425401
10002030000030000030004000704030204070008000300020700000300030500000605000800030001
10848030278827438026785060406020504050525020503475556370805070708550307670343070521
10002050000000008070000080602050007040002020407000000020003000300020800030700050801
10207020686387402030708447203044382020204360502058743077502434805037735030625650201
10700070000040406030605000005000000040300000607000303000204000202080000070700000201
10428537376060406040855020654538675770402452605350705420552060784040736480805778201
10200080004000306070002060000000300060604000600000200040000050007050500080300030001
10505030803556208052505087502320202070302020867245764040872834702050508070737070821
10008080805000206080003000300050605030300040500000005080500080004000408000800060601
10264070506030608020883880426620807020323084206036808020704330525855402450808840601
10400060705070002040000020006000605060007020003000308060404000500000300060700000701
10805320507046436028236028704034505072403820446630404040703025604070505062867473801
10200050502000500060007000507000008000700040000030300060008000006030508000800000001
10487020402740706224803820203086377850534062528054344582575643876060483650607086651
10005000300020302000407040003000000060005000000040007000000040000060800040004080001
16885067726070308040507030272645332022608737507560406050236030572720808330486040201
10004000400080600030306050000000002000302000708000700050008050002000600060605000201
10303254407480348580202044804223453770603070276045828057706030882058558080505434301
10200000004050000050006000700060000000300060007020002030005030500020000030800000801
10547228756050536032732660403080704666554886307030602730828054206280808080335380501
10003000000020208050000000808080800040003050008060700000200070008000803070006000701
10406072473560507060608546703060232760404070426030344565303060627040507320604020501
10305050000020207000700060604030000000600060000070000030004080000050700050507030201
10604080636070702076843050608020633252833785327583833060868284587020263070702070701
10300040700060002000806000207050000000000000000000008020000080002060600040300040601
10357777204083724740204082204040685336837476764230704042276050807320803672723620701
10007000005000002000808000504020000000000000000080304000008000400030403000000070601
10504037556355806082205660203074708762842522327030702288702033884020507777677080701
10600030000080003000003070504000400000000000003020300000404000500040800000003020601
10584420583040226024305050604820462037743034803064674320705330206570885685304052501
10200000200030004000305000600070005000008000206060000080300060200070008030007000801
10425558604045608370236367532626604524706050508020547060375050207048802080576750801
10000000604000407000300040000020006000005030802030500050004080804000504060000060501
10607530703640202083206020805080308762444340407040408835806020243040404070264060201
10802000306000606050003000202000206000000040808000608000205080002070300040400030801
10336033402087503430734556674585664038425070305022206040504022205020456040707220501
10005080006050005000200000000000002020004060206000403060004050707030008030200000601
10204050684280537028805025423266407430206046204487304082375050805687306070586442601
10704000600000200040004000000000500000805000008000007020003020007000004020000000301
10406275404656603220707762565224654254707048763067248050702067658048435223325260501
10204000800000607000700000800000000040306080007020003000304060000030000000005020201
10806080342720407046842760406283343070606560808530505635787060385666888548508050701
10400070002000300070005000504000006080400080500050606000800050000000300000006000701
10304435205033238356208067406073708080507020286050507030802038226470803034357685501
10800000708000000000008040007060303000807050200070703070006000000070807000000040001
10563855502056765662888660505020802735804020504570208073377476658060707062762080341
10000060008070000020000000206030300070307000300000706000007000000070008000400070001
10845040762370405040548887802070765050802026444423707654603256378586272050502578201
10003020000000407000300060002020300050006060000030700000500030000000003070800070301
10203030435783803722607070505040308344478780748040327570302080707688206770802050701
10406020000000300000002040402020804000000000302040000000303020604000005000702000201
10206040688665527033387530876070807076373663607048673365806050304030358033668428401
10408020007000006060000070400040503000000000005000200000006050206050004000008000601
15703052828060502740568053407050802027256220434080705545224020207037502865407020501
10005000000060700000702000308060706000700030005060300050000030508000302000200040301
10242334502330647827307070602370805080578054504640785080848780408750758024238030401
10400000800080000000004040803000308030007000307000700070400000500070003000006060501
10382830725085334757834530807024307048406570807024462540205083224022402336508420301
10000050006000000000000040403000002000400080502080000020002000003000700000400000401
10736046203057548248673020805424347447533030403087638076657027703830653840786230301
10007000007000003050005050002000005000005000204000400060005000408050007000200060601
12605037572340502070407087737070605030507857404080607050207320508045256037305035501
10005000800070500030200050000040200070500000403030405060605000300060002000002040001
10638060453080325430826870206220348750608644808530804850708525425620805825326030371
10005080000060600050000000700020806000500080007000400000400000000000200000000060001
17203048528540633056424728254460408063465050223063767366235378376828222373366646201
10005000000030000040000000000000300040000020007000000000000000000000000000000000001
11111111111111111111111111111111111111111111111111111111111111111111111111111111111
