11111111111111111111111111111111111111111111111111111111111111111111111111111111111
10000000000000000000000000800000400000000000000000005000000000003000000030000000001
14368020253872578360607547506078205670786325722423808880704363468082704050837460601
10000040003000000080500060005000800080000050000000400000700080006000407000800000801
12803342707050547030354220705760548032463037242320508038678080208680206055707477551
10007000300080800070600000300080300030002000002000508000504000400000804000200000001
10866070862440703370605078648080605544305283308085503030802088278854803530432546501
10007040700050704020002000002030007000608000400060007070004000000000600060000000601
10707080402085202080827622803033866070606030207850223080542047455680355080642330401
10700030403000500060400000008000000020003040600040607050008050007000500030005000701
10773520228370742388302078754528438858334240707540506075705450306080703747475042601
10000020000000400040005000800000800030000000202000200070608000305020700000300080501
10746076303483258040535232204050707030223265307060582470408088405064326630606740401
10002000606000000080200000402030702000605000007020200000400080006000006000600000801
12706580426020738740302330505070406864405087643040608526366330476532806062407726601
10007060000030000070008000406040705060002000500030700000300040400000202000500080001
10428040246376348033573030803060203070823020502765428280507030406730607260225020881
10002080000000005050000070508030008040007060502000000030008000700060400040300060501
10204030544622807060808468806074286030404740804047735044306434804058434080382870201
10500060000080403080606000003000000050800000705000608000304000704040000080800000201
10374883555060507070843080632384237850802245707540705380645040784050728750607335701
10700070003000805080002020000000200070303000300000200050000040008070200020500030001
10606020807838205052605063702560202080604040362346552050724437607020705040345050261
10007070802000202050005000600030208050400030200000005030600060006000507000600080301
10577030304040608050338560668250706020448088606023408030304320762472307720504380701
10400050708050007020000080006000808070005080007000407060308000800000700080200000801
10502370208028488056857032505032604072508740378530802060804035407070308035723876501
10400080605000500060008000207000002000600040000060500070007000003080806000800000001
10383080808880308388706380608055673240244054547053647373867525633030524680406055631
10006000800020305000206060008000000020002000000070003000000020000020400040008020001
13452077268060208020202050583686788064605273504530205040782020628750202580738030801
10008000800040600060805030000000004000404000506000800060008080007000400060405000401
10607824308540382670703072808365267560607040488045645077302070645075723040302885701
10300000007020000080003000600020000000600040006030007020008080200030000030400000701
10727258772060758066666730506080305343544532502060305640585088308230204060475240301
10003000000060302060000000505050600080003040002060400000700020006000402080003000301
10204064752520808020606573408040525620806060727020566655602070636080206560306070401
10703060000060805000200050705020000000700020000060000080002040000050600070605050201
10404070725020505025658030506070562778467858463536363050632376448080553050405060701
10800070800060006000208000407080000000000000000000006060000050004030300060500030601
10554733702064264320506088403060227245363583688340505063232060708530708636242520501
10006000008000005000405000208080000000000000000050407000007000500080306000000080601
10504028734646604047407880702036608655278823486030605564707048282020805684873060701
10700070000030006000002030805000200000000000004070800000503000700080600000007050201
10765750855060663035702080607820844023523056308033228630305880402350267624804064401
10200000700020006000806000700040003000004000608060000080800080400020007040007000601
10744868503087702860832826333386704228503040808080625040554060602068803030566680701
10000000803000802000300070000070008000007030705040500050004070307000607060000040601
10802460608620502073807040505040702834476620407020706643507070336080604050445080601
10307000407000702040004000504000803000000080502000607000707070007060600070500050401
10736027305065308280835226574347655073332070406038504070702032706080753060807880401
10002070002060004000400000000000008030008040807000802050007030507080003080400000201
10207070734420263084207082567232504420307084208265506058265070808227204070478587301
10306000200000500080005000000000600000607000005000003060002070007000006050000000201
10506785205437305420708773666474668485708062347036868050706073383072223332248650701
10806000800000506000600000600000000080403080008030006000405040000020000000006060501
10304040625380503045884420505453662060808560405460603274777050544684458463706030501
10800030005000200040003000703000005070800030300060202000700030000000500000002000401
10304272204063477673306072607045204080608070485070806020302034538550804038633476401
10200000705000000000003030003040403000702080800040402030004000000030402000000080001
10424367808027384545263530205070603626507070708570608088356822273030304052683040551
10000060006060000080000000505060500080508000800000402000002000000020004000300060001
10733070657350705080834454305050872080402035578752507758606872266387553040608658401
10007060000000306000800070006030800020002080000080300000800040000000005070300040401
10207040888386205255608080303030506647687860362070745630405030404432603420602050701
10305070000000600000002040305060407000000000605050000000804080305000008000706000501
10708050446534572076575770466040303027775442507058453824608040602020233072672384601
10402080002000002050000050500020708000000000006000800000004070607020007000003000501
17604038777080402360436028306080804072864730775070505853742040202076303385502030301
10008000000070800000703000707030302000500060007050300030000050703000505000300040501
10848558804550528874607040503570703070462068504220854080872760706860828047565070201
10400000500030000000004070407000405060007000504000600050200000200070007000006070301
10626480778083836383224380203032703067706360603064355450604042243045703687704620401
10000060005000000000000040305000003000500080502040000060006000005000500000700000601
10264046302045776728536040404785522643845030404052325064555024807860647250478720601
10005000005000004030008070003000006000003000303000800080003000802080002000800070401
12603075243540804020508087753020304020706585406020407030307880206048627045402026601
10004000600070400020500030000070600060600000303030208030303000400020008000003050001
10533040358060885660664230402840473230503546305770705840205628632380207265636040571
10007020000050700070000000300060504000400070008000400000200000000000400000000060001
17205053852450642057538767346880605034686070262056857256634284364468756287234868401
10004000000050000040000000000000800070000050006000000000000000000000000000000000001
11111111111111111111111111111111111111111111111111111111111111111111111111111111111
