11111111111111111111111111111111111111111111111111111111111111111111111111111111111
10000000000000500000000000000080000000002000000000000000700000000000000000000000001
13807854772880322350208336833063304037406550507034707820226040702433646755875623501
10002000000030000020400000002000306000200000207000305000800080506000000000000060001
10803437274070588080758523507570403340775554472820805054307780563070745855233040441
10402000500020607000500000300050305000300020008060407000005020006030000030005070001
10603070804030506887805030328080405034403076704020407576545040703058356530407020501
10500080003080006000002080408020007000004000505000500000600040700070000000300070801
10546054284540775060572080608083328370757320603384873230705548275470346726852030601
10006070000020700040004040006000000030000060808000000020300000000000800000008060401
10306550604084802027502037642342552050636050602040822030575255655256606845403750601
10700020604000003000507000000080000070008020007050003080002000200000303000500030801
10763070603286725680705375572250306684404055663068404083306040404720307020477066701
10003000205000000080500000006000200080005050000040706070003060007000606060005000001
15302424208070808032646886422064728060808050802750307070544040474076638030503327801
10006000800080607000003070004080800030404000600050008030002040007000008080500000801
10437320303730342076707070305080808520708566675656564080403080803437505080484530571
10000000600070008000800080300040002000700000000060000030202020600000600020000050001
10656868405045802272448230887470583080725633256040323572805056578570575722735480601
10000000408000600000003000400080200040400070400050000030002000700000700000000020601
10765480438880873482304024552080207234804080202457484020645450406877707265667063501
10000050200060300000003000000050200000005040005000008050000000208000403000200070001
16263530604040408053662372306435303420278074278085243080752845533070605040608320301
10000000308060506000000000302000400020002000006000004040000050003050003030200050201
10588548503080504826502650838030222024772850704226602026842060604078828080387060571
10300050006000600000400080800070004000000070700000304020000060306000000020500080001
18607020205828535580857420702685507034483084806460702037836430608556238852804034601
10003020504000000040000020305000006000004000303000506000000000800080006000004050001
10472070227075734055237026404020787572808460604037402888204647374080507080823050551
10003000400060008030003000306070000020006060308000205000200060007000500060006070001
10402258202060506050482730872062278030247020273220305070862066404082625228503038601
10800020007070200060000050007030000070600070000020002050200050002000000040006050601
10225040258030578872562050205060643540303856588064845650602330408572875080644030201
10404000200050000000000020608080800070008050004000000070200000203000000040008000501
10406573702065424383633860303040602027474070504052327060343876528048643230404665501
10500030403000000000000040300020006000002000402030005060008000000030000050600000801
10206030307052284725857020705037522450707838504020807032205776656570882060464860401
10205070003000002000007050404070000060400060005000205000300000000020300030000040201
10558020867375508078803080606080447062267080532462602520307643743020507078323020201
10000050005000407000400020307000800040000040000000303000700030000070204000005070201
10627878804062403060568820706846672870802674642460302047657380608547707838724030301
10700000408000007040005000600050000000700030000000404070000000408000007000500030401
10602740504373234335635076576080655685625540563845405060305325602035352020708870801
10006000806000600070002030003060600000000030007060003000800060402000007030300050501
10538084807040802050504040626080303076663084408030806680544050602837204072333050401
10008000800060404000400080006050003020004000002000400070803000805000704000006040501
10308730574840306243867338805077544870405473262767388050303020404030507485807040701
10800020300000300000700060002070000070800000400020006030304050705080600000600080501
10727060702478464260306030387050336040306730407080405080705072502050627740563070301
10006020506000500040802040000030005000405000205070600070304000802030000020004030801
12353080805060402050303064574324808042304062305070533860405240204032242038405020701
10007060308080003070508000700000206000807000504070300020008000202000306000507060801
10706060706080777670204520702760807530203250766080662078665474704270306080303380301
10500040605060004000203000605000506040204080006060006000000000700070804060200050401
10342380502045804045405023603055808050603040508082708236767460203080608080538040301
10600070602050002020003000004000005000402030300080600000000000603080808040006000501
10206080705044238070604243207434462244702030563850508827245245803070503035504277601
10708000603000006070600000800060003000007030000000700000002000008030702000400000701
10203225704384306030404750725020305078644062323220508842532028687030705822453080401
10304000806020003040605000800020805080006000500080707000006070300070300000008080701
10507670406030622020306076707220805040607550407080887067803020205530603468304060801
10806000500080000040407040007000205000800000705040300030006070700000700000306020701
10305062566222258720607085828020805857647336207088603750704020524722225370403570201
10400030006000000000506000000030300000000000407000008000805050000000003000800000401
10774840505020673735403275526472882234235840448638565060504074426342506063237472701
10000000300070800000600000200000300080000080000000002050708000000000706060006000401
10253532866850706850603420405320805060433073244760805080303266432550303067804050801
10000000000040802000700020005000302040700050000030500020700000008080003000008050001
10672660435650705055343023786080373030208870756032246460802228504070278436434058561
10000070003000207000002000700040700050200000500080000000200000605070000080000040001
10663066807063208585708582402574206620678470804860764663682420504075675030656730601
10006000802000608000400000400000607000600080708000200060000070600070000070000060701
13705820508630208040264330588650207020504048504084575070377580566470607327426054301
10008000700030204060000040000070205020505000504000003030400080005000700000003000001
10308025456040407078204084254060505052604320502022307040606023505073353240408322401
10704020002060006000502000003020008000300060006000302060607080006040000030300000601
10635032206052686860705882248074733520547042348660507040208070432070445072247050341
10008000508050000000608050000030005000500050008040204080705020500060400070008030001
12603820703050604255806080474430207060306735504080304020502060777520805830808072401
10005000602080700000800040000000608040700000005000600050006050006070200000305050001
10854026802040806420344564333654506050563532334778665685343054408070404543806670201
10007000003000200020000000000000600030000000000000000000005000002000500000300000701
11111111111111111111111111111111111111111111111111111111111111111111111111111111111
