11111111111111111111111111111111111111111111111111111111111111111111111111111111111
10000000000000000000000000300000700000000000000000008000000000004000000030000000001
17772020725577646620407548308075804860374833555263707550802446542076302080642630701
10000020008000000040700030007000500050000020000000300000600020006000602000600000701
14303623605040867020242440704870385024236038678750508046757050808870406083706733281
10005000300020400070400000400080200070005000002000203000205000600000803000700000001
10342060522550606230304035668060703442308358807056202040203022275726308860454574301
10002080800020202060007000003030007000808000500040007040007000000000500050000000701
10804020302077808050767236608087456020407060603360452070754038786880227080557780201
10800070607000500040200000008000000020007080700050507080006040007000800050008000201
10544440264230463487505067726688658636257520308470208024308320705020702578428035401
10000080000000200060005000200000400070000000807000500050803000503020600000400060301
10458072306763367070286623407070602080567745702040234420207033603062486320204240601
10002000804000000020600000305040308000607000003040200000600050003000007000500000501
18306850584070637420603620808070308526405055526060307828825470278656402062605454701
10005070000080000040004000302020307060002000400040700000400030200000407000700030001
10575080263226284086862030406070702080678030208854244620507070206220405250267050671
10004030000000006050000070508050005030004050705000000080005000600060300060800020501
10206080882365502040703248503022425030704420307046666045807664504024663080425330501
10600040000070404080602000002000000050700000507000205000208000707040000020400000801
10827345472080508050648070852725664440303457308650408740768050477030853640605472701
10500020004000507040005040000000300060208000600000400070000040002040800080200030001
10602030404338405028608032507420506040405080477276226060537568505050808060263030721
10005040808000208030006000800080802020500040700000007040200040007000806000800080301
10326020503080608020843860452380502050254044804077708060606860464656802340402330201
10200050704050006040000040008000808030002060005000508040206000700000300080400000301
10203460206074264048865075605047502055604620677350708020205073806080803025677655401
10200080506000700060007000403000002000300080000060800060005000008040706000200000001
10388060606380607787605570605034753240258077846022388225743622663040357340305042761
10005000500040503000504080005000000040008000000040007000000080000050800020003060001
16474067236080202050207080245653577038406588207320208070786020335280705840257040601
10005000200020700030406020000000003000406000805000300020003070003000200080406000401
10507243402750366750703047204237278870802030356022768054704080743067844020304635301
10600000004020000030002000400060000000300030002070007070007040800030000030500000201
10643327573080873024684270703080202472637375307080303470382056304680406050575430601
10002000000050605050000000302060500060003070004020700000400040002000606070005000801
10208083288540206030603344305060633670203080848030658423606050543060603740202050701
10403070000080607000700070503040000000500070000070000030007070000070800080802060401
10202070425070308072482040204020867458668453578235663020388558486040555080606040501
10300030700030007000803000602050000000000000000000004020000080008020800040800040401
10728664306085267730404023705020236877787835637670308052867020407260205642455240701
10005000006000007000405000607050000000000000000050308000006000400050405000000060401
10608083878568703077402460707026207877542227773040606572308073774080305344736060501
10200070000040008000003070707000400000000000005050500000605000300060300000002020501
10877360482020838037302050807780447073454027302022586530604620404820234233406023301
10600000600020002000606000600050004000006000705030000030300080500040008030003000601
10565362804068403640387272746346704235605080407030487020243080604074206080886620801
10000000607000407000200070000030002000004080405050800060002080702000605030000070201
10706260807520806035206060406060405645528430704080305875606020346040706060375070801
10304000607000507060002000207000606000000040502000707000603060006050500020300070201
10642063507026605870682385374566562047836080706025407060506054508040856030403480301
10005080003020008000300000000000008050008040603000403040006040803020005080400000401
10203080244520535043402033323424808550206046502686608024873080202482504020667575201
10308000800000500040008000000000800000607000008000007040006020003000005070000000801
10707666602343503270703564435758858587404055643024456020204072437038782326257250701
10402000200000403000500000300000000060508030008070006000706040000020000000006020301
10707080436750404088547450506543643020505640407330408666828080426472753423805030501
10700070006000200080002000406000008030300070800080708000200070000000500000004000701
10803658208074857323704027507066702030604060525070606040702067623550306058827626301
10800000806000000000004080006080603000505030300060406060003000000060502000000040001
10527365203023686465355780308060707562206070306830204032252275742070603056668060881
10000040003080000030000000608080300050507000200000403000005000000060002000300070001
10685070744360604080547447607050834020204066273853804845708863755428843060802348301
10005020000000808000600070005080800060008080000030400000600030000000007050300020601
10202060354273802363206050205070406366726330567040754630304070306868808360803060401
10502050000000300000003080708030505000000000608040000000503070707000004000608000301
10202030385584424087838340453080402055472346503076834767307070802060668058838734601
10307080004000006040000070600080306000000000002000600000005020508050006000006000201
17208058466060702660658073503050305045548220375050702672563040402026408332705070401
10008000000020600000602000805030604000600020003040600030000030207000303000300030401
10745226504560766773306020508450406070375047403380532060354850208870623056458040301
10600000500080000000008030704000804050007000406000400050800000200050003000008050801
10854370354056644723858220806045203065202830802055845640306036337027507422304230801
10000040002000000000000020208000008000200020403040000060004000004000400000500000601
10654056206045785758543060204663852652872060705048774027475068707750283880637320201
10005000005000004070008050004000005000007000402000300030004000306060005000500070501
18802023323360603020203046284060503040204484505020806080603730306058667023504062401
10004000700050200060800040000050600060800000805040203040306000700050007000008040001
10652020857040522550466850305320685420503833402220207740505422577450208458344060621
10008050000080300020000000200080503000400030006000500000500000000000600000000060001
17605082287560866088884467846280703064472060536086882347226328543672232554787522701
10007000000020000030000000000000300060000030007000000000000000000000000000000000001
11111111111111111111111111111111111111111111111111111111111111111111111111111111111
