11111111111111111111111111111111111111111111111111111111111111111111111111111111111
10000000000000000000000000600000600000000000000000008000000000005000000070000000001
12677020834473545230404727308022506720838223358246206660803658575083207080466280601
10000040007000000070300020005000200070000030000000200000600050002000607000400000601
16705883806070278030638230502750884082868026828440502068758040403430508026404857421
10007000700050600040600000700060300070002000005000603000602000500000506000700000001
10222040542260306570705063355030703885303444606083207060606062636243403360372772601
10007070800040304060006000008030007000702000600060005040005000000000800060000000501
10308070202078604020463782408058756050502060205270766020733068482280464060675840601
10200030508000500030800000005000000030008020400040302020002080005000600020007000301
10767530746380762882603073736337865573454540306230803076604280708060703228243064601
10000060000000200070006000800000200050000000304000800050803000807020800000700020601
10752033207756843070265434203080305020536685602060582250805037702058536680806350601
10007000304000000070200000608020603000705000004040300000300020006000008000700000201
18802250775080632340206560803040202583304027746050708828487580344487707024704575501
10004050000050000070007000802070204030003000200020800000400060400000304000300070001
10363020423762726032545060202050702020367080503572462230304080307340202270625050441
10004060000000004020000070505080005030003030302000000080002000300020700060700030201
10704040847432802080404863204073738020206270608077762067606282606076335050554250801
10400030000030502060503000008000000060600000806000208000203000804060000040700000601
10485287625060706080663080766632858440208865505360405240658060378030758370206765201
10800030005000505080005070000000500070507000800000800030000050006030700070400020001
10203080206444607057407077304720602020303060686447777060244232404020807020623040871
10008040308000704070008000600030402040700050600000002050700050004000804000600040801
10587020207060705050842230223330607070662035604065405070802670584844205420205560301
10200040302030005040000080006000203070007050006000704060508000500000500030300000801
10703850308034354063734042302068804085208250776240703020602083603060603073732444301
10700050204000300060003000704000008000400050000040700060005000008040603000200000001
10577020708780703325303380708028782420673076274046868686342522845050622320505025351
10005000400050507000805070007000000080005000000060002000000080000040400020008020001
12678036238080404040805060247357357072303244405540708040746030767480705450288050801
10006000300050500020205050000000003000705000507000800060004050004000400080605000601
10403677707660253850507055602636378730503040836038267048603070478077555070502775201
10600000003080000060008000600080000000600070007080007070006040800080000020700000601
10824386426080586064526560304070802373653586804020403520726072605820403020262220301
10004000000050507040000000608040600080007040008020500000600060005000205040002000701
10502087344350304050207862605080476770808050534070466528607040758080307240606060401
10306020000030802000600080603050000000600050000080000080006070000020600070402050201
10604070286030404068763080705040435272864874258264774060365267276040862070202070701
10500050800070003000606000206030000000000000000000005080000060003070300040800080701
10346553708044322760705087502040278338225766584660204087845060403540703648624720301
10005000003000005000804000706030000000000000000020807000005000800070202000000020801
10604026732642508044804870205026706257467724785030504244205085284020705675887020501
10200080000080008000003030405000700000000000005030800000708000200040700000005030201
10423530225080783062802020403330827076533064308044846620402680602360246386807077201
10300000400020004000703000200070003000004000203060000060500070200030003050002000201
10847628207027607420628338348622805634506020502020688070535080406068707030663250801
10000000303000407000700040000050002000007080806030700070008060307000703060000080701
10308580204470707086305040504050803564464330607070802785404080582070302060323080401
10502000706000203040006000302000607000000060207000708000703040003070400060500050801
10523046604076706420638674838754846073366050202052504080606054302080426020605540601
10008030002080004000400000000000005080005020303000407040003070306080004070700000401
10705060453730263045208077584357604640302046505283507086888080407455502030567344401
10405000400000500070006000000000500000404000007000004030007050008000008030000000701
10504788407378303770408764744453226885305057684052287030302087765078824326838570701
10407000600000706000500000400000000070207080006020007000405050000020000000003020601
10407050372830406086562870503677377020204670302250804365865070574355752254206070301
10800030002000400060007000807000002050500030300050805000500020000000400000004000401
10707274206055634745705044508083205080208070674070204040706048846560502063278434701
10700000706000000000002020004040604000707070700060803060005000000040502000000020001
10433236705064242334324770507080606576708060304440807053562348827080502025325030821
10000050002050000070000000703030500020507000400000502000006000000020008000400070001
10337050344450705020233835805030628020707083783553305454705737544222637060705275201
10008020000000603000200080005060300030008030000080600000800050000000005020500070401
10202030434588705487806040403060605782683670466020574660405080807533307740207050401
10404040000000700000003060208040702000000000307040000000706080602000005000406000301
10402070855827666057825420658070203076254245702024888684603070807050272045334874601
10505080005000002050000040600020404000000000002000300000004080404050004000004000301
16202044867030407620625043803020404025773720764070603286426020803046807568707030501
10002000000080500000505000406040206000700080005070300060000030708000807000300070401
10272733504740788386803060802550204020357078203330574030567620507370388052836070301
10300000800020000000007050302000208060002000802000400080400000700030004000004070801
10577350685036382282336840603024204052608780508024483750605085364088603552203580801
10000060008000000000000080304000007000800040403050000080002000003000600000300000801
10658063304066648485538080704542563872325030504056653032555058804570327560488370601
10006000005000005050007080008000002000004000704000800060004000305070007000700070801
18202055442470407020208073548080504040507472603070602080307740603056523042606047201
10004000600080800070400070000080200080700000604060206080807000800030006000002080001
10587060454070674550657260508350366780405562407380408770407466874570507663446080831
10002040000050300050000000400080203000200080007000200000400000000000700000000080001
18508058787630872084828266628780803086522030256037572355774527466678384564427283801
10005000000040000020000000000000200080000060004000000000000000000000000000000000001
11111111111111111111111111111111111111111111111111111111111111111111111111111111111
