11111111111111111111111111111111111111111111111111111111111111111111111111111111111
10000000000000000000000000300000200000000000000000004000000000007000000050000000001
14864070838474234650508473407053306670376763333287806380205754683045705060345360801
10000060008000000070200050007000800070000020000000500000500050004000808000800000201
12205675404030774030544480606230768085286085537820306037834040303380302047502835271
10004000600020500060600000600030400080003000005000603000403000800000306000200000001
10254020365350604220805078378030502247408446406072302060208045223777403850863834601
10004070400060304080004000008020002000206000600030006020004000000000500020000000801
10607060803036804040858554602058564030607050803480827080877072452250466050857350201
10400080803000600030600000008000000050003060200030504070006050005000600030002000501
10736880534330757775807076455862857247662750207720308025407430804070202255465073501
10000030000000500080005000500000300070000000408000700040302000704020800000800050601
10832034808633778070757724507080205080882832306080738470605074403056835530207730301
10004000702000000070800000802020308000605000003040700000600080004000005000700000601
13806740752020458450802670507040805574604022882050403232357430244358702038608578601
10003070000020000060004000507070704070006000700070600000700030700000502000500050001
10748020673733458032376070705030605060572060205558464220202060602850607420832060831
10007080000000002040000070606020006040004040807000000020005000400040700020500060801
10204040236245503080304834704087352030305440608028358058502345708078352080658870601
10700080000050404060603000008000000050500000404000202000602000206060000050200000501
10363254822070402060883040342678432670708442306570304770622080566080577880705583501
10800060008000302070004050000000300070806000400000200060000050007080300080300020001
10802030703423802032508044502420307040708030835636726040648546708080603060588020451
10007030308000602070004000700080602070200050300000008020300080004000403000400070501
10346060803060808030837870664630807020875068503023804040807820888257707650605330801
10700040203070004060000070002000302030005060004000804020606000500000400030700000701
10402240703087466064668075204083608033606520558570807020208063803070508063625384601
10700050807000700030005000207000008000800040000030600080006000005060506000400000001
10845050807650803426807680603036374850372042634054345622686854278060366470302066641
10006000200060304000307070008000000030006000000080005000000070000030700030002030001
12437077446020203080203080743843562027205845604770705060558080676530404880588020201
10007000500070300060206030000000002000304000305000700040004070005000300070802000401
10504278407540447470404062204655857370805050578024838084207040677038282020808267201
10700000006070000030006000500030000000600050008070003040005030500070000080500000701
10882745886060374054628630306070403745668242305040805520233077804720608080745270701
10006000000040206040000000307060700030003040003070200000200070003000502020004000801
10502068445270308040608788404020852820805080838050586285402070374050605260202070401
10703020000070704000800080707020000000500060000050000050008030000080400030204080801
10606050477040406036458070506080362547426244724722356080675844575040873070804020601
10400060600040002000504000602020000000000000000000003050000020008040500020400080401
10852288305034268640708085308070437763383572574630705028338040705860507384428820701
10007000002000005000704000202020000000000000000050808000006000800020406000000040401
10505087885533308044606520607037507452363445482030307226405026368050406472484020201
10800020000070007000004020705000400000000000006040300000405000800050200000004080501
10728440268080572075202060802440878035244052805067344720303770407440436744504025501
10400000400060008000308000300080002000006000204020000070600080300040008070007000301
10248353504022804450326377374738602333804060502060522050247070705057204050287730701
10000000604000202000200020000050004000006040402020800040005030703000808080000060501
10502670405550402086307070204020304338523820603070403485605020323080304040343020701
10706000808000503040004000303000705000000050807000408000402040002080800060600040201
10345084308088302280688247233732433062683030605058702040408036205050834080208460301
10006030003080002000500000000000006080008080803000706070003060704070006030600000801
10408080367230325034304043772565202760805062305564303065234040205255803040333353401
10403000800000200080004000000000700000707000003000004080006040005000002020000000401
10407727708474407260405732654552658773703085284054384040308044622055845535885240301
10506000800000502000600000800000000070807080005070008000608040000060000000003040501
10505050685760204034427470606755857020702850204440303782522020464533484674302020601
10700060006000600060004000603000008070500050600040506000200070000000200000007000301
10507274507075874647503075507043404060704060568030202070605078272460602088548765501
10300000307000000000006050008020307000804050500050804050008000000020805000000080001
10455658607078623457837580205020207464204030806240207026428875435030306054768050771
10000030005050000020000000208040500020405000200000808000007000000020002000500050001
10786070535460508030635627205050688030202054257367206452808472626743728060302467801
10005070000000507000600020008060300060005020000070500000400020000000002070300040801
10503060522742707476604060704030304787388880537070736230507040606572804750202040301
10504040000000700000005050602050605000000000607060000000302040708000002000704000201
10303070752683576046324850853020305065647573507038228544307020308050778046746626501
10706030005000002070000030800020408000000000002000600000003070207040007000006000301
14403053586050204820632036302040708045727530432070603346848070303052406342302050301
10002000000030700000807000206030805000300040005050500080000080306000403000600080501
10258732703470337778703080206730505060433046603250655040723550602580725057748070501
10300000600080000000004040305000802060004000502000300070700000800030007000007020201
10236660458086336868834880302076306038204350508062432540804084287044302548308880601
10000070003000000000000020405000008000600020403050000030003000007000200000700000601
10722082604057372265578060806455625268482020207067682038546088604670862730362380301
10007000004000007080007080005000008000006000607000700080003000605080003000700080501
17803082775740405020305083437080203080604682308080702030402480508066443064205074201
10006000200040300040300020000070600070700000205040506020602000800080007000004050001
10573030657030647880358680208860733260502226502650604260303722576320608544746040721
10005040000030500040000000400060405000800020004000700000800000000000300000000050001
16808073356480646032274542288570507088844070222075445285568278523455264446583683401
10002000000060000030000000000000200030000080006000000000000000000000000000000000001
11111111111111111111111111111111111111111111111111111111111111111111111111111111111
