11111111111111111111111111111111111111111111111111111111111111111111111111111111111
10000000000000000000000000200000700000000000000000007000000000005000000030000000001
15865060882428646880203656608088405780485667388535407440804766764065607040486450401
10000030002000000060800040008000700060000080000000200000800070006000206000700000301
18204868405070524070227740407640745045544033384230405085825050203420805047802387571
10005000200020700030800000300040200030006000004000202000208000400000604000600000001
10263050273680703740502034677030207887207647806038705030804076646674308880677432501
10004060300070406020008000004070004000703000200030003020006000000000400020000000301
10806070707027205050772854503042583070306020805680324020475056784660587040423680201
10800080403000400080700000005000000040004030500050607040002060005000800080004000301
10827530882420353347207076548286366538648530303320604022603470406080703827368085801
10000050000000300030003000800000600080000000602000500040308000806020300000600080301
10588076704655752020772778502040407050377245302040882870806065704074242320505870201
10008000808000000040600000708030208000603000008070400000800020007000006000500000301
13803320288080226870306650803050506662208038225060406343476470438852404027706787701
10004030000060000080002000303030403080004000300050200000300050500000508000600020001
10752060586655666048545040805060803080762040607748555550303040802380802760272070831
10002050000000005020000060605020008080004040607000000040005000700050600040200080601
10604050724527202050303838603048866020406860305088476063205438508043445040252650701
10700040000050802030803000003000000060700000507000605000803000303060000060700000701
10866528754040606040488060778424457630703848408240406730347080663040828760207423301
10200080005000307030006080000000400080804000600000300050000080008070200060200060001
10307060705784304024206058504250302040803030775462452040262768305030308020533080251
10008080604000208060003000300030203040600030200000005040500040002000407000800060201
10277040708050306050364440524520802060254075402065207040602520544833402630202820201
10500070707020003070000070008000804080003020003000606040704000800000200050600000301
10405470605043343082827036302023806044702340757720604080406024408030604023373637301
10800020802000800080004000204000006000200020000020200030002000007030606000800000001
10563040306270605658805230407086844750574056873067447257768348478070544880706063341
10002000400020408000405050005000000020006000000020004000000080000080300030007030001
17548048738040707050602030428738438088706853706870506020276030778570802670755050501
10007000600050600040205050000000004000305000402000800030005040007000300040702000301
10402585305880468770408038608434483320402030533046884082704080732055478030705666601
10500000005070000050005000600080000000800050005060003070008050800070000040300000401
10738522684040748033637360504060305778487855804060706680775045707270208060657420301
10004000000030305080000000703020600060007070002070200000600070004000803030005000401
10702025524520303020802568706050738420707070463080585658703070636070405360703040501
10804020000050408000400060404080000000300080000060000080004040000020200050806080301
10604050655070207045788020505020776368462378485376578060582334554070277060607030401
10200040300050002000405000702020000000000000000000002020000070004060400020800080501
10248785706084826230605024305060358486662564224330806048735020703760707833543630701
10005000008000004000808000306050000000000000000070807000006000800030203000000070601
10805043475323207082605260204023302776564547867070406466305073345020805822582050501
10600070000020003000003040503000700000000000006080800000306000800070800000005030601
10347480275020445063707030703330878065258044606043265680408570203320363756408074601
10500000400030003000807000800030007000003000403050000060600020300040006020005000301
10653224706074804620755253525748802885604060605050376060227080707085503040344370201
10000000306000606000600060000030003000006080503080400030006040403000607060000070501
10702830706820305055708050404070302563627680807080504373703020643060808050357020601
10502000803000308060002000203000305000000040307000608000404050002020600070400030601
10773074702038304680252625576226326082855050408027604080406067508070834030604440501
10004070004040002000200000000000005050002070308000808040002040702050006040800000501
10607070623330737044608084277248802250302077607737404082685050203585706070462227301
10604000400000500030005000000000500000308000007000003030002020006000004070000000301
10704426604364505340208338575527856776802078286033625020803033848086575457742730301
10603000200000304000200000400000000080508050005050007000803020000050000000004060701
10704060248720803088776660303528562040505570505630404234836020635838874632603050601
10300060003000800060007000803000005060800040300070802000600080000000300000002000601
10405322704026644457604056303052407050302070325080804030803063465260302077255583801
10400000203000000000002070006050704000705060600070402040008000000050606000000070001
10447437308024752224283840702080408566208040708250707056278357535060302056586050731
10000030003050000060000000206070600060808000500000704000003000000030005000500030001
10286060268640308080288333205020736040406057436273602222203756533647624070405253401
10006070000000706000700050007020600030005080000080200000600050000000004060500030501
10705060755364303368205020502040605432427280222080342220502080708448804220604070501
10308040000000200000008040802040805000000000506050000000303080302000008000305000501
10203050648446622047646770646050505044458253805088825284808040806030538044673767601
10804050007000002050000080500070603000000000002000400000005070704050002000006000501
17502047626050607670223067703030302067354670353030703754254060505048506883702070801
10007000000030700000303000608070408000400080007070300040000040305000304000700060201
10428242408450487665204020803270406080387058807580655050463780204320744035738040601
10200000600030000000002080702000408040006000202000400040200000600080003000006070601
10887370645083555873548720503062803055207340302045574730303023378053603822206380701
10000040002000000000000050703000007000300060306060000060002000004000600000400000701
10868028405077348272757080205563747357282040806072268074248038807270656470537270301
10004000002000007030008080003000008000005000607000800050008000304030005000300060201
14503086726540406040304055874070603050503872305040305040305880506045233054805088601
10008000400040500040600060000020700070300000708040504030506000500040006000007030001
10584040333060728850582460806640575760602322808680306680607648638670304886866060621
10002060000060800040000000800080807000700080003000400000600000000000800000000040001
16204028322540224062578335862540506078575070272068472764466644687282442534774456301
10007000000050000070000000000000300020000030007000000000000000000000000000000000001
11111111111111111111111111111111111111111111111111111111111111111111111111111111111
