11111111111111111111111111111111111111111111111111111111111111111111111111111111111
10000000000000000000000000500000500000000000000000004000000000005000000050000000001
12367030372333265840503868502044807460678872525485805860703837563026203030322670201
10000030008000000050200050002000400080000050000000500000200070008000802000700000201
18306385305020732030657240505860333043877064463450508086553080504740708052605424631
10003000300020800020400000700050800080002000004000205000403000600000705000600000001
10543050666820306860206024655040408552705248206043602060703036685778303280863245201
10004040400020306030005000007060003000808000600080008050006000000000800080000000601
10205070208043205080663855604065487060202050703680647030835046482730878050464440201
10200040205000600020800000003000000030004080700040502030005080002000400040007000401
10523230278570648247202034374222452544383740306340304076605460506070505677677046201
10000070000000300070003000800000200030000000205000200080705000802060300000800040501
10265052503356285020524468403040407020272487603060762230208045602062238540205280501
10007000802000000070300000802050308000706000008060800000400070004000005000700000701
14505250676030757480807480803050707232805057253040503288382470328554607062503327701
10004060000030000080004000806020206040004000500060800000300020400000608000600050001
10545070373385524033265080207080405070784030505484356460805060506560504530684050241
10003040000000005030000040204070004030005040203000000070007000400050200080700020201
10807070447233407060507343303025876040607450802075638063704726306055226060362340601
10700060000080506070507000003000000060800000602000206000203000408050000070800000801
10646532638050505070567040223762553570702744806740402470477050647040838720403833601
10600020006000303060005070000000400070605000600000800030000030005030500020600070001
10507050408527203023504065308480207020807070674444885070825663808040607080535030261
10005060408000703080007000700080502080300080600000007050700040005000504000200080601
10847060207030305050448360248560502030337076705058607050604880545258206360805350601
10300080608050008080000080003000508020008030002000803030605000200000600030600000701
10505830706055574075862083608054605055302440658480305050406082208050303082645375501
10400040606000800070003000205000006000800060000020200040006000007060204000500000001
10527030503640603327308670404028437640885086886032483226757344284060475880605068371
10005000300080404000408060005000000020002000000030008000000060000040300050002020001
13774086325080308020702040662436386024203634807520203050833070246480408320788050701
10005000800050300050806040000000006000702000506000400030006040003000200070202000701
10508676804530355420602083203637853350507070685046286037408070462082684070707752701
10700000008040000020002000500070000000400070007050007040006050300070000030600000801
10246326447050435043863360704020603457654265405050503520853074202630805070733380701
10007000000060608080000000708080400030008020004040500000400070006000506070004000701
10808057645250308060202278302080565650508020722020864528702050855040403420407030401
10306070000070306000700060607040000000200080000040000080007040000030300060507050301
10606080338070302086255080503040427568454857632775832030443464426070726030703070201
10700040400040005000805000803020000000000000000000002040000020004020700060300050801
10554348604027787740208073207050784325432882646740703046448050505450508847475260301
10004000006000005000506000507030000000000000000050803000007000500060503000000030201
10406082233376208044308820503075705575753246623060202622403065568030805457586030501
10500020000070008000007040204000700000000000004060600000802000800040200000003080801
10383420452060448077408050706670768055682083202022225730407880504280846852403076701
10200000500030003000208000700070002000002000404030000060500040600060006040005000201
10574342605035402820228545643422702645604070308060864020748060503036703080568220601
10000000803000203000400070000080004000004070603040500030003050803000508050000040801
10306420507850407057808040202020308747463540503070202375403050567040704020377030801
10203000605000505080002000408000805000000030702000504000802040006080200080700050401
10822074405063406630734685482836348032288060706057705040406042608030684050302670601
10005070007070006000500000000000007030005020408000704060007050805020003030400000401
10805050882650838037406033282424708620404085208663205073664040406854706020585367801
10203000300000500040008000000000600000408000008000002060006030007000002080000000401
10807482302868706370202835738746283444204067283088656030702043635035548463854530601
10303000600000804000500000600000000080303050005080002000305080000080000000005060401
10702080545720806022724670505687474040603250802730804728338070677652342483706020701
10600080007000400060008000408000002030200020800080302000200050000000800000008000601
10402466602027486465207038807054605080705020624050604070602042463780507037432584701
10700000402000000000007060006020203000506030700030803080002000000020403000000050001
10487658608086646675346440202070402236402060707440408074767565483050507073883030381
10000040005030000080000000503020500070505000200000505000004000000070003000400080001
10663060388560202020223636703030844060306045785777708237508587736348736050806827301
10005040000000507000400080003040700040005040000080800000500060000000003050700060701
10306020643863808333604080208080604582786830786080327460603080203475203740706030501
10804050000000200000004030704050704000000000605050000000303080503000004000608000701
10502040873338275024642740332030503046667635606038572222403080306050842075764622601
10207040007000005060000070300030505000000000004000600000007070302030007000006000801
13608023357060503470488058306040708064357740283030807723748070607022406553502020401
10005000000030300000805000806060208000700030008060200060000040803000705000500040301
10754472807450874775403020603720507060456037602280235020583540205730482042532040701
10800000800050000000006050507000804070007000408000400030200000500040003000004020501
10485630222067752344875520706032205043505440505024433630606072564078306554708320401
10000020003000000000000060302000006000400080408040000030003000006000800000800000301
10432067308063354668437070504742742853528050702068363027833058804450675860884540501
10008000004000003050002060006000005000004000306000300080005000702080007000200060701
17206047837270805080304035852080606080203342803050407050506840807046848087308085801
10005000200050400050200030000030600040800000708060602040207000800020005000003040001
10458080287080562640847620604480487830208226204820707370205626774870607575483080371
10003050000070400060000000600080705000700020007000800000200000000000200000000060001
14404033443560256022344272325350506022472050736087664322342868436283884777277875701
10002000000030000060000000000000700020000060004000000000000000000000000000000000001
11111111111111111111111111111111111111111111111111111111111111111111111111111111111
