11111111111111111111111111111111111111111111111111111111111111111111111111111111111
10000000000000000000000000700000700000000000000000002000000000004000000060000000001
15323030728864454560704585802088806580862787567635703370604257247046404060236370201
10000080007000000080300080003000300050000070000000300000400050005000702000600000701
15603744405060244080242380705580744074762083466260306022845080603670707065205456451
10006000600060500050500000500040800030006000006000308000703000600000504000600000001
10447050258560306240806067646070307225607584502053408050404025568645202240376757201
10005070800020202020006000003060002000402000400070004050005000000000500040000000501
10705070203025202030322885706083346040304050502650556040275035568250576020587320301
10800080605000800050400000008000000040002030400040408030007070004000400040005000801
10787830587860323383607083548342873458342440702370303056504470706050403666436063501
10000040000000700060008000600000300060000000306000700080303000304060800000300040501
10676066502676833030556263808070802060462882502050434640807077506028476730206420501
10007000204000000070600000803040207000302000003020200000600050002000003000800000401
13606870358080657420506670503060606732706063334080302477776420288838308053808775601
10004030000020000060008000804030804080006000700040500000300030800000807000700070001
10234070227784356022734060406060605040883030305855668440203080606750506630238060851
10005030000000002020000060303050008060005030506000000020005000300080800050600020801
10304040755246602080408323307077342020306530207028848083402482404026522050258740301
10300050000080407030308000008000000070500000703000504000507000408070000020600000601
10555282453020203050785020484366522230408883204530405750467020636030547380202838401
10800030007000805080008060000000200030804000500000800030000030007050400060500020001
10208030805355606055503086508750306080504020335426747030767675405050503070474020351
10007080804000403050006000300060203060600030400000006060800070003000203000800070601
10845020704040708060632620362870704020358024405067508070505430852737305850807760601
10600050503030005020000070007000703020008050003000506060402000200000200030200000201
10408630702026438065445072508033407055804350772830506080306082207050703063338244201
10400080802000600060003000507000006000700080000050800050004000006070607000800000001
10587080305840307575503380508078254420486086286077765586465388474030558520805067551
10008000800080407000405040007000000060007000000060007000000030000060800040003030001
13625078525040507050305060238456627055502383506830802080434040383870603860483030501
10006000600080300030604070000000007000203000305000600060003080006000700030808000401
10606463604780664380408033403274752250604030323042545045702060387065866060703323701
10700000006030000030006000300060000000800020007060003080003060600080000080300000201
10885687542080684067368330206040604636536568702040305560836082707680307080857580601
10005000000030304070000000707070700030002030005070600000800040002000804040008000301
10602055443470702080208236205020865560507050783020833337807050422040308270405030201
10805060000020208000600060306060000000700050000050000040002080000030200070602080801
10307050578070402075883060306040436576322756364382234050266728874050343060405080401
10300050600040006000206000702080000000000000000000003080000070002030500030500080201
10267353806073258220608026304030322547257746456680605086422070302750507644275280301
10003000003000005000207000307040000000000000000030708000007000400060304000000050501
10207062246835405082504340806077706376477884484020302837308085235060205388262030401
10300080000060005000002030204000200000000000006050700000707000700020400000003040201
10322550234020524056407040408380347048484054602027237640606630603460376558608074301
10500000500080003000803000300060003000006000207050000070700050700020004080008000301
10286557306044408420827343282473608725306080605020563020475020808054807060768520301
10000000605000804000500040000030008000005060502060700080003030608000308040000030401
10803230508470706086405020605060805833578780205020406583406070742050804040433080801
10707000207000506020004000604000803000000080505000703000403040008060500040600080601
10887065506086507770883687485522262073362050406056206050605033408040855080407220801
10008080003050008000500000000000002030006050505000708060004040305040005020800000801
10406060646380545067803034522552306330304047404364604046482030807542807030588723801
10408000500000700060004000000000400000608000002000002040007060002000002080000000501
10506327802867704660203873647675826454606032455045752030204032485067225533735780301
10606000700000608000200000500000000060606060007080002000305020000040000000006080301
10805080737320302042624340608827553040806820205620407276687050238367537775302070501
10700050002000300040005000604000007060700040600080207000800030000000300000007000601
10306834602034542578308075807077707020308080665040603070404045388250605036747453601
10500000304000000000003060006070506000603070400020308030003000000050206000000040001
10784646305024547657546340708060706472203050704370508044567887774040705025284020831
10000040008080000020000000604030800060406000200000606000003000000050006000300060001
10884050845550205070844483703070347070504034744835702327608755382677633040703287501
10008060000000604000700060005050400060004060000040200000300040000000008030400070701
10605080732566705444207060308030408725648870477040666240405050605764702840603060401
10607070000000600000002020207030704000000000306020000000207060305000007000206000201
10706060878688544075738240872020306064777858703036224282204040606080752025868663301
10607030006000007080000070700050204000000000002000200000002080802020003000006000301
14808072864050802330864056504040204065287560653050208463382020506074404733602040501
10008000000030500000603000706070805000700080002030300030000080308000306000700060601
10756553207880238386806030505540306070362082305850768080534230604440333058625070801
10800000300020000000006070503000607030008000707000800020400000200060003000006040701
10735840773063644575873440706088506036305460305052426480802084263025804685203220701
10000020003000000000000050202000003000200040702020000070005000004000200000400000601
10787066602074657386443030404554525757462070603067326086755022804640228680248520601
10006000007000002030004050004000002000006000304000700080007000803040002000500070401
16504036273220207050405073556040402040204786807050808070303320306052627065207078401
10005000600050700020700070000060800080600000608060707080702000500070005000006080001
10822020232040323560756530504620642630802372505880608720407577278720702844435020321
10006020000080500050000000800040608000200030007000600000400000000000300000000070001
18707067683270454052348478525570703066348020242046264455283447635752324422685553201
10005000000040000060000000000000600020000060005000000000000000000000000000000000001
11111111111111111111111111111111111111111111111111111111111111111111111111111111111
