11111111111111111111111111111111111111111111111111111111111111111111111111111111111
10000000000000000000000000800000400000000000000000008000000000006000000040000000001
18568070732724258630805432802032703420326654572557406670507624246075203040385340201
10000060005000000070400040004000700040000050000000700000200020005000804000500000801
18806456503030784080378320707380764044556054255620406024735040608330508037408737861
10006000200070700070800000600020600070003000003000205000804000800000505000400000001
10626060555570402560608055853040207364507276308028202060803053473687807280747752401
10008040800050508030008000008040007000505000300020007050006000000000400030000000601
10805080206058602080787827502023775030404020503280883080776054543620846070638440401
10400080207000800050500000002000000030004060300040607080002050006000500050002000701
10462880322650884852604068624282637227362480404880205078707570506070804575472087501
10000080000000800040002000200000200020000000402000300040404000804040700000700050201
10534057707744335070377663608040704070582235608070254260808038308043788880607230301
10002000705000000020400000305040304000408000006070500000400040006000007000800000801
17603880752040263770703460305030808467506076638070402467773680435785305038203464201
10007030000080000070003000208050802020008000500070600000400020400000202000600030001
10544040785743833052443080206040603030485050407648274740606030202680602240246060321
10006040000000004040000080304020005080004080204000000050003000800060400080500020201
10208020327588704020702326408065446060208240702074482046605375602042362050262420801
10500040000050404040508000003000000060400000405000803000504000403030000070300000601
10873747672040307060283050226524855570705658405360706740733050572080868670403455701
10700040006000707030005070000000200050304000600000400070000050002080300040700050001
10503080602523708045706045407530604030806060265257533030876355506080606070643030641
10007070603000604070006000800050205070600080400000008050700040008000508000300020201
10333070502030403080727370432640307050662046705024206060207380558452807530405760301
10700020705050005080000040006000204030003050008000604060704000200000600020500000201
10303270504035672035342022406066208084807220422670504060503054202050702073253862201
10800030806000700070007000202000002000800050000070200040002000005060507000400000001
10874040308680405367306260808047748240683065547048782332637383354080546750202065341
10003000700060806000603030003000000060008000000080003000000020000080600060008070001
12788083864080708040805020663353226067505223805620506050887080826630506460763020201
10007000400020200040708060000000003000807000608000400080003080007000200050706000301
10707872605870463330702085506658385340706080554047863052705030256042682060508845401
10300000008030000030008000600050000000400020002020002080004050300020000070500000401
10545444832070857027537870205020505328253782805060605540788086707660804080755680501
10007000000040504060000000402030300060007060005040600000200040005000806030006000801
10402055284440403080702428304040647870406060664040866568203070285050505880303060301
10305040000020706000500050804040000000700080000020000070005070000050300020508080201
10204070257060302057575060806060444775445464472562266040252732425060758050307050601
10600080400020003000208000606070000000000000000000006030000070005080800040600040701
10427353707047525720705063503080863685623347375730805047726050305680303325328430801
10004000007000004000306000303050000000000000000040203000007000300060807000000020801
10605073327556307076407360204043203735672272488080404432707066486060504745262030501
10200040000030007000005070206000300000000000006060800000803000600050300000002050501
10856720886070682057404060508540624068527073205086883250805730306870546657303047501
10700000400070008000703000800040003000004000705050000070400050700060004050002000501
10224344608033508880533386532256504256706020703070666050754060604037407030536670401
10000000703000706000700060000050003000007060308030500060008080707000808030000020301
10803580303430402027502030302060306342758650707080707366807080463060606060846070701
10403000803000404080004000407000806000000050604000802000705020006050300070800070701
10533074306078407360665856363322634083676070702078702060303065503070575020606770601
10005070005050002000300000000000003060006030404000303060006040503080006060300000301
10504070244380533037504026257322506760802052504467504022838080506772206080263383201
10306000400000600070004000000000500000507000002000005060005040005000006020000000201
10708858705682202670702285638874323222504083275054454050308022576042732753772220801
10808000800000607000700000200000000050708050007070007000503060000050000000003060501
10708050358260705043764250203843882030708280808820406683742080773436878525706020301
10700050006000800080002000707000004020500040500020703000200050000000200000005000701
10707685805075776883402026708054204080303080666040703080803075325760805048428543701
10300000508000000000005050004070806000805070700050307040004000000050706000000070001
10787362603052838427342230405050603585502070607360807064878656665030706023742040821
10000040006020000050000000808020700060403000300000305000003000000030002000400050001
10826060772530805020643384705030543040208088557676707234605426328433824080602624501
10006080000000406000600030008030700080008070000080800000700060000000004030700040701
10602060883374203625606080307050502587474280257080685350606060702273606550603040601
10308080000000400000002020708070606000000000302050000000403040708000002000808000401
10807040636447476062388760355060508048827522402026667835506020702050675044478573801
10306020006000008060000020800060702000000000002000300000007070405060006000006000301
18308022666080602350333074707020702058474260227030406763366080702074603566307080601
10004000000070200000704000302060404000300070004050300050000030804000208000300050601
10555867803230542852503040402520308040647065308470672040278630602620237063323060501
10600000700080000000003060408000203040008000507000600070300000600050007000005020701
10382340846028578438285660806075403085307480302072436840503023735024208776203260401
10000060002000000000000020403000005000200030503080000070008000003000800000300000801
10576085304063438236342050605643764367732030805085226025833053304830362870572570301
10008000003000008070002050002000008000007000804000300040004000406040004000300020501
15305073587430405020807058662080603030506887704060704030603220605025784028504032501
10003000400080200080400020000030500050500000302080206050502000200060008000004030001
10324070623020364250587480607750344460203564805230407350203844752240503546357050831
10007060000070200080000000300030402000400040006000500000700000000000700000000080001
14503085248650287054564545226250708087255030884068458773675877734486525857474337501
10007000000080000060000000000000600030000070002000000000000000000000000000000000001
11111111111111111111111111111111111111111111111111111111111111111111111111111111111
