11111111111111111111111111111111111111111111111111111111111111111111111111111111111
10000000000000000000000000500000600000000000000000006000000000003000000080000000001
12243080883732765560205425204038608670887443332724207640707664645025804070837820801
10000060006000000020200020002000200020000030000000200000800070002000505000200000801
15702756608070254070262580203540374043855088865750608068647070402550806048705778561
10004000800070500080600000200030300060006000004000408000202000600000307000200000001
10627030242530205330202077825020708883603546506058207050503087873275408540276342501
10007040200030506040008000003020007000707000300040006030008000000000500080000000601
10208060807056403080288246308022362080702060604670458060636087445630474070624840301
10400050304000300020300000007000000020005060400070508050003030003000500020002000701
10557570285280576862407026572768386462378360303350608064205870706040203632377086401
10000080000000500030004000600000400040000000406000200080306000407030300000700050301
10662034802844344080767435603030303060324826506060474680605083308022426880606770501
10007000808000000060400000804060404000306000007080700000500020004000008000500000801
13507430855070767360202240503030306633404084757060605367364880778227406054606446501
10006020000020000060005000708040307030008000400070600000800070400000403000600020001
10777060328684866082286070407060407050342080702776348420402050207220806480775080431
10002070000000006040000060307060003020007070607000000020008000700050800070500060501
10403030854652302030803274605068366040708720606045242043405337606035865070628470601
10500080000070507070405000005000000020400000708000705000307000502050000050800000701
10678633264030807020726050583648255350702865206860402360656060382040845640206683601
10500080002000804050006040000000400080203000200000700030000040003020700080700070001
10307020408478607025805034808330805040603020652423842050537288706080403040782050631
10002080603000805040008000200050806070200080500000003050600060002000204000800060701
10765030806070305070252630387240806050226025804043405060502620873432503570404560301
10300030608060006070000040006000603070008060008000505080206000400000400040600000301
10805630308085535054783066402068802034506630285580604040606054204030505076443844601
10200080403000600030004000404000007000400060000070600040006000008030302000400000001
10552030505530408375406870606063663580883035668088684372467368576050723780304037871
10004000600080503000407070003000000080007000000040002000000030000060800020006080001
13872038567020504020203050746728558076704442807550208020265060653850302220423080801
10002000400080400060503020000000007000307000502000400060003030006000600020502000601
10806264505850243870603026204787466520607080856023622038707040372067623080306865201
10800000005070000030008000600050000000200030008080003060004070800040000040800000601
10565765225020266036457640702030206634722758402050305470466072402520405070338560401
10007000000050502020000000308030600030003040008080200000700060008000606020007000601
10704065753550202030206755302050555820402070756050336274508060742070402480204080701
10708040000070403000400020207030000000600070000070000030002080000050300050305060301
10502050735050802042376020407040238638347786565436724040532576424070448030304060201
10600080500060005000308000304020000000000000000000008030000030004080600020400030201
10732738705055362220806086804060628755652626542350604037482060402420407722566670601
10007000007000004000402000603030000000000000000060304000003000700040408000000020401
10808086546774204085302860606078508824877878637030802868808036434050803526576040501
10700080000050002000007060608000800000000000008080400000608000700040800000006050401
10563250227020872077708040306420852034623024305027753820507720504420374874703034801
10300000800050002000507000600030007000007000507060000040300060500040006040005000601
10736488306028204620337348865778303875806020508030222020732020707064508070443540801
10000000602000806000200040000020002000005050706060500040005040406000603030000080501
10206370506420602038502070502060702862545530304020406857707030886080504050753020801
10307000504000808060002000304000207000000080706000204000207050007060400040500080401
10574032406043803740726573325338586026427070402085506050707065305050885040305370201
10007040004030004000800000000000005080004040703000608040006020303060002030800000801
10404040486740472024705063286537606230707046602845502076373020202783707030765625701
10503000400000300050007000000000200000307000005000002080004080004000002050000000501
10804545606236508340202243477764778755608042887063627060604074425067257887875330301
10305000500000405000400000300000000050507070003070005000702030000020000000008060301
10205030624550806073356430702872743080205880707240708868375050333677347758208030601
10800040008000800050003000802000006060600030500060304000300070000000500000006000601
10507355207065477583503033806032502020707040658020608080602056476670403037223353501
10700000408000000000008080005040506000207070800040206050008000000080805000000050001
10877786508063255387535460808070508576703050706480708083225555384070705046344040581
10000070002060000070000000506060600060706000700000206000006000000060007000500070001
10643070578440203030443338508040386080202033743887708468802763742426483030708475801
10005060000000205000800060007060800040006080000070800000800050000000007050400070501
10506080357462704635706030808060305546725350265030455850405050603436603370206080401
10203030000000600000003070604070304000000000302020000000308020703000005000706000501
10203040237666282065425630636030805028354674607064428634808050405070824074746762601
10808050003000004070000040300060407000000000004000700000004050706020004000002000401
18303085852040803570488052304020607046868580366020308336836030602043502247707080401
10006000000040300000404000806060707000600070003070200080000080405000604000200040801
10384322803420634637404060302280207080766026405630868040536280704550377065782030701
10300000600070000000008030803000605080004000606000700080400000600020008000002080701
10686680482048275465785220202062404044707660604078744530602035336056502283407470301
10000020007000000000000060405000003000300040806070000020003000007000200000600000201
10423028706023546524255070206433476867383020206047757058353038602560667320735270201
10003000005000004070003060007000002000006000408000200030008000305080008000300050601
18308046242730507040203022573020205030702763407080708030206480805078873033506043201
10005000300040500060300080000030300070400000803080502030303000300050008000008050001
10285070676080458730238870608830583740402777608530607360805848834480203374575060341
10008020000030300070000000200080707000700030004000200000200000000000400000000030001
13502082488580847077643478673830502072434040654028765678774883345373726224742542501
10002000000060000030000000000000200040000030004000000000000000000000000000000000001
11111111111111111111111111111111111111111111111111111111111111111111111111111111111
