11111111111111111111111111111111111111111111111111111111111111111111111111111111111
10000000000000000000000000800000300000000000000000007000000000002000000070000000001
13266020723644352550808242402042807260638383442548507340703855266062702070854640501
10000030006000000030200020005000200060000040000000300000700070006000603000800000501
18303454403050452040225760705440866032456063528680406077567030306550302063408868861
10006000400080500030200000800080300050006000006000603000805000600000607000600000001
10572070838620702880607047466040504887208257403035707080207084757576304530764644701
10005070300050605050006000007070005000507000400020005030006000000000600020000000401
10705030303035606050737736303076628080803050508550625060565083637530285060824770501
10300050702000400040800000006000000070007060700040704020002020005000400060003000701
10335520387560574733208053452535735478243460703740604062705570408070205545864068801
10000020000000300050005000300000800060000000708000400050303000606060800000800040201
10466057804278246050363247304060707020784488705040833240306038205068664440206480501
10007000305000000030500000307040404000405000006020500000200060003000005000200000401
18508560784050343340404630303060606627208086474060802263387350753624703052702383501
10003020000050000030007000806080206020004000300070800000200040400000608000800060001
10636030877858883066466020703060704050334080708428322760604040206720208740586040341
10006030000000004060000040505060008070004050407000000040004000600050500050300070201
10305040274842208030203843605043256030805820407035468027808463406077478060843840701
10600080000040403040408000004000000040600000604000707000703000504040000020200000501
10437667287080307050254020676443673650405877702750308880422030682050765830203772301
10800070006000305030008080000000300080808000300000700080000080005080400050700080001
10708020404573508085502076305770702030802060686774434080846833307020707080442080231
10008020407000402050003000600020705020600040600000003050800030006000308000400050601
10666060307050408040385380656780604020526063607063402030404660456422503330204770701
10500040307040005050000030003000403050004020002000402040807000500000800040200000201
10805330206048656052534057208084703055604730573620605080707043406080302027482886701
10500020306000300070003000304000008000400030000040800030002000008040503000600000001
10232020406660506753602470402056583470748067744088447234474457742060262440408036771
10005000200020305000505080005000000050004000000070003000000060000060600070006030001
15542074738080605040604060274366734026605464806250206080672060346670606770322020501
10005000700070200080806020000000008000202000204000500030004080007000500020203000501
10804885802430266530202074207877652320202060854032678034403060225067726060803464601
10700000006040000020007000800020000000600020006060006040005050700050000040400000201
10828758777080382024326770202060307622758684803060703640726053607750308080236550701
10005000000070208050000000803030500080004020006070600000200020007000305030007000701
10604042663470705030505456808040628270503020764030646764508030252030405240606020401
10602020000030805000700050806050000000200050000080000040002040000040400070807050601
10403080422050702082824080705030428783387574726333337080848822287050375080806050201
10500060700070006000305000706070000000000000000000005060000020005050300060200060301
10552664702042748340404082607070364362675574854530504046658030202380307262323780401
10008000002000005000204000802020000000000000000070803000004000400040704000000060401
10206057658847608073507540408053406743873826867020403743805047766040807257353030201
10800020000080007000004070804000300000000000005040600000802000500040400000003080501
10253420428020835024707070705880482077283042402062352570307580602570862222604054801
10500000200080008000205000800050007000005000703080000050300020500070007020002000801
10448557308086602620433656645475606266602070203080355080273060404066205030557230801
10000000307000207000500060000080008000008080306070400040003060507000505050000020401
10802680708260605052607020602050308778648740504030607865702030588070305030654070701
10405000605000202040008000504000804000000070207000208000404050006050700060600060701
10763022404074803230486832743627838086344080507046706060807082803050745040604550401
10004020004070004000300000000000003040006050703000405060006080403040003060800000701
10705040674370244036707076546866604780505083207655806065583070608658608070753844801
10204000700000400070007000000000800000603000005000003020002050006000005070000000401
10302566408448703370805323455545885553505074256046758050803074328087788754667870801
10606000500000705000700000600000000050607060007060004000802050000050000000005040701
10602060476470508048374750305487636070604640608450506372747020285787762724606020701
10200020004000700080004000603000006040600060500050708000700080000000700000007000801
10707328707065646252502022505088207050307060866060205050206073844370508044765684301
10200000403000000000004060004060503000508080700020308050006000000020307000000050001
10557373807088835328734570405050606767606050507330606074747625655080405088375040721
10000080003070000020000000606070600070308000500000506000007000000070002000600070001
10523020832540403040864768605030852050503085388573204878702534573435844060503773301
10005050000000203000400050008060500040007080000050700000200040000000005070700030201
10602080553326508746803030604060403468527670567060223430205070302846705420207080201
10704060000000700000006020506070202000000000706040000000803050503000004000808000201
10403060353446233026275730775040304056736622406068567364207080806030537023765488701
10608070007000004030000060600030808000000000007000700000008080203050007000005000701
18206036485060305730624047403070403056273440355060607453563070503033605742507070701
10004000000040300000208000707080808000500080008070300070000080507000707000700080301
10432354402230253478803050207470303080224028804880682050245350303340774032578080801
10800000200070000000002020706000805080003000307000300060700000600040006000008070401
10387750263045323634723480305032703048606630507044248270502035662046607348807860201
10000080006000000000000070805000006000500070605060000030008000003000300000800000701
10564033508082455422347040502855322236835070608022875022226058206380732570587380301
10002000007000007020008060007000005000008000207000200020008000807050007000600060201
16808073775530702020504083726030302060507272402050707040702850606067545064507078601
10008000400060600040600080000060600030400000806080307040705000800020007000004050001
10765030777040283860838540407820225830805435806550704830207622247870604444328060671
10002080000020500020000000500020405000700060008000600000700000000000700000000050001
17604057576270786086655843238540505074635070273085544257636526555577337227822457201
10005000000030000040000000000000600070000070005000000000000000000000000000000000001
11111111111111111111111111111111111111111111111111111111111111111111111111111111111
