11111111111111111111111111111111111111111111111111111111111111111111111111111111111
10000000000000000000000000700000500000000000000000002000000000003000000050000000001
13347030585283666770706267306067406870362857485625205270503826622068803030873240701
10000070002000000030700040007000500030000080000000500000200050002000707000200000701
15308727404080737030346370306550444082857078632770506037234030204840605068206844781
10006000400080800050200000700050400050003000006000805000805000800000302000600000001
10627080484620203360805075525020307746207567407056606060308035228858303540578442201
10003080400060507040005000003080007000607000700050005070002000000000800020000000201
10703060404033302030886452403037653040204030202880357060557058555430622070576240201
10500060503000200020300000005000000080007060400080708040005020004000500050008000401
10532440324530822638708058665283624526727340605230207086503530304080302782658072201
10000070000000500030008000500000700080000000707000800040404000607070400000500030601
10426048406465643050783365704040603030753633702050663360308077308075626820403450301
10003000805000000050200000408020802000307000005070800000600040003000005000300000201
16503820653070322840808540205020804454502077822060708888238330756355306066806274501
10005030000030000060006000402020304040007000500070500000500050800000504000500040001
10477070268373472036668080608030808030642050204674655870607050404880606770852020251
10003080000000002070000030302040007080002040205000000080007000600080600040200060301
10705070746585805030508442707027725020407470203035534044704747608083564020237320701
10200060000080504050703000005000000030400000205000608000404000607070000020700000701
10373534884040605060237020236246584440203388405680207880828020443050624680702338301
10300020002000807050008070000000600030802000200000500040000040005020500080200040001
10305080508426507073503027604350708050704050255445473050282855403060708050333020771
10005070805000307080003000200040806060500020700000002020400070004000402000700050701
10266020507070203030386430682480605030445046805028304070202530666475702330405280501
10400030204060003020000060006000405060008030008000807080207000400000800050700000301
10405840502055524052858065702022404073206750565420802070606064307030605077243446801
10400070206000200030003000705000002000600030000060200030006000003020202000800000001
10842060708840307478507680308065773240334052786033766325334854837080743380503085821
10005000700070808000805050005000000030005000000020003000000020000020500070006060001
12224052254070607030305060653624233054607824304760607070775070624860208520665030301
10002000600070600070402040000000007000208000702000800050004030008000800030207000301
10506534608440487840607036802634284880205070644055673034403050288025544040502558301
10500000004030000060006000700050000000600020002060006080007050300050000040200000701
10666222765040536055668380404040503438476572804040504480258086505720805060842660401
10008000000060403080000000504080500040005070002020200000400080005000402080008000301
10207074285270402080505364807060743260405020456060848462507080753030604770405060401
10506070000040203000200040302060000000300030000070000070005040000020200020408040501
10704080264060305046724020306080563366787635874527544050427467726040666080605080501
10600030800030007000705000804050000000000000000000003070000060002030500040300020401
10344585603028522550203053707070847346635365354870608085856050305670505544755850801
10003000007000005000408000408030000000000000000030304000008000800060608000000080401
10606044263755402037702340304035508236854438682040706752203047827070708642376040801
10200070000040008000007080403000700000000000006020800000505000200070400000008040601
10467450257020563027206050403470225066578033302047273850203680603550368223302046601
10800000600040004000204000800030006000007000304040000040600020800020002020006000801
10463568602024802570876847257824702286805040503080633060428080804072208060576480501
10000000706000505000200040000040005000005020808040500040007040704000207020000040701
10207460604860804062604080805070702585274260404070405774603080488050402030277020301
10508000708000808020007000306000608000000020206000802000806080008020200020800050701
10735053607086308280844765357626677087864070502025403020207043305030786020504220601
10007060003080005000600000000000004070008040308000505060007050303070002050700000201
10707060343260532063203028224486403830305035706434804052278030505346306040247532601
10303000300000800030003000000000200000604000005000006030004020008000006020000000401
10803876207783606540607736538226886888208085384026824030502064284085582667466730401
10503000300000703000700000600000000070202080004070003000404070000070000000002040701
10402040883430303066747320304464275070405460607480408554732030835453355455602080501
10700070006000800080006000607000006030800020600040507000700060000000500000003000501
10405254204046765557402042304076205030703020864030308020606025467350807085277276801
10800000308000000000008030005060602000704060800080506080008000000040805000000040001
10372322506087322232225730703060203263702080603670408065544323368020502042752060661
10000060006070000020000000604070200060808000300000304000005000000020008000600070001
10744060622720306060727535507030656060208057244876303548204676862786257020204882201
10008070000000708000800030005080300040007040000080500000600030000000005040500070301
10704020253456207463307020803040508823635840772060537460306070603262307470707050301
10406070000000700000003040607070702000000000807080000000707050806000004000506000401
10404080832635824063583640242030304074478845604032232783207060308060754072546778601
10303070003000008040000050500060708000000000003000200000006060304070003000006000601
18302032253020407470463045504050208028337580272050502556546040804087505558703040601
10008000000060700000708000608020205000500060002020800070000030408000604000600050801
10287437604420866875506050303740208060743052605330238080328560203780585084456080401
10700000800040000000007060608000405060004000502000200050600000200080003000002050501
10253440366058738236476280804073506033603520502025725720805067573067306326207580801
10000020002000000000000070606000002000200020606080000070008000006000600000600000501
10456027808085525388726050205823845355473080608073865048562045307850238520647480301
10002000003000006070002060006000007000008000204000300080007000704080005000700080601
13403052448440606040407074284070306070308866305060503070305850308044864084307026601
10008000700020700060700070000040300040200000805030705030502000500080008000006030001
10767080874030342330457570804530377840304454507440806380308748765820403736868080751
10007050000040400050000000200040605000400050006000300000700000000000300000000020001
16505052524580742062664384586470508032335060826065725654482628885857757454254544801
10004000000030000060000000000000800070000020008000000000000000000000000000000000001
11111111111111111111111111111111111111111111111111111111111111111111111111111111111
