11111111111111111111111111111111111111111111111111111111111111111111111111111111111
10000000000000000000000000400000400000000000000000007000000000005000000040000000001
18474060883727222440406724607046807570355582377727402530605877438047408050445470301
10000020007000000080200040008000200070000050000000400000400030008000307000300000201
17508222508070445080267420403820485035826056555860505063872080205330207065605688361
10005000600050400070300000400040600020002000005000207000208000500000207000400000001
10766070428360206720306038878070804757303524604052606040602025653642708520272373301
10006040300030508030007000007070003000703000300050004050003000000000300020000000401
10805030802052507030743528702083563060604050402750852080677038273320884070252560201
10300080202000700040200000003000000060006020800070806030006060007000500060002000201
10873350734470722847306082623555766662557240308750307063402830302030602522525035501
10000030000000700050003000200000700020000000506000300020703000706070200000500080401
10646054208675427030646332402030204040786243408040256370408088405062444780205450701
10006000306000000020600000504040508000307000002040700000600050006000005000200000201
18708770424080236370704550603040808782808027636050404854467240235446506024707226501
10007080000040000070008000707060708080002000500040700000800050800000202000300080001
10858030663678444053678040706050708060255060505234725580505030207650805620287050751
10007040000000002070000030307040008060008070305000000040005000700070500020500080201
10603040872568307080806458807055573020707280405036752066603574503032436060447760501
10300080000080405020405000007000000050200000608000302000403000208050000050500000401
10585237222040707020626020888875754420307424303240308570526060565080628860706743301
10700050008000807040005040000000200080404000400000600050000020005060500080500080001
10808060704576303064502032507480602070308020774884886030682246604080608050668030871
10007050307000305020002000600060705060700020800000007040500030004000807000300030801
10265030802050202050232550773220707070756062303074307040307320644847804820802280501
10400020706030006080000050003000406060002070007000405080802000600000400070300000801
10202480803044323036463053705083305086804580226550706020203077706050608086436668201
10500050708000600030005000802000005000800060000020200030008000002070703000600000001
10737040707470704462403470406036225540758072254083748878534864687050447640204062331
10003000300030804000807030002000000050008000000060003000000040000070500020003040001
15373064623070406070207080225246524055403325807870205080763040272270804820874070201
10003000500040200040408040000000002000606000305000700070002060002000600030807000501
10403542802330762760806084605238474460405020325064366082707080442048584060803736501
10800000006040000020002000700030000000700070006060005030005060700080000040200000801
10277456567050587033225750605060303334257387603080608750835067803880705020777450301
10004000000060507040000000508070700070005060002050800000400070005000702070002000201
10405082332820603040408688504050224680203020535060374424507060333060704570808040701
10506080000020308000800030205040000000600040000070000040003080000030400080403040401
10606060635020203044644060604020237585872864568677737050277354683020383050205060801
10300020300040003000708000504050000000000000000000006040000020004020700050600040701
10442384703084368320402055305070534376543525643370703026783080504280702876688250301
10005000002000006000602000607040000000000000000040308000005000600030808000000030601
10305077545822803043304260503042803464272827847080402764603088448080206637256060701
10700050000080004000006050706000700000000000004040600000206000800080700000003080201
10668860232050285058807080404870463027286034504064444220506270805660784723604037601
10700000600040008000604000800040007000008000708020000040200080500040005030003000801
10467278805073503250464248732875203782406050203070587080722080306043507050736770701
10000000507000602000700030000030004000008070407060300070005060706000605040000050401
10606830706580604087205060407060206757545850206080503535704070673060608050582050601
10406000802000206080006000207000804000000040607000607000207040003040800030400060201
10745045806085303580853234646848585034876030505076807050504027803020445060503320701
10005020002070003000400000000000007040002080604000608060003030208040003020500000401
10507030748340747077402035676863705720703068308564207055252040804437804020578828301
10303000200000200050002000000000700000408000008000002040004060008000002030000000801
10803583308522204850808554465447783876804036847088864080708074674074262578428650801
10706000500000806000800000200000000060806070008060007000806070000030000000006030601
10302050422540707036584580805482484080806860504740202488652030854444225538508030701
10500080007000600060005000205000002020700040300050205000800070000000800000004000401
10802486704082635783503074606042707080507050387030806060507033667550803088585724201
10800000304000000000002040002050705000807060700030706040003000000020202000000070001
10744225305064454656724350208020206725308050307860207042483645576060802045583060231
10000050003020000080000000502050300050208000500000207000003000000070005000700070001
10672030347680502080373564307040687040304078242854607755702825673378744070706624301
10003060000000305000300070005080400020002080000030600000200060000000006040500020301
10405060674332502845604060702060505582325770368080882460203060202253203360202020201
10205050000000500000007070505040203000000000606050000000708040308000003000302000601
10208080666336567063348240888070602028462373407037654377604020305050824073636865401
10304050006000008050000040200050602000000000004000300000005040307060007000003000601
13708053783020407240783066707030607068637530744080208258572080608033506783505030401
10002000000020700000705000707040408000700060006070300060000060302000705000800040201
10878525205270644534603040703560508030533077706880348070252840403640252034485030601
10600000400060000000005060308000807020006000408000400020800000700020003000002030701
10652340728054247485354540303083604032407260508048352360307034356058406738302350601
10000030007000000000000060803000007000400060403080000030006000003000500000600000801
10658027204035448366232070306326777288742080405027835024564084205250868470458260501
10003000006000003030008050007000002000002000204000400050004000206060004000600040801
16505035284240702080603042374080703050507627304030406070603650204046534055204058601
10006000700050400030500040000080600030800000504060704050503000400040008000004070001
10734060625060267440722560604420348540702553802530506580702563743760306243764060541
10003070000040400080000000700030502000500030007000700000600000000000500000000040001
16306052844520573033828536373580806065738030365086555644385447258254588278337223401
10004000000020000040000000000000600020000060007000000000000000000000000000000000001
11111111111111111111111111111111111111111111111111111111111111111111111111111111111
