11111111111111111111111111111111111111111111111111111111111111111111111111111111111
10000000000000000000000000500000800000000000000000007000000000005000000060000000001
17322020457232363380305347706032203680253222643554804880605472646064503080627330501
10000030006000000040700080005000400070000070000000400000300080003000805000300000801
18208887804030858080774270804720735087552062374680708034577050705220608088406355261
10007000400040400070300000800020600070003000006000305000706000300000408000400000001
10473070877450704340702082375060207455806876203038707060704034622754504430345886601
10003070300050202040007000007030005000806000400060005020006000000000700030000000801
10207050607068505070347225503088264030202080303240632080444066368350635080662550501
10700040802000300020800000002000000040002020800070304060007050004000200060003000301
10558440643650675825608075377538366663665770704740404056703430205070504458384064401
10000080000000700030006000700000800040000000304000400040204000205030700000500070501
10686038605336542060745327406070705020333332804040362260503052206078364280804440801
10004000706000000030300000803040804000704000002050500000400030005000008000400000501
17506550544050733660504560507050702528808082445030302835224830865844203086803645401
10003060000070000070005000504020502070003000700070600000700060500000604000400050001
10274030752353328082566050708060803030232070608362882280606070808230707840582070371
10003020000000006060000050602020005050007060607000000040003000200040500070300060601
10603070682385206080308762407053266070402630406024828085303646307062863060466830401
10400050000020405020705000003000000050500000408000507000606000307060000040500000401
10342673265080508020428030664735266420803644808840708540233080454040444450808573801
10600030007000508050002020000000300050706000800000800060000050003070600060300060001
10307050508836605074807047704460302080707080554538428030235583606050805030536020721
10007050307000308080002000500030607030200050800000006080500020006000402000300020401
10658080404080803030828420833820607070853044702063507070404270638385407760804360701
10700040603040005070000030008000407060005060007000203040308000600000400040600000201
10604230202045283088758044203048405033403850875750507040707068402020406053582543601
10300060805000300070005000806000007000800020000020300030003000006080803000400000001
10534020702280208357805780208077327430657068856045368875367347653030856270204032741
10006000800020707000406030004000000060006000000050003000000070000050700070006080001
15874048663060704020204080562375763052808353504260307040578060365320508560537040601
10004000400030200080204070000000005000706000208000600050003040006000300060304000801
10803666803550442770204053308274372650208030673042264082402030246054522080407522601
10700000007050000030006000400020000000800040005050007030008070300070000050700000701
10475854764020726063438370408050804578662425304070403780577078408270407020726780401
10005000000080204040000000503030600030008060002020200000300020008000305040002000401
10202072557850704070603544308060426880405070666060847567303060536030208230606040501
10202080000040602000200080202040000000200040000030000020008030000030300030205080801
10507070643050405048362020808060655545685323252228573050774677374080442080707050501
10300070600040007000203000502030000000000000000000005020000040006070700070600040201
10736548805027526280508044708070857723722848245340304067337070307360302326326730601
10008000003000002000605000205030000000000000000080705000007000300060404000000040201
10408084543376208026802460407088205452786542444050404436507063822020408832555070401
10500060000030004000004060308000700000000000006030600000703000700070400000006080201
10435670862030787072706050407270663088542073402024268570703470507480884677603024601
10800000400070004000505000200030004000004000307030000060700050300070005080008000301
10755836306025403730258726538354406855305020808070864030346030608048503040778420301
10000000807000304000600040000030006000005040203070200080008070508000307080000020801
10405760802630605053407070206050803835366530705020206573708030558060205030854040201
10307000405000405040007000608000305000000050805000603000707020005070800070600020201
10757088606086404360473685233587632057635030504057802070503085405060242070207430601
10007030003060005000800000000000008050005020603000202070005080205050004050600000701
10303060666480867024305053387558702820702082402674208026826040403763708070466437701
10402000600000400080002000000000300000208000002000006020005030003000005060000000201
10804687506265502680607758277744455728702073725038827070204072388048685356627560401
10304000200000508000300000800000000060707030004020003000807060000030000000003040801
10502030232550306023573250303378554060607240808630808848555020577486472788302030601
10300050004000500030002000607000005060400080800050506000800020000000700000003000601
10506873606088225883206022706086504070303060825040608030807037346660207057338737201
10800000607000000000006070007020408000303060700030604050008000000030404000000030001
10638455406047878534647820604080504585406020304720305053742337464050706022767030881
10000020004060000020000000606070500070307000200000608000003000000060008000300060001
10865020243580806040784472705080633060204067466765702862505258282743664040505786201
10003050000000307000200070008020600070002070000030300000300080000000004080700040801
10308070274765404437605060506030605856465560828050468540707080504466603820807050401
10304050000000300000006040402030705000000000705050000000303050304000008000803000401
10406040522556543067325880278070402024537376805026772645608040408060522062273532601
10607040004000004070000080500060405000000000003000300000008030807020002000004000401
13502032552060403350526072404070407062383350627030508647543050802054403485207070401
10002000000040800000406000406050307000800070006020600080000030602000702000200060801
10558533803530638387408040404740506030327042303660472070428830603540822022583030801
10800000500070000000005060508000505030007000707000200080700000500030007000006050201
10622230428052386543738560707057306083803320702075352380803028685083208366408570401
10000040007000000000000060506000005000200020604030000030003000005000400000400000701
10852083406055338682533020602276733646345020206083828033225075603340556880362750801
10003000008000002050005030004000006000003000405000800070003000603060003000600040301
16404023654820706020802027674070502050205264703080806050308550505022665062603043701
10006000800020200080800050000040200070300000304050405050304000700020003000005040001
10762080885040268240272530708640756370704436503730806520706446773780805828284050871
10002040000050800060000000800030404000700040004000300000600000000000300000000040001
13804023523550483087488452568420305043433070623025486636256828467456664772264636201
10003000000070000020000000000000500060000060002000000000000000000000000000000000001
11111111111111111111111111111111111111111111111111111111111111111111111111111111111
