11111111111111111111111111111111111111111111111111111111111111111111111111111111111
10000000000000000000000000200000700000000000000000008000000000006000000060000000001
16427080425442438380802742805023305620264823468456506340502287584035203020847230401
10000040003000000030600050003000200020000070000000700000500020003000405000400000401
18605767705040573020284440502370538083354035848720203026473030205260607028306327641
10005000200070300030500000800020200060006000002000707000207000200000404000400000001
10357070682730503760203064726030403322604456506046207070203046457687404730736728301
10004080400080602060003000007070007000804000300030007020006000000000600020000000501
10202030307028402030338823806077286020804020305620637040482026368730623050364350301
10400030506000300040300000003000000080006080500080805040008080002000300040005000601
10328480567240632268608028637354655667735430802220805033208340602030608538637082501
10000040000000800040008000400000200050000000307000200030803000203070400000700030601
10645062808468883020777636502020403030658887702030382770505035605077375640608220801
10008000805000000080700000203020404000702000003080600000300080003000008000300000301
16506460688020338540706720706040706223402064786080708528422480772666406057805385201
10005020000060000020006000207020503030007000700020300000600020700000807000500070001
10524030452687376064258080206020202070655050607887673360306020508320206720478030881
10003020000000006080000050406020008050003040607000000080005000400070600040800080301
10604070366277504080506334803068682020705630604058637064605473603078666080846250201
10500040000080703030204000002000000080200000804000706000406000503060000070500000701
10642835824060805030348030542247557840304874708570402580468040664040456250504237701
10800060008000807030006060000000500070506000200000200040000020004060200020200070001
10407040504242808082802083202760806020405080255882748040622785703050205050334040741
10004070703000606070003000200030602060700060600000007040500040005000805000200080601
10855040605060602020863460236250808080284058707062707080403360885253404550303450301
10800050805020005020000020003000602070005020005000306060807000200000600020700000801
10503360202048488023857027602064306058305630473780304070404068405050308026768773801
10500060506000600070006000303000005000800030000030400040003000003030803000800000001
10545050808670703885502340405054824470537087835045343827785254845050362860605073861
10002000500030207000205040004000000030008000000040003000000050000080700080006020001
12382038475060402040605070872544335057506828707560306040828080378680502540357040401
10003000200080600060802070000000007000706000705000400030003080006000300030306000401
10202666402320485280302072207765823840502030682022844055807070264045532040705354801
10300000007050000030006000700060000000400030002060008060002040500060000060600000201
10357488263030487052632780302020207845368434803080302630775052808830604020468450401
10005000000060207060000000803050600070006020002040800000500060006000203080002000801
10702076465870603050707348207060848460306020657060525667808030862020802720507020701
10804020000030402000400050802060000000200060000070000070002040000050500050208060401
10407050462050405075443030706020773223776844478463554050373348486020778050408030301
10700070500050003000403000607040000000000000000000002050000040006020800020200060601
10352572807053636670704065305040645255428232247480602082857060705260308482253760701
10003000002000006000307000602020000000000000000080603000004000700020405000000080801
10605047648233203072503780705038807582646432268040308663506072445040704765427020501
10500050000040008000002060206000400000000000005080700000506000600080800000004050201
10663350283020235027706070607450652076588075307067657750607470805550447262407044501
10600000500050007000208000500070007000002000305060000050700030400040004080008000801
10473883206045602460268245346683404453502040702060777060854040207064706050548270401
10000000506000803000500080000060005000002070506050500030004060404000703020000070601
10203860206360402066207060705020305275764330206030604626204040474070402050334030201
10503000502000403060002000407000504000000080803000505000403080004060800040800080301
10626038402023307330837542262378662077345070404037307070405086407070855060507540401
10003020005050008000600000000000002050006070308000203030006070205050006060200000201
10302050835270823036503064582422706520303087505635806073652020706226708060684467401
10703000300000500080005000000000800000205000006000005080006020002000002030000000601
10302728704636702580606246582424554366208062666052238070702055333042287377632680201
10507000200000604000600000400000000060204020003060006000506040000080000000004020701
10502020438680405043584680604236383070608860207850302446558030788328833632706050601
10500030004000400060008000407000003030800020500050406000500040000000800000005000801
10602474606035665442605053704065306050206060763050506070806023323520305044448447301
10300000708000000000005070005020707000404080300040406060002000000040406000000030001
10683833604086746468272670804040607848307050807780303052344236682040607083882070471
10000040002070000030000000302030400060705000300000602000003000000030007000300070001
10325060365630404070336848804030835050204078362276208654707266248564328040307572301
10002030000000502000500030008020600020005070000050300000700080000000005030800050201
10805040523444406336603030805060402663482220773050226840706060303583702270802030801
10407040000000800000008050702070802000000000503040000000802030804000006000602000201
10206080578477458027722870435030708042864878706055737287805020404070544044664348701
10303040003000006030000080600030708000000000007000200000006070707030004000007000701
13306037724050607570685063804070404038627720837040406467238080605078504235303020401
10006000000030300000802000705060405000300040008080500050000020204000308000600060601
10365282805480654585207030503550303060382044808840355060473840207440785085847050301
10700000400070000000004030305000203020006000807000200080200000800030007000007080801
10345470486048377232425860608075704058608630202064222640308037738036704748506830501
10000070002000000000000030807000003000800050605060000060008000003000600000600000501
10884073306037837277837040206382846774675040504034376066475046205630322380538320201
10004000004000002020008020008000005000007000403000500020005000808080004000200020701
12404052355880207050506082786050706040202334308030207020705630708043723036602045601
10002000800070500050400050000050700040200000702030205060806000400040006000003030001
10457060473080456330237850202280328660302425302680608480503685853360608633226070661
10006020000030300080000000700070704000400060003000200000400000000000300000000080001
13203084826540654034442733622440204072386040724056682882438674234582676872854236401
10002000000050000040000000000000600040000080007000000000000000000000000000000000001
11111111111111111111111111111111111111111111111111111111111111111111111111111111111
