11111111111111111111111111111111111111111111111111111111111111111111111111111111111
10000000000000000000000000800000200000000000000000006000000000005000000030000000001
14272050644782528370203277805075703860322445257427303450408383757043602050687870501
10000040005000000080200060002000400050000060000000700000500020003000307000600000501
16708885806060883030726760308670458034544048436650505062247070304660506052504227531
10005000800060400060400000600040400050007000003000506000402000700000402000400000001
10242080373620704350804044642050505777705483205077306080506076264578607220662786301
10006020400070307080007000002060006000303000800070008050004000000000200080000000401
10706050305052303050646645603035547020204070704350348030722035684320738040765420601
10800040802000500030300000008000000080004030500060802080005060008000500060004000801
10224240633770467685502027467827443875423730802370807078602670603050608656277045601
10000030000000700080007000600000700040000000704000800060704000207020800000800020601
10478054507343532030853326706020603060537733806030585350207084507074646870805380601
10003000806000000050500000608040307000508000005040800000300080007000006000400000601
13808850548080477670702860506060207764203076456040602425788860474335304047507552401
10007080000070000060003000806030302060007000600060700000800050600000302000300050001
10678050843254633032487070702080206060428020206562587620605080808240203670834020621
10007070000000002070000040403080004020007050202000000040002000300050400080500060801
10206060344354307080207864307045376070603470303057836035802427304034826060867340601
10300080000030802030503000007000000020600000404000807000307000403040000020700000301
10862666768070607050283020225554727850207657802440306460752060445050266870208865601
10700030008000506080007070000000600030303000700000500040000060006040200030800070001
10604030407237803077403062602750608050304080284244283030787756807020504070626060721
10007040705000406030008000600070507040700030400000004050200050007000705000200070201
10467050604020607070748570383670402030822085808026203060208360552483502430203570401
10800070508070003020000070005000404020006040007000503060703000400000300040300000801
10606260202034483066586043707076308044808260687370205020705088506050706026323476701
10500040406000600060005000203000002000500050000030300070004000002080806000700000001
10525030508370308483706480202025646520463053328084354857838335387040748740204083641
10006000200020206000205020006000000040002000000080006000000050000040700060005040001
16285024435080808040704020732856336045608872607530202040428040638880503530824060701
10002000400030200030202060000000008000306000707000600020002080004000700020607000301
10605263205520336650507042304836886660606060652048828044704040882028723020503244201
10600000003060000050003000800080000000800070006050006080005020700050000040800000801
10438473382080623024828820404060206386384233204060406570424076805430804070852540701
10002000000030208060000000205050800020006080002040700000500080005000402040003000401
10508057646580802080603435608050753440408020578050348832505040223060308230508060801
10408050000070605000300050702070000000700040000070000030008030000070700030806070401
10308050732060506056735050402060675484877758243228422050763387345030486060802050701
10300080400060002000802000308070000000000000000000002060000060003050600080800060401
10766872606027864820603058306080285282667743623820806022767060502630303486267220401
10008000008000004000207000404040000000000000000060702000004000700080304000000060301
10805063374855607028202480806072406466283352486030603228207033635050502434265050401
10600060000080008000005020603000700000000000002020500000806000400080600000004030201
10367450562080643047802040307350847078634074703043735470306340802560755556304047301
10600000800020002000303000800030007000002000802040000040800050400070007060003000501
10833642408045205640373728877787405355207050208070552060655040607058204030438720801
10000000507000606000700050000040007000002050207040400060005080207000308060000030701
10407830602530805022204050203050504253268440805030208388802080374080206020574060801
10607000202000802070004000702000502000000020708000503000702060007030700060200030701
10678032502047808440778528268286228046333020307064502050707047504080588050303360401
10007030004040002000400000000000003060004060303000704080003020303050005080800000301
10706030448530547043407078648472708770702065208546804086752040808762707080563845201
10606000200000600050002000000000600000303000004000004030003050002000005070000000501
10407366308358705370602588243254656382803043724038425030405055384048352336428450801
10402000600000208000600000700000000020204060005040008000602030000070000000008040301
10805080743720604048855780303643223070507870808760207364767050232367674582803060201
10800040008000600020008000806000006040500080200050603000800040000000600000008000701
10808885607028476743706057202062304040408080825060708040806088728360303075422666301
10300000604000000000007080005030607000507030300060706070008000000030203000000080001
10765867206048248578564850402020307735504070605770207027225537427030207032484020761
10000040005070000070000000503070400050408000800000803000004000000050008000200020001
10246050873640205070886776307050687070305083354377302547208286845566354060406872701
10008040000000408000700040008080500050002030000030300000600040000000007040200030501
10807050827346302788303020302050805273244680543060438350605050407637605870702070801
10505050000000300000005070407030503000000000604030000000708020207000002000606000801
10702050575834734083578820438040207077233575705063322646706080608020278037278334201
10208050002000004080000050500020802000000000004000300000003070307060007000002000401
18408067284080503380833084702030604055778650656050702367876020307062705764805060701
10008000000050500000205000704060404000200070007060800070000080202000303000700050401
10446635605560464455308080206870406060724076403870266080576770807520362072426020401
10800000600080000000005040706000402030003000408000800070500000800070007000004030501
10866650443083274878844780408082402022505540407064568450207084882073602735702230501
10000060006000000000000060706000002000600070402040000020005000008000500000300000401
10436086504033723737734060604278232785537050402076838083573044803270788480648450601
10008000008000004030004060004000005000003000506000200070006000503030005000300020401
12608058653280803070202034533080208050507443706050803050202830502072525063206033301
10007000200040500060300070000020400050700000508030606040408000300080003000004060001
10724030622060843640223840407820263840202266206530304660406646358830703372777080681
10002050000030700070000000200080503000300020006000500000500000000000600000000020001
15502048264370357043827428542680202058648060624084565344282627763637243525323636701
10007000000030000020000000000000400060000030004000000000000000000000000000000000001
11111111111111111111111111111111111111111111111111111111111111111111111111111111111
