11111111111111111111111111111111111111111111111111111111111111111111111111111111111
10000000000000000000000000500000300000000000000000002000000000008000000020000000001
14347080238625286570603454404035704870345555575377207670408484687086607060534270701
10000050004000000020200060006000400080000020000000700000500060007000803000300000601
17406375404020836050788240405240648054556053277820608048453080303780306064707524371
10008000600030600050400000500080500050007000004000405000703000300000605000300000001
10883040354370607320704073865030204373507348202053205050708043725458402550262744301
10008070300070805080007000002080008000208000500080006040006000000000600040000000301
10703070603078803070755674707032337030203080707880788070746043426530384070857620201
10500070703000500070800000008000000080008040600070402080002060003000600060008000801
10526450747260778537607022544228248438647720806450403082303260602020708666273084301
10000030000000700080007000700000400070000000307000600020402000608080800000500040301
10332085302424872070376857408080807020585342802080387840407086505038688450802350801
10004000802000000040200000307030207000404000002060500000300040007000003000200000501
13404430358070626760706880802050808428507035543060403266664730275486604047806588801
10007080000020000020003000704050402070005000200040800000500060700000408000400030001
10224040652324287046468030306080203050444060602283483550507050406650704660864080731
10007020000000003050000070708030004070004060703000000070004000700030600060400080601
10304080425727507080308633803055534060702870704067456043507252507087577030287770301
10400030000070406040602000007000000060400000408000403000608000202040000080400000501
10875567878030206030376020357487847250808278608570308640768050387040637470406433201
10300040007000307050002080000000200080507000300000800080000030006070800020400030001
10805040502678306078604024504830303050805050354366323020646748205030606080237020841
10008050704000603070006000800020404020200050800000002040300080006000602000600020701
10223060208060203030377620578240704070636055602064606020305280337367405230602560601
10700070405020002080000040004000702030005080004000404020804000200000300050500000801
10204730706067476083856076207084306036303440368770206080406037708020404064865422501
10800070306000700070004000405000008000600080000080500030008000003020503000500000001
10484020506330502736705550602073578350268056538038883688657372342030538340404044741
10006000700080808000803020006000000020005000000060004000000020000050400040004060001
13455077257050502070306080672448354046405573705570302060666050467640206550736080501
10004000400030400060706040000000007000204000603000600050007080006000600070505000801
10608374304570758760205038703653827480302030828058748048506070256053223030207228301
10400000002060000020002000500050000000400070007040002040004040400040000040500000501
10255344424040765043552640302050206324385558508060504370386058805570402070538880401
10006000000020407060000000307060600050003030003020500000700020008000805050007000701
10707034776330804040306526708030448450506030727070466756408060642070702450708050801
10702080000060407000800070506070000000300080000070000040004070000070800020203060401
10206020563020304048244050805050224376852886556446376040724837585060263080408020401
10200070400040002000806000603060000000000000000000007060000040003030500040200040501
10445833206037748830402045308070323487552525233760502085285060806540606323353460301
10006000005000008000804000707050000000000000000060602000004000600060408000000020701
10408048583233202057403350407032202583256256423060406778705086347050302848737080501
10700050000030004000007030305000500000000000005080600000705000800050400000008080401
10382460268020278053704030506420547075854083702048333280602270803280477285507073501
10700000200060007000304000300060008000004000205060000070400080300040004060005000401
10246276303055402340454868682355603743204080708080852050733020802038508050382420601
10000000507000207000700080000020003000007070307020800080006030802000406060000070801
10404260406640804084406020506050402828858750705070508223205030723020502040363050601
10606000406000702020007000802000308000000050206000806000804040002020400080400020701
10276074305023807430658575553278825034825050507074206060404048602040655070307560701
10005030005060008000400000000000005020002070805000502080006020603050007020600000601
10306030665340832084306077386457702250603067804354602073752070506427505060842676801
10304000300000700080007000000000600000308000006000003080005080008000004050000000701
10308364608855806360704658785782258827505052762075633070202087627088763272766880801
10502000600000704000400000300000000070807040005050002000406070000020000000005060701
10603030865340707026233330507422762020303580308720502727457040442377274236204080801
10400030002000500080007000205000003030700050300080604000800040000000800000007000501
10605436802074248747205055206084408060603020437030307030405054824320802087737523201
10200000803000000000003050008060505000403070800040704020004000000060703000000050001
10436847205033775578528860206070208443202030305770502062838348422060805076477080271
10000060004060000070000000805050400020805000800000202000004000000070004000200060001
10274020565620505040667677505020742050608024783672406264407556325565687040208678401
10006080000000508000200060007040700060006050000040400000200070000000003080400060301
10604050763667803338807040505020205366857660347050455830707040307534402450603080401
10406050000000500000003020404020704000000000406020000000206070806000002000206000401
10808030834773556047785780536040705074368372602068744383207030307080856027562387201
10607050003000004050000060300070803000000000003000700000002020503040002000007000501
12704062572060203340384032802080505084468740842050408545482080707023707675607080301
10002000000020200000302000605070503000300060005070600070000060503000202000600080801
10774564708420483636808020706850804030672085804370828070585560802880474052858070701
10400000500040000000002020402000805030008000506000700020400000300020005000008080401
10764620578045724353426680804058707087606760606038356420208073355027704576305730501
10000040007000000000000040302000008000800070208080000050004000003000400000200000301
10773085607075855262674020603687553247866050302027225064246045205820756640376570601
10003000007000008020004060004000002000004000807000800040003000206050007000600020201
13607057837780804050807022553060603060708482806030504050207360706056455024503082701
10005000500030200030200060000030300050600000503080206080506000200070002000004050001
10486070246050873560337550203530734220602285206820608450808566762720402677455050281
10002020000060400080000000700040406000200070005000800000800000000000600000000080001
17608078244240322082732785562630806026685070263085373368758438772685756376567568701
10004000000020000080000000000000200050000080006000000000000000000000000000000000001
11111111111111111111111111111111111111111111111111111111111111111111111111111111111
