11111111111111111111111111111111111111111111111111111111111111111111111111111111111
10000000000000000000000000400000300000000000000000006000000000004000000040000000001
14568050278552667250306358302022302780423252684568702720402233247025707080685530801
10000070004000000030200070003000300080000020000000700000300020007000407000600000501
18407327303080823070674870205470436024668036266260207077364060708840405038505468381
10007000500080300040400000300030700040003000005000207000505000600000606000700000001
10723030235860705660703056236080402552808238705082807040504078257886505630272685801
10008030600060703020005000005060002000407000300050008080004000000000300020000000701
10808020403086702080776784603075332030602070704460724080644055878520662020235870301
10400040506000800020600000004000000070006060700080604080003070003000200050005000501
10557570758440337782306076475648676884653760707360208034507330407020407543577022201
10000080000000800040005000200000600070000000806000700080407000206020400000300080301
10458037207886783080686682406030602030272442508060665840203023803063775530503460801
10008000305000000050500000805080205000205000003060600000300050008000003000200000601
18204420784080853480205860305060208673506025683060206763767380886663207035307754801
10003080000060000060006000205020206060005000800040300000800020400000603000800050001
10662050363474764027846040805050804050578040607455378350708050405680404260282050641
10007070000000008050000040404050005070007020504000000040006000800050400020300070201
10608030487248605060306777204086888040705220303066675066303748805063235020383770201
10200020000030607020404000003000000050400000403000402000606000206020000060600000401
10774354782030206050255040375448878250303743402750604630485070746080838670305585601
10600070003000502040008040000000200060704000500000800030000060006080700020400030001
10704040706334203048202048807220806030705080888455246040778258702070204040374070431
10007060302000807060007000400080802040600070600000002070500060007000607000600080701
10568070404070605030443460634220703030283048402028304070403750374775307280506750401
10600080706050006070000060004000306040003070002000403050606000200000700050700000501
10606770302022824023483035703036702045302570545580604020507056303070402028888337201
10700070203000200060005000506000007000700030000030600040007000005080207000400000001
10634060203560203446606580804026572630467065385082337234455872538080268370703044421
10006000600050205000507070004000000020004000000030008000000050000070300070008050001
18648074636080608030307020573235433075205264406440804070446040533650504750445040501
10004000600080800030702020000000006000607000205000500060008030008000800050808000301
10502226707430727860406054507464563830304070644085267062503040683034522070608864301
10200000002030000050003000600050000000700050006020007040005080600030000020700000401
10487842447060278034375860307050407334842653704080703750765075406670203070237680201
10004000000040202030000000505020400040008050006030200000800050002000702050008000201
10506078443520805060603335304040385620405080767030336872707070648050504780206020701
10702070000020505000600050704080000000600030000070000020007020000030400050607050501
10303080447050708042878050604050365745456778682675656080565268537040888060608050601
10700040200020006000202000707030000000000000000000005080000060008070700040300020801
10324233503048572340703024604060523345327365378880408062687080203770705442378670201
10002000002000003000402000308060000000000000000030703000003000600060307000000050401
10302045434587504062605880204067608575378782684050404575402055836060706265824060501
10600050000020007000004040707000200000000000002060300000806000800070300000008040201
10766640385050856063607080207320355056787058603062246820702230405560653853404025401
10500000600050004000502000300080005000006000708080000020200030300040004080003000401
10342572503076408820887485643687704546503020505060568060856070706065608050766870301
10000000302000503000200070000060006000002070405040300030007050503000603050000040201
10708730703580308086205080707070707482828440302060807674208070445070306030833050501
10604000704000203030004000402000306000000050805000606000707070005060800030400030801
10847046502047202870668672533584578064372040507046704040808086506020868070405780501
10005040003030006000800000000000007080003070305000406060002060405050008070500000301
10807060252620877063607037627652804530404083807872706068628030803587203040833335301
10502000600000500080004000000000500000805000005000006040006040007000007050000000401
10603765505563308260205375768384682774802036464074235060505088736028685563567360601
10505000700000208000500000700000000030302060007060003000603070000070000000006020501
10502070662860304052686570307556354060503740605480408624533060263624443852505070701
10700050004000600050002000504000002050200070700070302000600030000000400000004000601
10706528807087336457203052204058603040705070275070804030802075683650208057655747201
10700000202000000000004040007080705000605020800020706050006000000040802000000060001
10563267203088442635572550702050503647803060502570403037268428778050802058343060531
10000030004050000070000000703030500030502000500000404000007000000070006000700070001
10672040572850702020422244704070573020703023346568705434707772624545855030402342701
10007040000000508000200040008050200050008070000030800000600020000000003070400060801
10607040585233402344602060708030608545236330348020586230808020706826404670605080501
10408020000000400000006060607050305000000000507030000000707040705000007000804000201
10403020755446387044622560682050505058358846503083822454402080405020684068644523801
10704060007000005020000060800030305000000000008000700000002070308080003000005000701
15604028877070208450487075407080304087385550765030703587652080307083802487403080401
10007000000030700000802000604080402000200080004080500040000060307000407000800020701
10525467607550336634605080304320708050226044505330263020355470505750588062537060701
10600000700080000000005030507000603070006000402000800030400000300030003000005020501
10484370565063372774643640507038803048803830602077778360602065878025803327606860801
10000070004000000000000080606000004000700040308070000020008000008000300000500000401
10733078206074257462556040604235628877772020307033262024342048806570728470444550601
10007000006000005050005050007000002000007000206000500040008000608050002000300020401
18507064778620202040403077685070502020505352403050206080507650505083238087804036401
10005000500030600050500040000080800070600000404020408080606000200080005000004080001
10663030236020823320234650203680582680502723804350505630402637278420704522744040621
10008050000060600060000000500080805000800030003000700000700000000000800000000030001
14503052878380667087578577237730203044378050435032282462286558264723277878764278601
10002000000020000020000000000000700040000040008000000000000000000000000000000000001
11111111111111111111111111111111111111111111111111111111111111111111111111111111111
