11111111111111111111111111111111111111111111111111111111111111111111111111111111111
10000000000000000000000000700000200000000000000000006000000000005000000040000000001
16337050774844643830203875607073608670363284446426507760406846472072207060634760601
10000080007000000060600040007000600030000030000000700000700040002000808000400000601
14805883407050676050374720806680826064637075427350408042567050602820405074704268231
10008000600030800020800000200060600030004000003000504000406000200000205000700000001
10848060776260603340406083287020203324605743506034405050308083234477404650877425401
10004030700070206060002000005070004000702000800060005040008000000000800080000000301
10204070205072705020382235207062863060408050306550352080683072474320287060626270401
10400050803000600050400000004000000030002080800040502070007060007000800040007000801
10823830256380438724507055277262754576744360508530307048502880202080804867565077401
10000080000000200050006000400000500060000000606000400060702000802070600000200080201
10332086605782676050437838405060503080564287406040665460604026505042768740202550501
10008000803000000030400000705020608000706000003060300000200050002000005000600000501
16202770373030282870304240603060206346607046674050606345375570868663704062704278301
10004040000030000030008000307060302030007000500080600000300030600000204000400040001
10225080756778267068572040402020806060242020203665647720808060802650503450263070251
10007060000000007060000040705030004040008080205000000040006000400070700080600060501
10505050537226406040603763502046786040403430408055272053408725204054288020564460301
10800050000060204030302000003000000030800000703000403000305000304020000070500000601
10334546723040708080526030534882434870808582402460602570274030785070862520204775801
10800020007000503040004020000000600030202000700000200020000080002050300080300040001
10705050302464503028202053307580705060506020775322763020448748402030808060753040861
10003030706000206030003000500020503030500030500000007080700020007000406000600020801
10675080808080403070367530362760405020623028408033403030308480577446206250408340501
10800060206020004040000040004000802050008060005000604060805000200000600060200000601
10204330304025356034824036405047305067704520828380703020505044704030502067732747201
10500040705000200080004000306000002000300040000030400050002000008040205000800000001
10272050206750806864305670207085746860546085454073487773355738485040388630708083621
10006000300020202000606080002000000050003000000050002000000030000060200040005040001
16245028534070705070707020747876288024607555308430507030447060274640203520785040601
10003000800040300060502080000000002000802000502000700050004070007000300040804000701
10605454704240274470705075704873386620602080373076733082504080664065645040504635801
10300000007080000070005000700030000000200080003080004040008060400080000020500000501
10463242636040863032463630806040208872334544307080307250625038603760305070242340501
10006000000030606060000000804080400020002060003060700000600030005000702050002000701
10605027246870208050606422704060562870306030636080784237504060724080304470502040601
10507050000040208000600030708020000000600060000080000040007040000060700050407070301
10207040635070804053382020608080525366847848747847656040642526466020767070308040401
10500070500060005000205000208080000000000000000000003040000040004070400060500020501
10743282707084844780402075605040478544548587442570207076326060302320402424628770501
10006000008000005000803000306070000000000000000060608000005000700080808000000040601
10606086747588602065506640807045305457864646522060403435306077662050805337543060301
10600050000020008000005030805000400000000000007070800000605000400020500000004060601
10653630543060427076205050705420586082245066702076735420305780307620577342207022601
10700000700040006000403000200050005000003000305060000030200050500030002030007000801
10334675808082406570744875834863407246403060302070535060272070706086805060374660301
10000000605000405000200050000080008000006050207070400070005020503000302040000070401
10502380208670807085608070203050306382776380703030605756306040555070602060577040801
10207000708000205020003000403000307000000060406000606000703060002060500040500030801
10277062507055802380833626256635373087226070405066807040206048408030256060605280501
10002080006080002000300000000000005070006050302000203030003030403020005040500000301
10308020344370234055203086577366407650804068802758802074565030305824808030556233501
10305000200000800070003000000000700000308000008000002040006070003000002070000000701
10205776802424205640504546386538574472405085786057437030306085477027354243263350201
10602000300000304000800000200000000060803050002080003000802020000020000000006080701
10407020353340206038735230604227627040604760405520203233735060826464382688207070401
10400070004000700020007000707000007040700020200040206000200070000000400000008000601
10207443604087748663508084507027808070406020737080303080607075327660805026482246501
10500000403000000000003050008070608000207040200080505030007000000020605000000070001
10742487707056843723276340804030707374605020307340304056387788336020604038486020541
10000060005040000050000000402080800080203000200000204000003000000030003000300060001
10482050246750805070543743805020527070205073844462403764305662483337762020205538601
10005020000000702000400070003050600050004060000040600000500030000000003060800020601
10308070465858606773705080805070408755274570256070748750603020403725308520704020301
10702070000000700000002040506060705000000000602080000000603080807000002000207000601
10507060533786673024363650745030407034827533305077556342707020206070842067756362501
10707030002000006040000040700060306000000000003000400000004040605020004000006000201
18202035272080403720653073306050506064645640878070708527576070406037608353704080801
10007000000070300000703000803020806000200070005040600060000080705000805000500040301
10733876304420346552604030403360808020434053803660832040442670502730288044788030701
10700000500040000000006060207000504030006000606000500030400000300030007000004040701
10846630332076853625344460405044605072805650408053664530708035767023607557204620501
10000050007000000000000020507000007000400060206030000040002000005000800000500000701
10736082407085862375553020303567373268647020606085266022426033708260355220376620801
10003000008000004030002080004000004000006000703000400050005000602040004000800060701
12506086855770405060603062656070404040704855408030506030604670204076578047707056501
10008000600070500070500080000030200050400000507030202080304000200040003000008070001
10627070435060686320426580703570785880203747705780505440307768633220207585243040471
10003060000080700050000000200030607000300030008000400000800000000000600000000020001
12502052627280668087225886423780606082636020543085786546463847552422654566837758701
10002000000070000050000000000000600030000050006000000000000000000000000000000000001
11111111111111111111111111111111111111111111111111111111111111111111111111111111111
