11111111111111111111111111111111111111111111111111111111111111111111111111111111111
10000000000000000000000000500000400000000000000000003000000000002000000060000000001
14663050266677853620402782302058505750844384228434405380508622776032503080588370701
10000040007000000040800030006000600070000060000000300000300070003000407000500000601
12403443506050542050467530707240656046348053232520207085725050402270405028305875541
10002000500050600080800000800070600030005000008000508000402000600000504000300000001
10647040436860703580503045688050604747607253808042605080208045756784506270387528301
10007030800060606080006000006030006000703000700020005060007000000000200080000000201
10403030605064303020564465303045463050508050403430467060778032278450452020473450401
10700060607000800040800000007000000060002050700060602080008070008000700080005000701
10653730867480622423608065863522873774442830708470705043605320606080405788683068701
10000030000000400060002000300000400060000000702000600020707000405020700000200040201
10874073305478822070336324305070205030626365602070443770708067207026767480503670701
10005000406000000060800000705020207000806000008050300000800060008000004000700000201
15407320826020883820208560506050803758402066344070403633237730347478303085505247501
10002050000080000080002000606070406060007000300080200000500070500000703000600050001
10526050277475773057822040405060405020872040708786448850504080203780203650872080631
10004020000000007030000040405040004030008020503000000030004000400080300040200060701
10308040553634305070304573303067334080702460803053377025708738605044452040577540601
10300070000030505070307000008000000050200000202000502000204000508040000030300000301
10842874432060703060252050884562227280408322707370206520776060685060776260607454301
10800080007000702030002060000000500080203000200000600060000070007080200080400020001
10206020406235204083505075708350505020506020747423445060555735402080205050254030661
10005060807000503070004000800020605050500080400000007070200080004000408000400030401
10555070608040506050843420232770405040548067504084206050404360473738804480804820301
10400020205060006020000020002000408060005020002000703050304000600000400070300000501
10502660503055226025768027306045608064508760756220203040507032602050607063463563301
10400080607000500070006000705000008000800050000080200020006000007060206000400000001
10633050405620204683302550302066435760432084583083728656282734824060287530706085741
10008000300070405000605030003000000060002000000050006000000060000040200050003030001
18866087383020606040405020468774274044405733703260505080358040235520503880526030701
10008000700030200030505070000000004000408000503000800070008020003000400080707000701
10502887706440356860805057502753442270408020645044272062802070772043486070803284401
10400000002050000080003000200050000000300030006070003070002080300040000040300000301
10866685334060227065368860206060408684558828804040503620576056505270602080456840201
10006000000080502040000000307050700020002040008030500000600020005000206070006000501
10808078363370803020308267205040255750308020545070664827204050226070405630207020801
10603030000070504000500030707050000000200020000050000060006040000070400060208050401
10605030636070702037736030406050438472358327763478363080842766224040564020508040401
10600080300030003000202000504020000000000000000000008050000070002080500080500020201
10862522707058445280307066803070346878487484774520505072822080808340608847436250701
10005000008000003000605000607050000000000000000030304000005000200050505000000070701
10806044744775703066804470608036703583487628772040803832207025465060306752635040801
10700030000020004000005080703000200000000000004060500000802000400080300000006030801
10772360447050863082202070808370482044522062504084254830803340802240652283803027201
10600000300070003000802000200050005000004000503040000050200050700040002080007000801
10625485407052507530586847828345704462207030305030225030523080608043808060724330401
10000000407000406000500060000060007000008070302060300060006080603000802080000020301
10807780303440304057406030805040407687433820502050602857202060583070708020626040701
10707000702000705040004000604000705000000040504000307000405040005040800020400070701
10663045402042208580678832685664566073328070205026502060503074705080385050708370401
10003060008060006000400000000000008030004040607000204060008050504080003080600000501
10607040536620834045403043484336603680604054505544504022447020505782203050765633701
10603000500000700080002000000000200000708000007000002040008060004000004050000000201
10806784302757805470402653357625382588602062847032342040606052464077233432724330701
10805000700000205000400000700000000080607040003030006000208050000070000000007080201
10606070665880506067642540803825258020207860302780404487354040632735833824306060201
10800070002000500080003000802000008060600080300020305000500060000000300000002000401
10703685203033555576603023406063704050405080744070804020407072874670307024735235701
10800000205000000000008060003080805000404040400060306020004000000020308000000060001
10326553805042362254462450807060702466503070708350208052438723734050304082482050871
10000070007040000040000000304040300030708000800000406000006000000070006000300020001
10337020455320608020438668205030875060503038562346807452406436562585327040207377401
10005020000000307000600080007050500020003050000050300000700080000000003020500040601
10208070443845704443407080508070408558563420478020344740803060408527505730404070401
10608050000000700000004080808070207000000000204040000000405080708000003000507000401
10402020663466242087523230243050603083687762304054285435406040202070873028468456801
10305020004000005030000050200030704000000000007000200000006080602040006000002000301
16502075374040508780435064208030607052554320586030404845332070408074606463403040301
10002000000070600000405000208030408000800060003040700070000080804000308000600050601
10523368305340583465203070803570306060667043602730652070866370407460645084682080801
10800000500040000000005060808000304040005000607000500060200000500080003000007030401
10875550668063243845275720403063302045408550307064673280606042627054404276402450701
10000080006000000000000020506000008000400020303080000050007000005000400000600000401
10254044805047887642534070202373237546363050806062766072372032605820637220883740201
10005000006000008080008050007000007000002000405000300030005000206020005000500060601
12205084375350405050308075557070308040605253808050606040208440304028542083804028401
10005000600080600050600050000040400030700000305070808050304000300050004000003020001
10766030578020424840776260408850422660204584608620308730608546562350504527347070481
10004070000070800080000000500050804000200060007000300000700000000000600000000060001
16308047435350583076724524573740502045232050586044338662248833325242436884255532801
10008000000070000020000000000000500040000070008000000000000000000000000000000000001
11111111111111111111111111111111111111111111111111111111111111111111111111111111111
