11111111111111111111111111111111111111111111111111111111111111111111111111111111111
10000000000000000000000000700000400000000000000000007000000000004000000080000000001
17722040762334686220308438706067607660637823566888708580607376836064307080852430301
10000040008000000040800050002000700070000080000000800000800060007000504000500000201
18803873805080857070846460506860768022264054486320603087658050507570402067408232671
10008000500040400050500000500040500020008000006000703000706000500000408000300000001
10634050574280706520503026822080708762502276703082806060202085642545307680627457401
10005020300060303080007000004030008000707000500060005080007000000000200080000000301
10704030503026305080582387707052837040706080608870266050862045244260352060343770801
10400060308000800020200000004000000080002070500080704040004060004000300040004000301
10528870462560325765206085385466543537363840207680407064604670203030408448688022401
10000030000000800040006000600000400040000000408000400070708000404050700000600080701
10535075502284733030223263807060507080464657204070845340304085506077456230507860401
10007000704000000070600000403060503000705000002080500000600050006000005000700000701
13206620428050532680302340806050507283405067856040806723762880675384407087706676701
10004060000030000040003000606020407080003000400050700000800080400000606000400060001
10758060474253756075766070303060508030542060707778886550806020803470805730266060831
10002030000000008080000030408080008030005040307000000080005000600050600080800080501
10605050878526404050505468405055326070803630608046874048304372704028628020647750801
10400040000060703040302000007000000050700000608000206000402000703020000030800000801
10762765584080407020646070453524244650602836205440607880246050833060564870503685301
10800050007000504030007060000000700070407000200000300080000050005030800080200050001
10606040307544407032302024703730607080407050852442585080524326604030504070424080231
10003040507000405080003000600080408060500080800000004080300050004000605000700050201
10787020604020302030653430456760207060384083307054302050808860457572807850203830201
10600070307070004070000060002000704070008040008000406020804000700000500070300000501
10205640603035658024843066802076303026804380675220407040607087505020707044856726401
10300030205000300050003000308000002000200040000040500070004000008040204000800000001
10458050706550805838305880403075872760575026723085426746358587743040483380202064621
10002000300030503000205030004000000040008000000070003000000080000030700050002030001
12248044583040402070405060866634445064308663703670304020832070765370707840342030201
10003000500020400050403020000000003000707000605000800050002040002000400030503000801
10506853804330465720506046805756228280208050485044526088807080353086732060402686301
10400000008060000050002000800070000000700060004030006040005030600020000070200000601
10887555577060675076625630805040705778374822605030302760746082706250505070632840601
10004000000060305030000000508070700030007040004040600000300060005000805040006000301
10504077227740602070702622702050537720707080525080658362306040527030206530204080401
10202030000070803000600050304060000000800050000050000030007020000080600080806050301
10804070563070806023547020205030746438424868664478354040484328874030234040705060501
10800030200030007000506000506070000000000000000000003060000030006070700040700060401
10452878504026448220605064508040646524527346564720705045364060605550503786632350701
10007000002000005000808000404070000000000000000050804000004000700020308000000060801
10704072753462604055505450704054405374766455453020502577605065726030205286734070801
10300030000070002000002030407000700000000000007020500000707000200020700000003080601
10253580665060478048703020208680285077338078603024668760702440806560223383605042801
10800000800080007000503000500070002000004000207020000040600050800060003050004000701
10885266208075308340782848444482607744408070304040334050238050602032504050822760301
10000000303000206000600060000060002000003050405030300040005020205000607040000020601
10602830503460306078304020602040602777688320606050207745405060732030205040773040701
10508000505000604020006000303000202000000050404000406000204030008040400040700050201
10388052608033208870686673338856754062724020202076405020506022702030822030505860201
10004080007030007000200000000000004050004050604000207040004070707060006040400000701
10204040865360876065808036684533806230604063705382406053534030303246207020572427601
10205000800000200030005000000000800000305000005000003020004050008000007060000000401
10803857406434604580703525356437555632408037263023572040208042327047272783222380401
10403000600000305000600000400000000070405020008070002000503020000040000000004030201
10603060352750806024357370702235546030208740502870205753272030785838722883207070501
10800080004000300070006000505000004020400070600020303000500070000000700000007000501
10204632408057754287808055407043605060608020383050702080205058686770303085366565701
10500000502000000000005020008060407000302040600070805070003000000040308000000050001
10322247607056825585546560606020406627704020807640408028776322332060506078847030661
10000030007030000040000000604020800080205000500000704000003000000040005000500040001
10257080545220605080535387206020458080305056658652707475202825425577647050307453801
10007020000000503000200050005060400020004060000080500000300060000000005030400060601
10603060744373707667302030708020406866628620857080666640203030702253802440507080701
10308040000000600000007030607080207000000000703040000000605070208000008000602000701
10406080556433844038364570734020203086337563508083365656404080202080623064865574601
10307040007000003040000050700070703000000000008000400000004080307060007000004000801
14803028357020402360873024706020506035638220888040407838848030407064803522408050701
10005000000060200000703000204060302000500030008020500070000050203000603000800070301
10444553208280255775502070307340807040238032707250444050864770604720667052784080801
10500000800040000000002050707000204050007000807000700020400000300030007000004050301
10278860556088652342244430708037304035402820805053744230202087474087303752308770501
10000080004000000000000060506000003000600030308080000080003000002000400000400000301
10882068507036476577784070205468283448346060407077734066272088205430344480566870701
10006000003000004020002040006000008000006000805000700040006000607020004000200060601
18206073645870606050203075787020606030404253603040807050405620605025663053608032401
10008000500040300060300020000080600040800000504040704030405000800070006000005060001
10633070348050478880267220206630528630504367806320206770508557848420402448557080831
10002070000040600080000000300040804000400040007000600000300000000000300000000050001
17805072837340437048262588627720704075824060572038422823846253256656526635236386801
10002000000070000060000000000000700060000020005000000000000000000000000000000000001
11111111111111111111111111111111111111111111111111111111111111111111111111111111111
