11111111111111111111111111111111111111111111111111111111111111111111111111111111111
10000000000000000000000000400000200000000000000000006000000000007000000070000000001
17324040636532548660205842202032808240283225688556503740807645643046703070752870401
10000060006000000080200060006000300060000030000000400000600080003000204000600000301
15507427503030754070235630503370436055522075635660406047277060707240204078505646641
10004000700080700060700000700040400030005000006000502000607000200000805000600000001
10558080284230803840705048237020608683404388407035604080603058382485702780877383601
10007050600050707020002000002070005000503000600020003050002000000000800080000000501
10807060708054202030232638404072532030407030805230824020832066877340463050768530401
10400060504000300030500000002000000020004020300050304060005050005000400050005000301
10342760878830743767807025446676867734757720808760708057805850208030706345735088801
10000050000000200050004000500000500030000000504000300080803000304040500000200050301
10526072502747577060384825406080606070387844706020786470204086204087254650203450601
10007000604000000040500000807020804000802000004030500000700060005000008000600000601
15403250755060273560407380804030305764607023637050207223557540244388403075808725301
10003030000030000040008000702050507060005000400020200000800070300000506000200080001
10268030488788878057586060407060705040438070402637846850605020503370205330456020431
10003060000000007070000080502030002040006020307000000040006000300020600060500080501
10804030246274505030805457707034423030507760806088536044605243502084876060446680601
10600070000040703080306000006000000020800000603000205000805000204060000020300000201
10544888675070303040878060848454662830306537603660803770435020452080364640402388401
10600070005000705020002040000000600030506000600000300030000050007040400070300060001
10406070504537505037206044807730704060502070473862774070256548705030602060588030251
10007040702000307020002000500070808020400060700000002050400050006000808000200080601
10852040508060804040486320543570507070525047307083606070403860277456308750606270301
10400080406080004060000020008000808060003020007000403080502000600000800050200000501
10504630703034358044243085803025602088404530445630407060604085507050306056322465301
10800030208000500040005000304000004000500040000040500040003000005020803000300000001
10657080606270803876204660707064445480855073323058822488335547276030262340806075381
10007000800060503000203050008000000050004000000070004000000040000030500070008040001
17728025762020802020302050473575372066308852303640704050254040468470603750832070701
10002000500050500070608070000000003000203000508000700070006080007000500050604000501
10308565604630544760806037602547237560604070378075263057707080748042347080603382201
10800000003070000080004000600050000000300030005040007050007050500030000030700000501
10747855786070277028727540306060806373476728704030707340352047702860806070238540501
10004000000070702030000000808070800080002050006020600000200030005000606050003000401
10406064877450607040505625507020477660405050822030447233705060565060504480706030601
10402080000040803000800030302020000000300020000050000070003050000060700060503080701
10506070374060704082526070507030527372748443265222285050573463657020783070605020701
10500030700080002000208000208030000000000000000000004040000080006050400040200020601
10763887607047724240305064304040368647842666342380203083552080604720407832537380501
10002000003000003000506000408040000000000000000030305000002000400030606000000050201
10203078482365405062705250605053403435722448624070307567502047423060403464845070501
10500070000030002000002060405000800000000000006080700000506000200070300000005080701
10354350552020466052204080305730257077557066705078487720504850607780446686502074501
10400000500030003000508000600060007000006000806030000080800040200060006040004000301
10873256503068402480647336358522704355305070404050222040423020702073202070232620501
10000000706000707000300040000070002000008030407080300070005040708000708050000050201
10805670607860507078707040803080703248552220702030805757304050838050402020777040201
10305000307000408050005000403000303000000060702000304000707040006050700030600020201
10244088704036808350262435522844473058282060602064708060408084707020588040205730401
10003060004070002000600000000000002030003030804000405060003020607050003040200000801
10308060225840436028208054676826707550404078608583705072358050804677207030777655301
10605000700000700060008000000000500000708000005000007050004040006000005050000000701
10805353305854703770406256565457242572208083637055742070303052772064624674544580401
10204000800000803000200000800000000040705050002030004000202040000080000000007050201
10602020556660607062424280404773662030808340808840708632724020648727524744602050401
10500070004000800020003000805000007070400060400040603000800060000000700000008000401
10204648305025426623507087407087506020505060738020302050305038634540607068376346601
10400000802000000000008050005080803000506070800020705080008000000050506000000020001
10637865807036255753663440305030402344808060302230306037623672824040806032538040871
10000030002070000040000000705070200040408000700000502000008000000040005000500050001
10224070682520504050536528308020868020704055435258208438603445688258755080206776201
10002030000000702000700060007060500040006050000070200000700080000000006060400040601
10406070753567205464808050505070608857478380286020288560807060802533402720407040401
10208050000000700000002020308030705000000000802060000000703020703000007000806000601
10202030367623232032426620736050204058277435507078725485705040503080368045272575601
10302040006000003030000080400020203000000000005000200000002020402060003000005000201
14202037335050503620372034705070807087288860576060204727275040406038406267706080401
10006000000070200000802000206080306000400060005080300050000040603000208000700080201
10744685702440676766302040408880406050383057304620848020862730603730823042774060801
10600000800050000000006070707000707060007000505000200070800000600040003000003040801
10586640564025662685435720806072403043602680807026367650406036566076802573807540501
10000070006000000000000070204000002000500030203020000080008000008000700000600000201
10847086704055557363463030606545243252874050304084365045256087603320734870554440801
10003000003000007060002020002000005000003000207000400030007000807050006000600040401
16507043838820205080203032636050604060202375705030303060706650602047763032707046601
10006000200060300020600060000070300040300000604020604020208000200070003000003080001
10687050625080276360654520606820825530403786302660603650204357733880706877466040281
10003040000080800040000000300030407000600020002000700000500000000000300000000060001
14608026858820775022486527655640404022442060656055533754648265782324544647635572401
10006000000020000030000000000000700020000070003000000000000000000000000000000000001
11111111111111111111111111111111111111111111111111111111111111111111111111111111111
