11111111111111111111111111111111111111111111111111111111111111111111111111111111111
10000000000000000000000000800000200000000000000000004000000000003000000080000000001
12752040632855252270706832503036603320345326582786602580503434847056507070268380401
10000050004000000070400080008000700080000040000000300000200020002000204000300000701
18706435304030873020488720208680577073457022355440404053587080606450504026708332261
10006000400080700080700000200080700040006000003000203000605000200000707000800000001
10757070653670605650706077472060508452208272308048405060608082255555503430544234501
10005020700040204060005000003020005000708000600050006070003000000000200060000000401
10203060603032402040853675603073646060403040207230828030526032866530472020755550801
10500030402000800060600000005000000060008020300080702020004060004000200070002000201
10238480824780787556408042227275827277684770207380408043603660505020207444287042501
10000060000000400060005000500000300030000000503000200060805000206070200000200020401
10748032302582865070352267808070608060537337707060223460803076808065788840204550201
10007000706000000050300000503060406000806000004040600000800060003000002000600000501
14202530227020887230308250508050507785807037484050707443538350252525808075307225801
10008050000050000070006000202080803080004000500070600000400040600000807000300070001
10888050327357787062455070805030504050676070608658483330402050603480305850487080321
10002040000000007080000060408080006020006040203000000030008000300080500030600020401
10503030332853504050703664403053236060405760204023247062203324702066458030827380401
10500050000080306060205000005000000070700000806000305000408000506070000020200000201
10332272368080406060735020355878228330604834407760407520583070322030523230807832701
10700040002000202030008020000000500040804000400000700050000050005080400050500070001
10508040402835702025302074205450504050704080248682427040588768503030604070832070841
10008070705000507050004000300050604080600080200000004020800050005000806000200070401
10626040503020203070547820334780606050644048808057805030303680658377304530408280301
10700020408040008040000020005000602050007040008000704040707000700000600020700000201
10404580707058833083644066806072603048304820256350605050602074608030607084322653501
10400050202000400040007000502000004000200040000020500030007000002040503000500000001
10435070206770804867608430306085672550477083777022566275536247255040576670206082631
10008000600030204000207020007000000050005000000060004000000070000030400030006040001
15423036288080707030503070635648852034402262302550405060854050388470708620268020401
10003000400060300060504080000000008000803000704000800070006060004000300060705000801
10807783503230886830303088203553426220507070775052652037502050385023448030202526401
10400000002060000040002000300020000000800050003080006040005040600040000020600000301
10233653665040428042565880207030408562733585606060806870762046404370806040248630701
10007000000030607020000000608080800080008080002080600000500040006000407040006000701
10608078334320302030207628207070676560207070845040633763502020326030602720407050701
10207050000040304000700060308080000000400060000070000060007030000070400050407070501
10204060574060603056674030702070484722875377857536356030327774354050685040607030601
10500040700050004000704000803080000000000000000000002080000020006040400070200060701
10836244506025827820605085803080584754363722632840308087642080507240507247537550801
10004000008000003000406000808050000000000000000060205000002000500020403000000080601
10805047684688506023708880708063502658458633227070207753707052473020506833723070801
10400040000080004000006040406000800000000000003020700000808000600060500000007050501
10288560842050576068403080206520853055726078402038243830508870604430858236504063801
10700000200050008000702000800040002000006000506030000060700030300030006050005000801
10845566502046704680354566675848306286308020708060382050468070806073403050476530401
10000000208000304000400020000050005000008040504020800030002050408000603050000040601
10502420506420506035407050703030204342726580503040406257706060445060304080448030701
10302000303000806050005000803000207000000040708000608000604030007030700070800080801
10686072806043707550743354482522767085422070606078504080802035505070233030803450701
10002030007080005000400000000000007020007080207000606030005020203060005060800000301
10306080432870774063507048525557202760807088508455707064382030203732803080783782701
10508000800000700030008000000000500000305000008000002080008070004000003080000000301
10507676308232705470508776855366523582202088884036427030608047488087822624273570201
10808000700000203000500000700000000050203030005050003000308060000070000000007030301
10806030763640506053844720203736428070805380405580807445788020853673355445302080201
10800080004000200050007000302000004020600070300030602000500070000000200000007000501
10702636705058488335306023707023205060507070532040305050507088243870804055846328801
10500000607000000000007030003020307000803020200020304040006000000060705000000030001
10765347707062738778344520203060702776302040505380304063448273687050708025775040541
10000040002080000050000000808030600030207000300000603000008000000080005000700060001
10638040372640302050864666703050345050403047438458802484706475228836837050407448501
10007080000000304000400020007050800030003030000020800000800060000000005020200060701
10606020274632206336408050208080606584743670567040773460405080207544403840707080201
10406080000000800000006020605070602000000000607030000000604030305000003000808000801
10206080426423475057367330363020202076384548802078547685503020305070323034253427401
10804040005000006040000040800080804000000000005000700000008060403070006000007000201
12404057625050203360546038406020803068448320552040204834667020708035705327705040601
10006000000050700000804000704030705000500030002070600050000030503000404000300020701
10688526806270583428407040206780307020785078304640435030458630708250843038668060601
10600000700060000000003040305000405070004000604000200040800000400050006000002060401
10335370738044745378626220502036702062503360502084434350406074347073607743303320701
10000040004000000000000040802000007000400060605040000040002000004000200000800000401
10547072307077378646836030403744562325526050704075443058672088603750263760227670501
10003000005000008070004030005000003000007000404000600020005000202070004000400070401
12204058348620506030704075553040607060606826702020505050608870207055442027206036701
10004000300050600030500030000020200080300000403070604020703000700040008000002050001
10788050236020382830438320304260752850405327603360506330707375552840604772833020331
10004030000060400060000000500080503000700060005000600000700000000000600000000060001
12608033288770434027766477438570604065678070348055527565687375775626264885427383801
10006000000040000060000000000000300080000070005000000000000000000000000000000000001
11111111111111111111111111111111111111111111111111111111111111111111111111111111111
