11111111111111111111111111111111111111111111111111111111111111111111111111111111111
10000000000000000000000000500000400000000000000000002000000000005000000050000000001
12453020427286382470304725804057303260724466238857308480704333587047703060328620201
10000040005000000020600040006000600020000040000000700000600060005000204000800000601
12502444206020278080668450205370333055665048254780504053378050702470207065806778281
10008000300050500070600000600030300070005000006000803000403000600000805000800000001
10888050732770205820306087554020204342806754502075604020407022267473708360345255801
10004020400020307060006000006070004000703000400060008070003000000000600070000000401
10207050206084406060488664308027565070504030205340686050443075642760273030676850801
10800080807000700060200000005000000030007060700060503070003050008000700040002000601
10343330265380526467503075458863658452346660406540608056708440305040506676436042301
10000080000000600080005000700000400020000000808000600080704000703080500000600050401
10587022403257773060372586704060608040447757805030457470606028504073653280308430501
10008000702000000060500000603030705000505000003070200000800060008000002000800000201
12606440753070756470404540502080206672602078622020602828686270356725804078404774401
10002080000080000060002000608060306020002000800060700000700040800000306000400050001
10443030443642347024675060806060607030674050206246845270504080507350605840286070781
10006020000000008020000070703030005070008070606000000060004000400050200080700020701
10607070784833305050407685303027457040504730203033735087807527802063753070757340501
10700060000030305060208000003000000060200000807000507000407000307070000050600000801
10772844547080408030725040247578442620305274205550206250327050542060686640203386301
10300060005000407080003020000000300070505000500000600060000050002030500040300040001
10702030602356507034307054605640807020604080342888722060338878405060307020225070461
10002080208000807020002000400040608030400050700000008030400080002000403000400080301
10245070302080302080855230535580807080556036204072804040606870882728503640803670801
10600040407060008030000060004000508070008050006000406050807000800000700070600000501
10304550507035453088653087605066404053307370266760503050403058505050403042254443201
10400020207000500080004000503000003000500070000040300050004000008040407000500000001
10875080707340402836307220606053884370452036848026327282444657455050663350704087871
10002000600030207000305060007000000070005000000030003000000050000050700060008080001
12837086888080408040806070886837443074402625404470405070355070228770505360732070201
10005000700050500050708050000000008000702000302000600040004040002000600020605000701
10706423507240523320204078506623242440304070458054288053404040653047438070707326401
10700000002060000030008000700080000000300080008030006040005060500030000050300000601
10443463877060623084462730203020305333222585502060708570627072308760407070532750401
10005000000080202040000000307040300020004080003080500000300030004000708060003000801
10704056648240406030605253805050557270304060727070582658707030454030603330507050601
10802030000080207000700060204040000000600070000020000080002040000050800060208030801
10807040353080802042378060306040362735286562787364284020454748783020762080702050701
10200060400050006000308000202040000000000000000000006060000080006030200040300050701
10284576403034783580404025405020646553668464435770606025257050207330808733578240701
10003000006000007000202000507060000000000000000050306000002000500040206000000030801
10404075358663602046204480407036806246648836528060207763504037477070407677368020201
10400080000060003000004020807000700000000000008050500000807000300030700000004080401
10682680626040442044705020706620563062452027408037542260305360607760554836605065201
10200000400020005000304000400060008000006000306070000080200040600020008040002000801
10764475602085305250587432224843206643707080306020335020754020407084506040286550301
10000000406000703000600030000080006000008020703070200050005040804000402020000050801
10208260303850806068406080603020405564442460804050207735608060734080305030836080601
10708000406000506040007000403000303000000080403000705000707030004040200060300030601
10574044706024202370743566287466388077636050407064302050707086706050823080603630801
10003050008060004000400000000000002030005050605000402030007030707040008030500000401
10202070584720263048808062478482308330408043205546802032447020704858204060364862801
10407000800000700020007000000000800000606000003000005050004050004000005030000000201
10603727302683707270404646546756364443607024745032822020204044848047456865853350401
10408000800000604000300000200000000060408060008060004000306070000030000000008040801
10808040823730207075242520203762434040308230404460804868468020664633887565805080701
10300070002000500030005000708000002020200080600030206000700050000000300000007000201
10705478206072842424607042408076702060608070288070304050503073863550704086232457201
10500000307000000000008020007080607000704070300060307050003000000080704000000030001
10884472305026253353865730605050703272702080604340204035768326854080803025743030521
10000080005080000070000000705050800050704000400000204000008000000040004000400030001
10667030238320503030352337404020863030203048338528308256402666347653526080608463201
10002050000000604000600080004050400030006020000040400000400050000000008020700020201
10208040888886204875305020803080207624582320355040762270402070305365608760704050201
10308020000000600000007080506080205000000000302050000000307070605000002000304000801
10507040638376263056276320446050804073273634602032272458608020406030227084824368501
10608030006000006040000020600040506000000000003000500000008060602030002000003000201
16204076643070507620835045506030806023324480247080304448647020504027503262203020301
10008000000020400000304000405020207000700060005060200080000050502000306000300080501
10867884806720474584603070208450306030783044702460675050583780404480756062785030701
10400000400020000000004050308000406070002000806000600030400000500070003000006030601
10343340762085664845848630505038608052706220704054668740506064284047606256803840401
10000030007000000000000070503000002000300080206070000080008000004000500000800000501
10526045606063256478485070502438787724253030804057732032822062504870446550534750201
10003000008000007020007030007000006000007000603000500050006000704020007000800040701
14808047775750302030502033488040607030703333403020303040806760406067767043507062201
10008000400070600050300050000060400030200000602020402070505000400060005000008080001
10825020387060333540266350406480577470703268502450504550803255837260608486582040631
10007050000070300050000000500040403000600070002000200000200000000000200000000060001
14505023833880827072835735687740206086633070864043755682248347347245762675877656201
10008000000080000080000000000000200040000080004000000000000000000000000000000000001
11111111111111111111111111111111111111111111111111111111111111111111111111111111111
