11111111111111111111111111111111111111111111111111111111111111111111111111111111111
10000000400000000000000000003000000000000000007000600070000000000000000000000000001
13603050703448428862735756504030763266287376405080358030608362307760508662738757531
10002030807000000000000000804050008000008000500030000040305000200040200060006000001
10704220402070384265676240505050303020402070374822705370702048875050247420705068201
10700070302080003000006000608070300070600020002000305000300020000070000000400030001
10722040304030508030604084703070826030657675506050568058667040283630485567667040831
10003070002020800050407030004070002060002000504040006000006070700070008000008070001
10333060627080734577502070734052404880502060408082408076805220402045304738607077501
10700040600050000000603030007000300060705040500080008040008000703000400000303000801
10302343502057726730207076307860782050702020872840853830208070502630364470208073601
10800000408080003000606000808000500050200040000070007000806060200050000020003050001
10285240407030207060505080308037843050826243648084606072554088562053665060565060871
10000040306080206030305080700040002050000000006030600070008000000040002050200080001
10484030407080232087302080863335302036275826207020308220505746482220407070508355701
10008020002000500040005060000000205000008000708000703000600030000050400060206000701
17508038535420208870808743425430407086808080405732508055546070386830206020802085201
10004060000050507000307000004070005000303030607000703040004050000000403040200080001
10788080433080803034235030508056327340302030607050845040873030522646208850687750321
10002040600050405000002060800050005000604070006060000040000060000000400070000080001
14406020402370805032608080658650704377704045636070244856504542882620425050738060501
10407080600020302000400050002000505000002000000030000000605000000030600050308070701
10703030805083803550485756877050206038285024422674628520838036875070302440806036601
10007000204000700080008000200030505000007060000000000050000050000030500070005000301
10682872582340808042308080306340406328308020508247376037232540326270472037648660301
10004000600000603000208050400080800020003000500070000050000030000070008070008000801
10607770407243347320302060437060672050504342788040634664756040444084238050703083601
10700000305000600000507020002040005060200000003020000000000050400040003030700020001
10265642508060803077768058507062745080455530807037784823705640508070408670775860441
10300040007060006000700080206000003040600050706000004000600080506080800000800030001
10203020774020756542706580603662708860307080408250804540682350602560677542805682801
10808000600070200000600000200000300070005050300080800000400000300020000000300000801
13508025702250804540802686636320554040283030255050644258306348586072562820846730301
10003000406000205080804000700030008080700040300050002000506000007000004070000000801
10325630403532305040483040804048208075603030708877633050364033205020506070774586801
10000070303000006020005050008000703060006070208000002050003000403060700030500070001
10764043502033488060307074827760407070286080604032507050204686502053603440602080701
10006000600080004030506070000080003000700020300070700060600060002000408000302040401
10706050723440805030208070848087763056806060274860405530372070652740507033405020401
10703050000070200080205030400080002020004050000060703000500030400050706000008070501
10303386457040203237303040333240608640377060305050463070506470825020307422572040431
10700000005000602000700020003030800000800080408000200030700050004000804000005080001
10637320708475642020487453808040657775473080758758206642807068605872406075204030801
10000030400000000020000000208080000000006070002000200000202000002000006080400060201
10257028382564872064278330208080287676402026306040424470785736263568804020235630801
10300080000000004000000030007030700000002000800020000080000000000000808000600000301
10403250267274405883277728872030208548744850868543325070868758773760745628606776501
10600020700000607000002000000030406000600080200000300040000070000080000000607000401
10544030705030706058407040278440604760604420305480804475428080377070784760526060201
10003000402060603000500030000060700030507000600020304000300070700030500030007030001
10308286202350404640305238254020462050706080875070707270623570602030722085604072781
10200000008000600000300030000030008000300040500020200070000000602080004000505000801
10538287837058755280343040445685307542625735208720267072846487208033406070407770401
10000000002000500030006060000020004000000000700050008000000050008000702070600060001
10887078806360432050702055373080272064533540577060308378628040464460503380233048571
10005000400080000080406080003060000050000040004060500060005000600000500040008050001
10608840767020702730605030605053632445738020506058742040304333404636843052702060501
10500050700040800060705000403000000000000070500020000030700000300000007000005040501
10847055606020645050603553307427255785586644777860326880557830256034804786642030201
10700030007070300060200000200000000030000000300040300000700070003000300040005000701
10708720774070524370773240672568382030888670806070607766305053302230803058408033401
10708000200020007000500000600000200030000080008040002000003020006000504070008000401
10204038872826807045404344602630706556535060364086444080485350246074348050505830301
10707030000000206000300000008000600000000070004000000040002000606080002040507000601
10607082426530708420847757558043763342264737252034643878203072807053506040485084201
10805000005000300020000020008000000000600000003030000020003000705000008000700060001
10702366804030587044448070407832874620604086207080643060375570407730577760606820881
10500000200070200060002000600000003000206040003000800060400000500030700020700030001
10465280838540502720307450772244208060606040283260558440307643322070202058874050201
10000080600030200070800060008000402040508060200040600000200080006050008000007070401
16488080435030862040607042808030202074603020602034408280882027606066772655437080701
10800030300060006000202000602040603000002070304000500080002000006000500000005070301
10806040408062806425584620565020306064747640608060223070506683582480706044307084801
10004050006000608000600060000050207000007000508030300080400050000040003050004000601
14467834807370506640708057557430505833674087407020442088644080703033686220324480201
10000000700070800000802000000080307000008050007040003040004000706000500080000080301
10652780508050858874607726284020208043303080352478303260507623603750604082785020801
10500030408040000000300060200050402000600070600000400000304000606000404000007000201
18206070804058854858454050202270702860878660205050686272505570406088505664803258201
10005000702000000020004000600000600050000040603070000000600050005000208000002000801
10625748272557788850708643373568666522872070203066647260886046368666806043722030501
10000000000000000000500000000000000000000080004000000020004000000000002000000040001
11111111111111111111111111111111111111111111111111111111111111111111111111111111111
