11111111111111111111111111111111111111111111111111111111111111111111111111111111111
10000000200000000000000000006000000000000000008000700060000000000000000000000000001
12207040805365734224846757408060385246627764805040347060407637305280507382837867651
10008040402000000000000000503060002000008000800040000080304000700050600050007000001
10506780607050854474475780508040802020202080567477603430704062427060835870702047701
10500040606060008000008000303070400070200070002000504000400080000040000000200080001
10378060508070702050304063806020258020742323804050554062264030376440524487762020281
10008050004050600060604080004030003040007000608050002000005030500060006000008020001
10462020684040825346306040824085404420803060602087707082705780403056802254808076701
10500020600050000000307020008000700070307020700080004040004000302000400000707000601
10604427204053633820402088706230283030405080276270672750305050602370743620506023201
10800000205050003000705000505000200030300080000080002000302050600060000040004050001
10687280203050706030808020804044527020862226445057207042253034432038663050784050841
10000050405080606030808050600030004060000000005050700050003000000050003030700020001
10522060708040836078607050824648602082225585604080704240804743388550507080306863701
10003050008000600040007040000000605000003000705000402000300080000030600060206000501
14604065725360505560304258748880802047408080802658507045324050443550303020807062401
10006020000070702000308000006080007000407050302000703050005040000000503040400050001
10833030458030706046876070707054483430203020408070564070435040875786707230826840731
10005050700060805000007020300040008000603080005080000050000070000000200020000030001
17703030605460805057602070654860207576704084884040528464604455662440832070237060501
10305050400060408000500040003000607000008000000030000000807000000060200060306080801
10707080403038503870552265652070707027422038482567882780525058764020702460204064501
10005000802000800080005000600080303000006050000000000080000080000060200050005000801
10847864636230305044303060702660604487305060805228878084862580734560363076783770601
10004000200000504000705080400050400080002000700020000040000020000080004060007000801
10208360407763247730406060242050832050605262737050846476642020437086638050705075401
10300000808000600000408060002070007070400000003060000000000040200080005080400060001
10578747207040404072375035704033637030443580204084552637206360808070708330788230521
10800030006020008000400060706000008080800070604000008000600080505080500000200060001
10702070884040574348504240608226207230205040602260704550527460402860234372602385301
10707000500040200000300000300000500060008080200070800000800000500020000000300000701
16605034607620706260805567727460786040254050538070785455505857427077655720635720501
10003000405000706050207000400060008080700050700020007000202000006000008040000000401
10544650407567403060856030308047607088206030206626627080655045805070502040472243601
10000040404000007030003030005000808070006060506000006080002000805030600070700050001
10322074407032465030404024538640505070678030704052603070306528708045603630504030201
10007000400030006080702050000060007000200040300050800080800020007000806000404070501
10602020472460603060803030876085482088507040452330606470742030324750603035604060201
10307050000040400020505050500040005020002060000040207000200080600050707000003070301
10704758453040404267607080664740807430383060605020722020804350252020308246275050831
10700000003000706000700020004030400000800020604000400020700030003000808000005080001
10336460308348776070832655805020386744524050863744803885807072807665206044706020601
10000030500000000040000000804040000000002020007000800000704000002000007030600040501
10257032236774345052734750206050674367706086802070254860647644573647605040358240301
10300080000000003000000080002040600000005000400080000020000000000000504000800000501
10806770672282205782886237568060805827682330624835874030586367255360627857202668801
10400070500000603000004000000060205000400030700000800050000050000020000000603000801
10423050806040502024503020555840407220503870602240608676776070823040735430636030701
10003000306060405000600050000030400060406000800030206000400070500050400060008030001
10703753602560407770505837466060622040506040566040802630248880807060585026603074761
10600000007000700000800050000070003000300030400070600030000000505020004000408000401
10528663736076576770444060455244607362732558504860558024477888704048302080803840401
10000000003000200070005060000060008000000000400080003000000030002000305070400040001
10788036707570574050808036384040552063234470423070307682687060463440205460855036381
10004000500030000080207080002070000040000040004080700030008000400000200080004020001
10302350427020704660408080602047754844554040604035835050708643502256443036707060701
10800080700060800060308000503000000000000040500020000080600000500000006000003040501
10278067308050333050608863807883658354227578644660556230556430484034303378455060501
10400050007070700030400000500000000070000000800040600000300080002000700030004000201
10308670247040824670453240565327258030363760708070402725303045408260203063607072801
10602000400040007000500000600000700050000020004020005000008030007000405080007000701
10206052862535207056804326508430806646332040283057543030276430762065855070706570801
10304040000000205000200000006000800000000080006000000080008000507020006050807000301
10408026224870306680784826585026564672835622652058437673503086204022208060223034701
10708000005000500080000080004000000000500000005080000070005000603000002000800080001
10707824504040765042852070205627876680605037408020886070228330804420646430406250221
10800000800040400060005000300000005000805030008000400050500000800030500070600050001
10432460875560707370703530434278305070804080862820582270203263654030405028372040601
10000030300070400070200060002000503060604080500060200000400030007050003000006020301
12323080243070228040706065506020403036403020403065503750575067608074732384473070701
10800060500080008000606000708070602000003030404000700050008000007000300000008080501
10704050208058506565528750454030707044638220805040283020706643386470306075602026401
10008030008000802000400030000080202000005000802080700060700050000050006060005000601
17654422602550405670805074264370203557288024807030577083767050207056723650542750501
10000000800080600000202000000020307000003040008020005020003000805000300070000040801
10775360607070475454303722486070204023206060327488206240702688208620408055652020301
10400050803080000000200030800040508000200030200000300000204000208000307000003000201
17205040805034465782637020302440808850568580508030776886203270408066804455607422201
10006000303000000060006000200000800030000070707070000000700020005000804000002000701
10828566278563676740702822384846285587567070206082364670658088537224305075275060201
10000000000000000000800000000000000000000030008000000070007000000000004000000060001
11111111111111111111111111111111111111111111111111111111111111111111111111111111111
