11111111111111111111111111111111111111111111111111111111111111111111111111111111111
10000000700000000000000000005000000000000000008000200060000000000000000000000000001
12408040806724832824525655204040537283527843206030752060802465804560708387284465761
10008040507000000000000000203040005000004000500080000030207000700040400070005000001
10507530506020768844678730607040406070803070555746807280704068748020728780407043301
10500020406060006000004000207040700020800070005000703000700060000050000000300050001
10857050602050607070502032602070432070843624407020345044423060426370657684643060661
10004020004070500080304020003070007050005000507050006000004050400070003000003070001
10265020228060243573503030645046305220204020804065202077507240604037806467707043401
10400030400070000000703070006000700030706070800070006060002000705000400000307000301
10206635307055538230803033802540722080404020262660438320605040706750886250602027501
10600000806040003000704000807000600030300050000030005000602020300060000050007080001
10466750207050304080708080408075753080644845778074702042327084678033868070585060731
10000040607070508040507040600020005060000000006030800030008000000080006040800050001
10222030308030366086402060347647402066868762508080705270606572474470608060208767801
10006020006000400030005060000000405000003000707000202000800040000030500070505000801
14808033256260208460404475828870203037508070302375204066773060266720407060304037701
10004030000070208000307000004040002000305030606000804020003060000000705030600060001
10328040448070306044875070407037663720206020206040243030678040687234302550623440421
10005070800080705000008080800080005000506040006020000080000020000000600030000030001
12708060705660306088207060244230704324605064856080344448607488848870757070237030501
10202020200040804000300030002000206000005000000030000000404000000030700070406070501
10306070305083807250683882672050503058646047852386725720322035775050702550703083601
10008000208000600030004000300020707000002080000000000030000070000060400020008000301
10864634354340506063303040505870606667206020705267722083778850238570787034754620301
10006000500000706000405040200030400050005000200030000030000040000070007060007000301
10302570804466865540503040338060454020708337822060585547764060727073452050606076201
10300000704000700000803070002030002060300000002050000000000080300050006070800070001
10346572208020304036777045805046567080888820504063673726808460707030202680347250831
10400080006030003000500070603000004040400050303000004000500070602080700000200030001
10507070627020642242704270204438208640408070405840302660536560708230237334507864501
10602000700070700000600000800000600080008050500030300000800000200030000000200000201
15403047605530808350203224367730585030725030777070433277606837846022542320287830301
10006000807000406050602000800020004020700060400020008000208000007000007070000000801
10756370304673808040562080206037408067307030806774855080443083604070206020237458701
10000060205000006060003020003000504080004060503000002080003000806060400060400060001
10523054602062576020405056578720702080878070506062707020508566708058607220607070201
10003000400030006070702060000080006000700040500060500060300020006000806000606050401
10707060728660702040705060357052462064805020783640705420437070874340704062403030201
10202040000020300060306070300060007040008020000030303000800060200020703000006020301
10704383564030304427604070646450203850882060404060526040704380666070405432223050631
10600000008000603000400070002070700000200050705000200060400070003000206000007020001
10482280302875728050567484503080767776373080846656506423603078408363702083208070801
10000030800000000060000000807070000000002060005000800000706000008000005070200050401
10857025237253387068637220704060753343303047606040327730663268738532708050223470601
10600020000000006000000030008070700000003000600040000050000000000000308000600000501
10404440264464406664572262342020707766638830844854374060782443865560572866308628601
10800020700000507000004000000050805000300050400000200020000020000060000000402000201
10636060204030406057202070342760704320203730505280205863448040588020325420384080201
10006000308060403000700080000030300070406000600020207000600040500040300030007020001
10706627508880606350303446843060837080806050274060208320468660503030846058408024551
10800000006000500000800040000040008000400070300030400040000000407050003000204000401
10535476423028545270648040232646605285324362402750657052685426607077404060202860301
10000000007000200040008030000040003000000000600020007000000020008000508070300050001
10864023805420762040307042382070352048855830774040303534343040332470607580528025641
10002000400040000060405020005060000020000030008030600020004000600000800030003070001
10508420438040406470307080305067333387723050502037438020204334508522752043608070601
10400050800060500050607000702000000000000020500030000050300000800000002000002070701
10272088207050825070203585202355857363774627445470838320285750454085305642725080301
10200080006060800050800000400000000060000000400080200000400020005000300050006000801
10407260326080524760373830465536287080768870603060603367808064706880602045803084401
10308000300060002000800000700000700020000030006040008000004070005000206020005000501
10808055226278608083702683507820507536256080826043384070676730357055868040508820301
10203050000000307000600000003000800000000020007000000050006000204070007030204000601
10804038553680505280386545345084543623474222483047458482407062505067705080624087301
10405000003000700070000050007000000000500000002060000020006000507000004000300070001
10307535704080746038322070605825283420704057404060566030884260606350733420408350561
10200000500040700040006000200000003000803080004000400060700000700040300020400020001
10625440275260604760307780662864706080304040657270236370808728224040305053452080801
10000070600080300080800040006000203060706020400050700000200050002060002000004050801
18234040677040368050502054803050506078204030704087803730486056704088745225752020801
10700020800080008000704000408070206000007060206000200040006000003000400000004020801
10606020504065808382445320653030306023367330805040352050503443272730203048604026201
10003060008000408000800050000060708000002000706070600030800070000050002080007000601
17663444406730306240703078766640702255866074208050386085736030506042426670364740801
10000000400070700000205000000060206000004020008080005020003000204000300040000040601
10277270702030647745403863475020505032406030825224803850307287302820508063875050201
10600080807080000000300020300080206000800070800000700000602000405000802000008000201
13706060808074542272486040304350503740464440708040578773803340305065806527704723401
10005000403000000050007000400000200020000040406030000000400040003000508000002000301
10334632224435776330208388848768266485353040306074232330323028688345704028367020701
10000000000000000000600000000000000000000060008000000030002000000000005000000020001
11111111111111111111111111111111111111111111111111111111111111111111111111111111111
