11111111111111111111111111111111111111111111111111111111111111111111111111111111111
10000000200000000000000000007000000000000000005000600050000000000000000000000000001
14302080704383368258632232603040448364748826808080848050408665606320608628635522481
10008070802000000000000000306080005000003000700080000020606000300030400020006000001
10308460504070886485665270407070503060704050524253403370302056727050542320808023701
10200030705080007000005000605040200020700060002000807000200030000080000000300030001
10233060405020303080207048205080848070243622506020843074278070854650434322574070251
10002070008080500050706060004020008080005000307050006000007030500080006000003080001
10342030534080833273402040455045607270307080604067205048603460405066203776404078301
10600050700060000000207060007000300060805050800040007070006000405000700000303000801
10404844506052578560806084402750566040407080685660553420708040203550237820607044201
10800000503020006000302000302000500070500060000050005000605080700050000020007040001
10238880304080702070207070203037365020548786486023308053685044728072752080482060831
10000060206070405070202030700070007060000000004020800050004000000050008030300020001
10368080403040567042806020388878702065654877203050306780406566633250302060808653401
10006040004000800030005030000000608000007000208000808000500060000040500070802000801
17805076642270704770305427867820402026507080706264605077235080528770203050607028701
10004030000050806000204000007070007000303030303000603020003020000000307020300080001
10448020436060203074525070803058556540205060502020824020536070262883706470743550761
10005080600040202000008070700080006000308020005020000080000040000000200030000060001
15607080508680805072606070684460405846205044837030767847407785375760324080563070301
10607020700020505000600020002000805000004000000040000000302000000030500020503060501
10704030706078208280733334238020406072588076483353773840358057726050208570504072401
10003000706000400070002000500020203000006050000000000030000070000070200070005000401
10376626382570702047403020404370608868303050403778432025765650254530825086884250801
10007000700000208000803020400030300020006000700040000060000080000040006040008000301
10406350807624234740203070646030464070804327684030778426834050474063786060203076201
10500000803000300000803060003060003040800000008020000000000040300050006080600060001
10634648706080502062777057205073632050685880806076522667706230608060208520687780431
10400070007070003000700040703000004050400070603000003000200060403020800000200030001
10603030776020745725603360803853308440605040504820706650575580808820562464803765601
10808000300060600000200000300000500030003060200030800000600000200050000000400000601
15405034302280302780708424828370242080232030854070245336302874647074258540585240401
10005000305000808070305000400050002030800040500070003000608000007000007020000000701
10767450305734508040786030704045403025603050506688544060884084606020805040468655701
10000060205000008030008070003000302020002070207000006040006000407030400070200060001
10625073202047535050502065823840703030337040707064808020205872407077308870708060801
10005000800050008020603050000030003000800040600070800070800030005000403000808060801
10502070865640703050706050385068833074705040783270506580358020658420307057406020701
10307070000080700020605040200050006030007080000030702000600070300060306000006040601
10308862233040203234205080736830707750852070407050434070205580488050406774354080231
10700000006000605000800060004030200000500030208000300050400050002000402000006030001
10462270805662884030364558205050633387842070857652808434402027607875806077207030401
10000040600000000060000000304050000000006020008000400000603000007000004040500020401
10352063453642448035435580405020672584803025507080652820654875337763208080244370201
10400050000000006000000080005070800000006000600080000060000000000000807000200000401
10205270834248502827467428248070507734446370358764566080335762843550635382508287501
10500080300000802000003000000020607000700070800000600030000040000070000000502000701
10563050403080208067504070275720208840505540407830808683878030885070254560654030701
10007000408030708000600020000060300050608000800080702000600060500030600050006040001
10204524405430404620206648483050244060704080574080808620653850802080488077807047281
10200000007000700000200040000040007000600030700050400030000000208060004000404000701
10367744285026588420682030224865508364336345403230564057744864804063202060706850501
10000000005000200080007020000080008000000000200070002000000060004000404060400060001
10838028607770668040404036383020354083325670722060503623876080564740307520642058321
10004000400030000060507040002060000020000050006050800020007000400000200080007080001
10503230822030506570704050308088758728847070402068423070706365405447882042502020801
10200020600040300080303000507000000000000050600050000080700000800000008000005070601
10275053805020853020205554607234253528688438385820756530278340586088305685536050401
10200040002070300060200000600000000040000000800020200000600030008000500070003000701
10808880887080588460377330456788223040664730702020808623504043405660402053607035701
10403000700040008000600000300000700020000070004020006000004040005000407030006000501
10805024342427403025503683802340806534328020238054444070378770346042526050706460401
10406060000000605000300000003000500000000070005000000070005000208050006080306000801
10203046847420305470722276546056275486687825522048577684606072404023708070585042501
10706000003000500080000030007000000000400000008040000030002000708000003000800080001
10707624502050856065627060402635828380407046407050536080287460703350583860203770331
10800000500070500080003000700000006000702070005000600040500000700060200020200070001
10845660766660804550508470282385803050607020282760457670703232266050308038724070601
10000020700050300060500050005000202040704020700040800000300070003050008000008080501
12582080227040623060404084704080208086207060805022802260424074808026426857724040201
10800020200080003000608000707070204000008040704000500060005000003000200000003040601
10606060803038208565538470658080303058245520703080472050402524226230506036507042401
10007040005000405000200080000080706000003000503060800030200060000080007060006000801
14336484304650508430404084552230803738535036702060487077325080202043688270237470301
10000000200080300000305000000050703000005050005050004030002000303000300070000030601
10763380203030622384407854685030404066405070678525802460205276304640405033785030501
10300040702080000000400040400050204000500050500000800000804000703000608000004000701
12406050408033734588274080803320404360233240704080532248702780305055302785202333701
10002000702000000040007000500000300080000080407020000000600060004000802000006000501
10637266732266646670402532262628438483256060704023687640287033222236307026457020601
10000000000000000000800000000000000000000060002000000060006000000000006000000050001
11111111111111111111111111111111111111111111111111111111111111111111111111111111111
