11111111111111111111111111111111111111111111111111111111111111111111111111111111111
10000000800000000000000000002000000000000000004000600020000000000000000000000000001
16808020806368743484232264605020763254246842705080656060402528204680503268577678231
10004030502000000000000000308020006000008000800030000060405000200070300060008000001
10405430705070587437473220402030506030802040885756308520705038675060828250202083301
10800030308040007000003000307070500080400020006000205000500080000030000000700070001
10574020507070803060404035307070775080332365404020325074778070282660546325325070641
10003040005060200050302030006040002020004000504020005000004030700070006000005070001
10636050575030753253403080863055805650305070308076705082607280704025404734406034801
10800020200080000000606050002000700050303070300020003020005000303000600000407000201
10602324403077774780207053607370734030705030643270266620403020703760885430202037401
10600000607050005000404000408000700020200060000070007000406050300050000060002080001
10258620504050206070503020607046354080652742873047206027424036322086824040475040831
10000070508020402050302020200060006020000000004060600020005000000020007070400060001
10888080208070637066802060552326207074856553304060302430302534825640507040306575601
10007030006000300030006070000000807000006000203000203000800070000080700030707000701
13603067363670407580705526844760403052807020708333805077558030575220202060204068501
10008080000020706000606000007030008000604070507000608060007030000000806020700050001
10758030286030306036383060203044837660408080702030267060546030253753202430844370641
10005030600060203000007030400080004000208080004020000020000060000000200060000030001
13607080307270408057208040862640408463507044844070825325302448433670324030338060701
10603040400070505000700050004000203000008000000070000000605000000030800020802080301
10207070806046306270737877757060408075825042328775487650786032536030208760802036201
10003000204000500040006000500060302000006070000000000020000020000080400050006000601
10726483686330807065805050703580402574307070405447836048786530878840287045844640401
10003000800000406000608030800020300020008000700030000050000030000070004060006000201
10602270605752542670705060244060586040706468374050563368682070823087733060705066701
10500000503000400000503030006030006070600000007020000000000060400020005030600040001
10778278304070804072384046607088625030768350607048363853208240206020806530876820231
10300020008020002000500030508000005040400030408000003000400050408080400000800050001
10303030873020726278608670808375308260604050806520404420462220304740376358402733501
10205000300080500000400000400000400050008030200080600000600000800030000000400000801
14408054408750304270603238254620338050732030663020823457206523386048425350328450301
10006000805000207060704000500020003040300020800080008000502000008000003070000000701
10442850707565703030643040207035207064505060605743627030774072303050604060282735601
10000060808000005070008020004000307080005020505000007040007000308070400080600070001
10335043208037746030208056867480303060258080407035206080407883304023508320704070601
10007000600040003060302040000060006000300080700070400060700040003000608000807020701
10604050567880302050608050733023722074203020776560403820472050482620304083807070801
10206050000060300040703080400080007060007070000060705000600030300040806000008080601
10708763734060705458405080663270506640776030803060542040806860325060806738737040881
10200000008000802000700020005050700000400060402000200050500040002000204000005060001
10267570607266373040244383602050746226224070342383203684306035303265402063802070301
10000050700000000070000000205040000000005040006000200000204000002000003050800020801
10257077483837482054453840202040455336406048708040884380673346284855306040675750401
10200030000000007000000060003080700000007000400080000040000000000000307000700000201
10204860736535304378653224857030602352243720562272426020472686733320787624707747501
10600030700000706000006000000070608000800020500000800030000060000020000000207000701
10725070802080507054808020475530202880408360503470202623487030838040825850856070401
10004000804060807000800020000050500050506000600060805000500060200070500030006040001
10206545602370206320603566876030578060407050438080703740667580208030263065203048771
10600000006000600000800020000070008000200070800080400040000000605020008000408000401
10546278547078523680334060257858607866725534208780827048642744703078203020604340401
10000000008000500050005050000040008000000000700070006000000070005000602080500040001
10283035707830638040307068528070356058577740554020402225737080645720804530877056341
10002000600020000020602040006080000050000040004050500050008000500000400070007070001
10806230386050303260704080405037466872744070205078573070408326806445857054602060301
10300030300060600030405000508000000000000080500080000020300000300000002000005030801
10582055706070856060702432605454566236573873366860856640584380282053805627756060301
10300060005020700030800000600000000050000000300030600000300030004000500060006000801
10708840288080877430687370472467528020342820507040802658405055708470204042303064701
10804000300070002000400000200000700080000080005030007000004020006000503050007000501
10805057357877507023704874303470705586878020643087558060328570652056722040407580301
10606080000000704000800000006000700000000050002000000030005000406040003030604000601
10805027536370508750664437233087566765727884465086447464503042705044208060753077401
10205000005000600030000050002000000000700000006060000020008000308000007000600040001
10604842404060742052332030703285378880502037206040433050744760503420553330208330441
10200000200030800040007000800000008000608030005000800040800000400040200030200060001
10578560238850404840504870363223407050204040243430286270207826832050506056436060401
10000020300070600040300050007000503040807020600050600000800070004030003000003070701
16538060765050786050805073204060508087807080704025402770675056703075673777354080201
10800020800050005000405000803040405000002030305000700060007000007000800000003050801
10707040305067503773745860558060806086452640705060543080608757584450503058208082201
10008030006000505000200020000060406000003000202050200070300060000060004070006000301
15567633308460706570504027356670407344448074802050424035822070803072744660433830601
10000000300030500000205000000030308000004030003070003060007000704000300050000020601
10537880508080223457608382846080303037208050648862607750607685406330508022572030201
10500030304070000000400030600020305000700060500000200000508000206000208000002000701
16206060602042486563522050503820206240488240207080666456403380706027705432306382201
10005000808000000060002000200000500020000020403020000000200080003000302000003000201
10668564874385483770504383578635234686683070503085848520527046727675602088854050401
10000000000000000000500000000000000000000030005000000070006000000000005000000020001
11111111111111111111111111111111111111111111111111111111111111111111111111111111111
