11111111111111111111111111111111111111111111111111111111111111111111111111111111111
10000000400000000000000000002000000000000000006000700080000000000000000000000000001
12303020302678226526348352807040642267324546602040665080702235306840203536775747641
10008040708000000000000000307060003000003000300070000020202000400080200040004000001
10403540606050483626834430303050704080603050676448505550505045644040835880703078701
10400080502050003000004000503030600030800070008000808000500060000060000000800050001
10533080402020802080405032807050742050334775605050823062882050434720543382857020261
10002080008060300080505030008070006060008000605040003000002030700030008000002050001
10827060253080272838603070262045308770705080608025504055607330206023706864202068601
10300070300070000000505080004000600040308080600030005050006000504000500000307000401
10307767308064678470203067603460772080507020777880884760804080604450478560702082201
10300000202040003000202000504000700050300040000050004000802040400060000060006050001
10225570403020608020505020405067584060486644352043603068562032745027265040574050761
10000050508030408040303060400080005080000000006060600070002000000040006020200060001
10354040306050653087406080424544707066573738505060602280606533427820804040608334801
10004030003000500040008050000000708000006000506000406000800030000070500070606000701
13508024565320307730508252776450706046605080404276305073727070384240305020702065801
10008080000070608000205000004030003000307060602000707070005060000000702020600080001
10483080347050808058866050706055473750607060706040526020234050788283406230444680451
10008070500080407000005060700050008000805030006030000070000070000000800050000020001
18408040508530406082303070425480604728507025825070683683503442374350422070765080401
10505050600060802000400030003000706000004000000060000000806000000030500040506050601
10207020308082306540784537358020206023852034734567646220255038584060203480503084601
10002000405000300060002000400050403000005080000000000050000060000020600050006000801
10272476634270303076406020308220208467404050507785277085228860864520557086227870701
10005000300000602000404060400080600080007000200060000060000080000030007060004000501
10602350502777678370707040623070646030203845727070265588226070625088673060405045801
10500000608000700000204060008020005030200000002050000000000060300080007070400080001
10844373706060607058826076803056756050467320508076738256406440706030507650342350561
10600080005050004000700070205000002060400070602000008000700060806050500000500020001
10505050543050435637305340204767607520207050706650207570323720307530767258307564501
10703000400060300000200000300000800060003030300080400000800000700070000000300000201
17406043406450403570508652226470637070377080574020332685705335242044233630587650201
10008000608000404020807000800030002040600050400060007000507000007000007040000000501
10335740805728307030384070607074406028705060702765858050332086607040802020755638301
10000050304000003020005080003000308040008030607000003080003000202050300020500050001
10858066505034336080502066562420702050657060807076302020708456504082607550702080601
10002000800060005030808020000050006000500020300030200020200060005000308000402020801
10807040668720305040507030387038246033807080466250708330646050253480607026204030701
10502020000050200040202060700040006060006030000030808000200030800040403000006070601
10202273255030505677606040436840708820453050804070277080302880732030706857648050341
10300000003000308000200030008020700000800060708000700050500060005000805000007030001
10356620704865688020457533806040348478767080583636706867703044307852505026405080601
10000020200000000070000000303040000000003080008000200000405000008000003080800040301
10887077378427876064268860505070586575706075404020252820773348757434802020277260601
10700040000000008000000020008070600000006000700020000070000000000000203000300000601
10503350537554703882774847547070603546623450224724246050655728336780387545303858501
10500060600000407000005000000070602000800040300000700020000080000050000000503000501
10722030603050402022806080575320507730803760603830708333376060652050334450457080801
10006000406060205000800070000050300060308000400070506000400080600080300050006080001
10705223402330504560404252662060425050604030768070506860485750204020673064407048251
10400000003000200000600050000080006000300040200050600040000000303020007000405000801
10448858472056737650347040788636304542682537505420443036325887205022402050708360401
10000000003000200080005040000050008000000000600070008000000070003000406080300060001
10358063302350476030802062644080653082652530766050703326666050732450403560264056671
10007000700060000030402030006060000050000030002030400060003000500000200080006040001
10207670762070308430505020702062685534484020406074872070502686305728428047503060301
10200030800020600080306000502000000000000030300080000060700000500000007000006030401
10567057308080286030605426502778826523824755472440728450652730674085507626867060801
10600030007080300030400000500000000050000000200070800000400070007000600040004000401
10306670256050857430774580432578658080273450708050406385407025405370504068208038301
10503000600080003000400000700000800020000050006040008000003020005000603030004000801
10706037768287703066505663206230707332485080848075553050265250364044435050806360201
10505050000000507000500000005000200000000030002000000050008000303040007030802000801
10506065678840505450637878274053365247468634866034667646404045502024403040884027801
10805000002000800080000020003000000000200000006030000080008000307000004000400030001
10305283806040345038743070803662735860606084705020374060333250207350528460804630451
10300000500040600030006000300000004000606060004000700080400000500080800080600060001
10378460278650407870503580527774704040304050582240645760308735385070608056572060201
10000040400020800050500040002000305030306020400070700000200060007060003000006060701
15445080272030768080308042505030702022305080503055307650732078207047227375482080801
10400020800070004000602000207040203000005020807000500070005000002000300000005070601
10703080303066807372348240347060705024446250308060578030804784257760506083503057401
10007050002000403000500020000060408000007000504020200020500040000060008040003000801
15628868203370303460704074835680806866682067206050323083428030708063464280877280601
10000000800020500000205000000040408000006070004050003040003000606000600050000020501
10546270304050377423506236675070404066308080564325608570402687408330707053646050801
10200030405070000000200080300040703000700070800000800000608000806000708000003000801
12503050807024546244882040708280207720686740503070377586202220802053207366206622401
10003000808000000060008000300000300040000020607070000000700020007000202000005000801
10642247447668535370504465372726342473468060608084532250433084682863703086327080201
10000000000000000000400000000000000000000050008000000070005000000000005000000060001
11111111111111111111111111111111111111111111111111111111111111111111111111111111111
