11111111111111111111111111111111111111111111111111111111111111111111111111111111111
10000000400000000000000000008000000000000000007000500050000000000000000000000000001
14804040508582773874428422506020445768378262405020567070503733508480802453345823771
10007040308000000000000000403080007000005000200080000060507000400080600020006000001
10303840606060277864737240305050404040805040754223504630507072477060478570702085701
10300080702050002000003000402040800030700080005000202000500060000040000000300060001
10485070705080705060603052707050624080683644408040788025765040673380728846558070641
10008070006070300070604020002020007080003000606080006000008060500070002000003070001
10674080635030238322804030423054206850704050606068508057508270808086708632407076401
10800060700060000000306080005000200040508060700080007050004000705000500000608000401
10302867802074524770603024502450837040204030232430832660305080405680225320807058801
10800000508080007000203000207000600080200050000030008000408050400080000030004060001
10757780207020507040502060202085867030647833224057203086563047258065864070888040581
10000030704030404030408060700060008050000000006030700070006000000030004060400070001
10323040804050875052302040325756304022476423705040802370205284278260608020504655501
10005030003000800030002080000000806000005000705000804000400040000060800080303000401
12805078877240204880306332846350503047607080306877702088534070466330607040705036701
10002050000060502000608000004080004000208030602000604030002020000000604020200060001
10376080478080706075644080205047356840408060805020434030787030353524505350574550531
10004020600060402000002050700030003000706020004060000080000070000000700060000060001
16308080205620307057304070477480405832504077246040585488703254228770388030445070201
10505050500060504000800040008000305000005000000060000000702000000020200030504050601
10507070505026503440563455553070705053832082728442726740545063686020202280705087301
10008000306000600040003000200040705000007070000000000070000080000060400020007000701
10346422827360204042302080205420602862604050405858748074225630333250555074576860401
10008000400000403000505080800080600020004000500040000060000060000030007080007000801
10505820607333328550408050627080754020403727456050655688774050766044474050302046601
10600000604000500000705030006020002070600000004080000000000020200020003070400080001
10225724302070308038273068208082628030264220704056268786506820506020404670356820381
10800020004050008000800040202000004050200040708000003000200020808020800000200040001
10404030332060835223204650506787304250408080403820505350246850602430268457602547601
10806000800050700000300000500000300040007050500060600000400000200050000000300000801
13207022408420708330603586464860245080266040373050827566805468735078874220433870301
10005000404000506040203000500040006080600020600070003000206000008000006060000000801
10837640806553707020556080204074808032503020602423328080272057206030508070353474501
10000030707000003050003060006000404050008070608000008050002000404070800030200080001
10477066207034825060502062473870805070682040606063404050703225202054503860303050301
10008000700020006040306080000030004000700050800030700040200050006000202000607020201
10704020655530403030804060723032382047602080742250707420338030348330804022605080301
10707020000070400050703060700070008070008030000040803000500050800070407000003070401
10404587735020207652208040238640408880673060206080262080602220677040607834255080661
10400000005000608000700020007020600000200030406000200050500050005000406000007070001
10342840502332352040445785207050738776827060262762307452604027604333708056805080201
10000020200000000050000000803060000000005060004000800000706000006000008020400050801
10357057436746544048264320508040733442302087503050383260722544748342502040443580301
10300070000000007000000060003080800000006000700070000030000000000000203000600000301
10804820874473608767237578654020706344768770725374673080858432875720542226805787701
10800050600000407000008000000070607000300060200000600050000030000080000000704000501
10843080303070208046307060835670402240204850807250602774273020456080282550335030301
10008000202080608000700080000030500060607000500080707000300080400070400040004060001
10602346706630703280302858558080262050405070873080406660472380708020368068206077631
10700000008000300000300050000050004000800070500080500020000000306050008000308000301
10638237885025538650734080588842804657832254703880468076727622408037507050208630601
10000000003000400040008030000060003000000000500050008000000060004000607070500060001
10325035705320422080808075677050854057277380455060805655383080735440804760628063231
10003000200020000050602070004040000060000030008070400060008000500000200030008040001
10307520862080603870406030408043462677438080203025587040308288606528672067702020601
10600060300070700040304000705000000000000020300030000050400000600000008000002030501
10444032802030238070504742403885264487377225842280238730867580457087806856353050301
10500020004060200060700000500000000020000000600070800000800060004000200030002000301
10307470553020746330682280226443365050557760408050206838804036207580305064703047601
10507000500020006000800000500000700040000070008040002000002030003000708020004000201
10802038758674604053705822602660404287545070888042683040478820768024525060608650401
10205040000000605000800000008000300000000080003000000070005000704060006060403000801
10305088537880205730247883857086547358575334832082567747508047706072406050883077701
10207000006000300050000060004000000000200000003070000030007000702000008000500060001
10603865808070654038536030303822535340403027203040636050373760507630237360505370831
10800000800080300050007000600000004000502050003000600030400000700060600050400040001
10374770477540802460708350725577807050508080686320262470503332387070508047276030501
10000080800060400080200020007000605040602040400030500000400080004070007000005030701
16553050388050868070608065205080305026203070302076506750837083708066367276682020401
10600040500060007000703000802070404000008020205000300030004000008000600000004050301
10203080505035604668776270446060708038453480203050333020406424684450306034806048601
10005020002000302000300080000040304000002000505080300040400060000030004020003000201
14282545205240502360307052733250805623857035603040345088445030804036245550664420701
10000000400060700000708000000060505000002050005050004020002000503000800030000020801
10837450708040868262803768277050504033807020648834303340205357506340402052536020701
10700040203020000000300040500060402000700070400000600000808000304000705000007000701
16606080806063528566767040303570806640556670308040288624803720704068703555803724701
10007000506000000070007000700000300070000080806080000000600070007000604000006000301
10856756358285386770405623858554437276388070503055856420376023758846206035442030201
10000000000000000000500000000000000000000080005000000040006000000000003000000050001
11111111111111111111111111111111111111111111111111111111111111111111111111111111111
