11111111111111111111111111111111111111111111111111111111111111111111111111111111111
10000000000000400000000000000030000000005000000000000000600000000000000000000000001
14508875564570845860304753266034303034404650205034705520562040606356455252554836601
10007000000030000020600000007000708000800000606000205000800030605000000000000040001
10303767726060322080746857803470306740833468634230404087703330575040324475837070541
10303000300060405000200000600060602000700020007020703000002030005070000030008050001
10504070505040205567606070363070707027407065805080804455378050707072258720407060501
10600060005080008000008080806080007000003000307000400000500020500040000000600030701
10566046663230434020362020504057232530264850803627622580302627367820636658357080301
10007050000040600020003050002000000070000040506000000070700000000000700000003050501
10404660505056506077508056846783242040363030303040332050478768752225805572306270701
10800040407000007000803000000060000070004080006060006030007000600000807000600070501
10462070308724837550702382364320204852807054433085706032306050206540404030342034401
10007000604000000070500000003000300070004020000030702030003050004000603020002000001
17405472505070403038828867563056346030408020504650708030566080327076582020204846201
10004000200050308000006040008020600020408000700020008080006060008000007060200000701
10348680607380477076204060402080702540508434556532687040703070706348704050643680321
10000000200070008000300060200020002000300000000050000080606030200000700080000070001
10352258303048408562382550737260264030588343552020746777303067328470623282776480301
10000000303000300000007000600080500040700070700070000060004000800000600000000060801
10266520867720534786303088628060406738604050805768784080847470607586208362652023401
10000070300020700000008000000050200000008080006000008050000000204000504000300030001
15487320402030507046467375604623708850774025367086255070838648673020307040708280801
10000000607080604000000000608000600040007000002000003050000060005080006050600040201
10374272304030404465703650828040742024477420805446205063528070502037773020545030371
10200030008000400000800020700030007000000080300000708020000060306000000070200060001
16607040207274287730428360804343606085226035703370405055275750603257348662204064301
10003040303000000040000030203000004000004000807000204000000000500060005000005070001
10537060267066758064236042403030863885607830802027803274302566478020803050758030741
10007000800050006060004000806030000040006020805000307000200050006000200070006040001
10804773505030505080376380458076824080677040455730306070747048505076676667603076301
10200060004040700060000030005060000060300070000060007050500040002000000030007050801
10884040536050782433865060305040564280603644566024836880307820203742322050667020201
10205000200060000000000070808080400060003040005000000020400000506000000040002000401
10403538405034366388658420603030603068742070202086424070433447324082548640803784401
10200070205000000000000020600020004000008000306050006050007000000060000030200000201
10608070203053664554838060406048847640307563607070807056307467352630434060482570601
10303050007000002000003050603070000030800030004000205000600000000030300070000050701
10643040688272308044505050708060353023845050338858606470305876865020603043632030601
10000070007000408000200080808000800080000060000000302000400020000070805000008060601
10858664305064702030355420604665277220703873757430508066722360506525406527222070701
10200000504000004040003000800080000000600060000000803070000000806000003000500060501
10302740703457373248562054655060247285564240266553806070506878202057737050504680701
10007000508000400020002040004080500000000040002050007000800040406000003050200070501
10233046705040504080405080748080703047746075504030305460535020304878508027433040601
10005000400030307000300050005040004020008000007000300050805000603000704000007040701
10608550465730606234267847202052834370204575853658624070505030804040207376808020701
10500060600000500000300020007020000060300000700050005040705020306060400000800060701
10422080407758264630502030743020827080806220803040506060605035702050538560247050301
10003030704000800020605060000070004000703000504080300040308000206060000050004050301
13845080802060508040702026264387205076702056305070737220604630304052627036403060701
10006040708050003040204000700000504000206000406050400020008000606000608000403030401
10408040202030682750707280303430605530603280472050655062647835705450304050708330301
10200040305020008000508000802000208030804080006070003000000000500020503040600040401
10827350506036303032307067402086408020208080204047304737824550802080206050435050601
10600030504020003040002000005000007000504070200020500000000000505030804040006000601
10708080703064746080702457602365482766203040268230304363437332307070205043304385301
10602000304000008080400000400030004000006020000000200000008000002050706000600000501
10708245206325706040502880855050702067227052222370406445668085857040803757776030401
10507000806060008060508000200060604060002000300080705000005080800080400000008050601
10505470505050734040504024308830804040803750708080755068202050304880207353502020701
10305000600060000050204050005000604000800000808050200040007080800000200000405020601
10405022848423434220504078432040704535566388505024308870605050566845364850802350201
10800080007000000000302000000040800000000000603000003000707040000000002000800000801
10556460304080332832402778282368637568584870654548355040405082855755802033656768601
10000000200030400000800000600000800050000070000000007030805000000000208050008000401
10886387427860805230304440306360207080433067558320606030502283365420408047505050601
10000000000040208000600040004000504020800040000050800020400000008050002000005050001
10278530453730202062585037283070888020605520483065584680405462708030656556837075281
10000070003000805000002000800040600020400000800060000000400000506020000070000050001
10855085806085803283804583806756706420643320307740242887537760403025867060327820201
10008000503000702000500000500000406000200020805000300070000070300080000050000020301
12208480705770306060325860648530407030703084405057443080846750654350306672633062201
10006000300040704030000060000070402020608000603000007080300080008000800000005000001
10505058885080703068308074562030303022607580408046507050702063508063653360207763601
10807040003040002000706000008020007000700040006000706060206040002050000070800000401
10243034305058648340802875823025642780885066783720508030505060823070657075883040521
10003000803080000000808070000060007000600080006050705020508050800020200040008040001
12703470208050605724306060566540203020405655402020605040305080463750304680805054701
10004000503040400000800070000000303080500000006000400050006080004050800000602060001
10287026302030504250455428687338703050223753668645247748588056807020806553304540501
10003000002000600050000000000000400020000000000000000000006000004000400000600000601
11111111111111111111111111111111111111111111111111111111111111111111111111111111111
