11111111111111111111111111111111111111111111111111111111111111111111111111111111111
10000000000000200000000000000080000000002000000000000000700000000000000000000000001
17708885772470424780407268386046805025505520707045704450375080208686485877246658201
10003000000040000060400000007000506000300000504000804000600070405000000000000030001
10304282775030838080226338708530605780277887265470507062806770863080482525248050261
10806000200040506000300000400030804000300060008040605000005070007020000030004050001
10504080208050704743206050383040206052706048307020204726435070803024648370208070401
10800060004050005000003070703050008000005000305000400000800040200070000000600040601
10823042536240262080257080403075775560872540803465326530602485536770256635635050401
10008060000030500020008060006000000080000050506000000060200000000000700000007030801
10304620606028307084208087377422665060537050502080733040323842753843304224603630701
10200060704000004000304000000040000050004040006020008030007000700000204000800050801
10343080204738325640608665456720205765706073322072607055203080208860306020245042601
10002000807000000020500000008000200020008080000080205030004040008000502080007000001
13704487507060402062686633636023277050306060505830708070833050328088848050805535401
10008000800040305000003030002080400060807000700030002050006020002000004050400000701
10665720306520485028207050606020406370505722284864784030203080402676705030255580281
10000000300060003000300050400040003000600000000050000050208050400000400030000030001
10373883305088402738854550442230863050675745485080826857506022322330676627684560501
10000000408000300000004000500080200070600050500070000020004000400000500000000070601
10652770538730223844207075788070208444707070706432456040387850805825203358625057201
10000080500060300000006000000050600000005080002000002070000000307000603000600020001
12574340407020407048662637305665303650238063238053246060237777483080804080508420801
10000000305040706000000000506000400060005000002000008020000040006030008040300060701
10867833703060307345803680343020333053376630802742808043675070807036465040427060221
10700030002000400000400080700070004000000070600000403020000040306000000040800060001
15402080408523533450835780405232507038868063602740403037625330302773768827203074801
10003020603000000080000050608000008000006000506000705000000000600020008000008040001
10385060532025657052222067606050536258205780405023305286507886325050302040672050251
10002000700080002040002000508030000040002060604000502000700050008000300020003040001
10507254504040208020674760522048576030526060328540407030327082607073452742807078801
10200040007020600020000020005050000080800040000050002080800030003000000080004040701
10327060384070365676554050503080426340603566625076374730306720705388872050862040201
10403000300060000000000030706050500070008060007000000060300000503000000020004000401
10802657206063358224376570604040305065524060505033363060683343724054555450503235301
10500050404000000000000050300060005000004000502080002040006000000020000070300000301
10808070607075762574274040206028547720406463506050702054607284266740724060635780401
10303030006000002000006020408060000070500020004000307000200000000050600040000060401
10247030385685408046306080305060374064566030756583507880207782823060204058632040201
10000020004000207000400070802000500050000040000000206000600020000030308000005060601
10774368302033706080466450206655762340505288263720403046742480303265608256256070501
10700000305000004080002000800080000000800030000000203020000000507000006000300070201
10302530706773384658456057584020642468434760574885806080305243507027827070308640401
10007000808000800050003040007020300000000020005030003000300030303000008050200040601
10482044805080703080602060232080708026872044702020508270657040403548206064432060701
10007000200020603000700020005020007050008000003000200070308000503000507000007040701
10704570562840804472763665808056233320802333333627368070304050402080505765306050301
10300040800000700000200020008060000060800000600020004040603050306060200000700040601
10528070306568565260506030272020643060803350308040703040602084707040864250345050401
10007030507000600080705030000080006000207000503040200060208000705080000080008070301
15348070507070702040805053475744206044204084807070827460704450303053277062406060501
10006080208040007020607000500000306000603000707030700080005000406000206000403060201
10804050604060276670205450808450603670508530725070464075783553804430304050304860701
10800060603080006000807000404000408060407040007020005000000000500050806040500080201
10586470606028206064303034205087206020405080608033702885274470503020507080236030301
10200030204030008040005000005000003000606040500020700000000000205060606080006000801
10502050706026624060803635804343466865506030772380402858236335207080605066703384401
10406000204000002040600000700020002000008030000000800000006000006080304000400000601
10304348703655505080207360356020706086545068575340602467643063254050607628842020201
10304000806020007080203000200060608030008000500020406000005080600050300000003030301
10502250505060876050203033802820504040707680304070768043802080605320605863305080401
10407000800080000040505080008000604000600000804060800070002040700000200000404030601
10505087667385786680806085744070705538853637603062204870505040734425777850208350801
10400050008000000000305000000080500000000000807000005000408060000000007000400000301
10823520204050324627703646248256558422482820654632848080706024725374302083723828601
10000000400050400000500000200000600070000040000000004020702000000000202040004000701
10583278323380605460704860303330303030264085285330307060505862838630408047508050501
10000000000070608000300060006000302040600060000060700050700000003020002000006040001
10824650678340402023552087236020854070504560448033855820602233603070352622554022871
10000070003000707000008000500050800030300000200040000000400000402070000060000050001
10568024507082507466206472505427802770237620305370574875835350402086622040783240501
10005000402000407000500000600000703000400080404000300080000050800080000050000050701
15402360204470805040486570723260307020802037703036334020576350873520606246632026801
10004000400020503020000050000060705050807000508000002040800060005000400000007000001
10208087585050606084706056347070203084805240602057506040702066507082227880307327301
10508060008080003000506000006060006000800040007000207040406030008030000040800000401
10482023405085373680502652565044734840577033458620407030707030586020473044323080551
10007000507040000000803060000050003000200070007050406040305020700020800030003030001
13204420603080807832605050327830707060505284707070604020406080772720808730306082801
10003000206070500000500080000000206020500000006000700050005080003070700000202030001
10387024507040602560755486674858403050466736272285827847536043705020606242705450501
10004000004000600070000000000000400080000000000000000000002000004000800000600000501
11111111111111111111111111111111111111111111111111111111111111111111111111111111111
