11111111111111111111111111111111111111111111111111111111111111111111111111111111111
10000000600000000000000000004000000000000000004000500020000000000000000000000000001
17203020206382446684677275507080763464854822204070342080603728302850202354882322781
10008060804000000000000000803070006000002000300030000060704000800030300070006000001
10406620805060427683254440808060607050303070738468404270704078376060276230708043701
10600020407050003000008000805080400050800070004000308000800070000070000000800040001
10242070806060702080306076804060448030727573304060624053253070526350785833662080361
10007050005050200040206040006080002030005000408050003000008060600070003000007070001
10485050445060765346206070844045508760505070704052304022702360203022802433202052501
10300070200080000000507060004000700030306060400020008040005000503000300000404000701
10805344608072275250202047305380655080705020272520488340707050604530844830503074701
10400000402020004000703000602000400040600020000040002000203080600070000030008080001
10438460703040402070506050508032237030562527664045702088384067683052556030684060361
10000080704040504020502050200030006050000000008020600070006000000060002030600050001
10786080202070724065707060283835504066738322508050404240403358368360807040405542401
10006080006000800080002040000000404000008000303000406000400020000070200020606000301
13405082676430406320207472766540205068303020606348308082464040448480308020605072601
10005080000030502000208000005030004000203060202000504080002040000000403020300070001
10472080236060208058542080607084242230507080504030866040562050547633703670823730531
10005040200030705000008020700020008000203080008040000030000070000000600060000050001
13603040808430806035205040837530508538508057825070635387707356626820623020824050701
10707080700060408000400060003000403000004000000060000000204000000060700040204050501
10505040404065808440758267827070306038555074836563728320586035387040806360703053501
10007000402000300020005000600040302000007040000000000070000030000060600030007000701
10485484644270704027807050705740304252508030608443587067553870662720853043678550401
10005000400000805000602020300070500020008000500040000080000050000050004040004000201
10706760703865262560304040244040488060203464663040334345223020858067234060802022601
10700000203000500000306050007020004050800000008080000000000080700050007060400030001
10685885404060506033678065702068583070554370308026472732508870205050808480484240471
10800020006070007000500030602000002060400080505000008000200070806080800000400050001
10504030426050226284807880706584303270207020407680804480862550502470686234708255501
10706000300070400000500000500000200020004030300070500000500000600030000000400000601
18303025407450704430403658872470232060575040625060242757205754574065456650538370201
10004000706000404080407000300070003050200080500060004000506000008000005030000000601
10865440408443605060642040402024206072803080702558488040226067403020504020765833501
10000070406000006030002060008000607020005040803000003040008000403050300080200030001
10644088307053236070706053638750607030424020802056603050508668302085205840502060201
10003000400030005030403030000080008000300080200020500070800040004000407000705080201
10506020458420707060607050686045748058204040352270407860355030642430508058506030301
10408080000070800030702050200080008030003060000070303000800040300030205000002080401
10704658375020508423504020242630503420255020503030838080408720236070705462462080821
10800000007000306000800030008050800000500050805000500070600060003000607000008080001
10635520206345578060243868703040537665648050473374503785205036207734705035303020301
10000080600000000070000000603060000000003080006000700000405000007000006080300020401
10387083274888743042466270604030484688705055207030644330786873343387503070787270401
10600040000000002000000080007020700000005000600020000030000000000000708000400000201
10407540427466206588556528668050703354672450665778382020353273536770672744702572601
10600050300000206000007000000070204000500040600000200080000060000030000000802000501
10664060308050403026208030472850608720205650304650606737836080563030737560482060701
10006000407040405000500030000020400030307000300030203000800030400060400040004030001
10203723207560702780602764847040487040704060546050702540477340504040567085405024261
10300000008000600000400040000050005000800040500070500020000000602060006000405000801
10786374723052783440525070368333607438327366305450436062683645507028307050402550401
10000000005000300040002070000070004000000000300030006000000040002000204050800050001
10656078807380452020607022823080333065455870528020608374267080858260202360858024461
10004000600030000050703040008040000020000080005050700020005000400000800020002050001
10603420338020704850303060208044225587648040708057344030602228606838876035806020201
10500030700050500080407000602000000000000080600040000080200000300000007000003040401
10876086508030235080704663603888457323666477627540228870462420846048807462237030601
10500040007070800050200000400000000060000000700040800000600040006000600080003000401
10207450473040782780523360452556524040423730307040304758803084407740503082504073301
10208000300080007000700000600000700070000080008040004000005080005000405020006000501
10804073822242505073304645704270203834462070822025566050433730423055833050502350801
10406060000000808000600000005000300000000080007000000040007000706070008040702000401
10804074562350803370474333662063748773535572577067284856508083402027307050634085601
10605000007000200020000070003000000000800000007030000070002000304000007000700060001
10502835507040326036637050403288785380202083506080575070465560203320754220805460861
10800000500040200060007000700000005000806050003000400060500000300080500070500040001
10738330268250205420303370787837702040308040627560472670306375446060202067836040201
10000040400040500040700060006000802040404030600070600000700040006040002000006030201
18786070362060577040205087208020608024705050606034802270862022207023578388888060601
10200020700060006000208000606030203000005030708000400080007000003000200000005070301
10403080706067704577232840387060205057473360507070283080605352384270305044202062601
10005050007000503000500080000040805000007000703030500070400040000080007030007000801
13826444305350606420703032282840403376467085804080673042637050806053673280873830201
10000000600060300000805000000070405000003030008060007030008000304000300050000050401
10574860602020658282808325447020802086404040838882702470603878202320704066784070801
10300070807070000000200050800020808000800040200000400000805000306000604000004000401
17804030703032283288828040602880403280258220606030445777204840703088406648303537301
10007000505000000060004000800000700070000050506060000000700070002000403000007000401
10475658577826368630706765676283223523835050302026223330778042867545403084258060501
10000000000000000000200000000000000000000050002000000040007000000000003000000030001
11111111111111111111111111111111111111111111111111111111111111111111111111111111111
