11111111111111111111111111111111111111111111111111111111111111111111111111111111111
10000000700000000000000000008000000000000000006000200020000000000000000000000000001
12202070404584632228368432503070752672534486302070583050507686602480806885726832341
10007080806000000000000000307030002000008000600050000070508000800020200060002000001
10604660602030286747478780305030505050406050532847408350702044385070366850503052501
10400050806080008000005000604080600080800030004000605000600020000070000000800040001
10257070604060705060704038808020563040657844304040628058536050576570284373785040831
10003070006050400020307060004060003070005000207020005000002070500040006000006040001
10667030576080246535606050584085604470706030804067507026705370208075206473502082601
10300060500080000000304020007000800060508060200050005080006000207000200000702000401
10404464203027263650304067206530335040603050483750726430208050408620684280202025801
10400000805040006000708000205000600050500050000070005000508080800050000080003080001
10838850303050402070305050208087734020875668722078602037735027542074675050747040441
10000060603050402080408040300040007070000000003030700070004000000070005030600020001
10888080704030284073307080223434707047228625202070408540803747864420506030303552601
10008080003000200020003050000000204000002000603000405000500040000020600050806000401
17207068627560805780708347883760203057803060608334205064882080477770603080804044501
10003030000080802000608000004080002000808060204000408030006040000000608030800040001
10447020434070406022754070608056366250302060702030547030582080247872802770752270861
10007040300070606000006040300060004000602060003040000020000080000000400020000070001
16405030808470803033302060347260608243505056444050647665607645376670868020376070201
10503050400050705000800050003000707000008000000080000000603000000020200040402050701
10203070406033805620874842856020808078445033828486342770857084632080604670304026801
10006000804000200050004000500060706000007060000000000060000030000070400060006000501
10648445477580408083604040605450507777402070203585437084526470474840286085238720301
10007000200000302000307080300060300020007000400080000070000020000060004030002000301
10802370806444346240705050842050567060205247823030882483336070482035763070505083501
10600000507000600000704050005070002040300000004040000000000020300080008070200020001
10473847503050606088753024604022844050266850207082878347606460504050604470568870571
10500040005030003000600040705000003040800020707000007000800050305030600000700030001
10305080727070653645608670605288505270706080508320403680377520206670433774403723201
10303000800020200000700000400000300020008060400050400000700000400050000000600000701
12805066702620208370802832665250635070778080277060655526607244455038458860527540801
10004000806000702020406000200080004080300040500020008000203000008000005020000000301
10288340805628607050848050807042402072307080205564456060225068702030306030287536601
10000080303000008080008050008000403040002040206000005080007000804020300040700060001
10662056202083256040402068283620804040555060703054304080505657703052505230603070501
10008000800070004040705030000040008000800030500050800060500070007000602000607040701
10403040526220207050207020352055322087705020335220307580582050537480208022206040401
10504020000070400030506030800050005040005050000020204000200070600050507000005080201
10204288457040302573608050362260607340476070804050322070707640744040205543828020251
10200000005000803000800040004040400000700020606000600070600060007000702000005050001
10583220702245743030354287805060274834868030587537607382308084606424707083406030501
10000080600000000040000000404060000000005030006000700000304000007000002080500070401
10352064484474448037545570503020427246202082805020462470842288637733306040252450301
10700050000000008000000060006060500000002000200070000030000000000000602000600000201
10403320234544606456364224245030805275357340325454852040453423453470362637306783501
10300020400000605000008000000030504000200020500000200050000030000060000000203000201
10733050802060208047702080335720306320208520306380607252673030445020468740354070201
10008000306020205000700080000080400080308000200060506000200070800030300050004040001
10203533708470605770606563588060686020203080447040202350766670608080456035508052861
10400000005000500000400080000020004000400080200030400070000000704080008000405000501
10253362873058672520233030534264702274653485406650746078283757207043607060207630401
10000000002000500040004020000020008000000000200070006000000080002000504030800060001
10323086602670258030606087633050242046757870474040804735457060587870507640577078381
10002000200050000030703070005020000030000070004060500050008000800000400060003070001
10407830738050407440502020306067483224636040506083745060804273606267785052706050601
10300020300030200020605000503000000000000050500040000020200000600000006000003020401
10275062503060354030202623707674527422436358347830627560564250238026807684286020601
10200070005020400060300000600000000080000000500040600000300040002000700050007000301
10806550656080765480228420235775853020822860703030306232702073305420604062703026501
10707000700050002000200000800000400070000030002070007000003050002000408050004000401
10705062573382508023605623608320305655874020734033523050467550835074688050602280501
10806040000000306000600000005000800000000030003000000070005000506070007050505000501
10207082887480605480235347848035676272742777564036857435703072204076202060782046801
10605000002000500060000080007000000000400000002070000020005000804000004000300030001
10807843703060567045475060506772622720705046202080873040872720805520853620407550621
10400000200070800020004000700000002000504070003000800020400000300020700030400040001
10565780547270503870807380642825806070406020764530346840702548543040305088322060701
10000040600020600080300030002000806030603080600070700000300080003040005000006060401
13566020575020232080403074806040402067605060206068605260833028202087452473338040401
10400030700040008000702000203070804000004020402000600070008000008000500000005070601
10502060803046602375273370268080505083235430304080845080203533388340506088507083601
10007070007000504000400050000080702000002000606080400070600060000030002070003000301
13232575306740503670207027432380604533346034402080436022644080804054874370536870601
10000000700050500000507000000080506000003080002040006080003000606000600020000020201
10878860706030626263705278633060707036304030382883705880804782205630608056332030601
10800070205070000000700030200020404000400060400000300000706000206000404000003000601
16507070807035487845524020304670804830846720402040353454408580406056805386803287201
10003000407000000040003000500000800050000030804080000000400080003000507000003000601
10654873248556233260507344226728836842477030208068837540542082743388403024855050501
10000000000000000000300000000000000000000030008000000070008000000000004000000040001
11111111111111111111111111111111111111111111111111111111111111111111111111111111111
