11111111111111111111111111111111111111111111111111111111111111111111111111111111111
10000000200000000000000000002000000000000000003000300040000000000000000000000000001
15207070706725267335842467408040887376588887702080832030408836505240703547885352251
10008050704000000000000000508060004000007000600080000020408000700020300020006000001
10706650305070764838666820407050804040306020372254606370408076244030348760208036201
10300030203040003000008000507050600060400050005000704000800020000050000000600060001
10252070208070503070204068207050435050848542405020468087338060748680275424272040661
10003040004070200080507080002020008030006000705040008000005020700070007000002080001
10552060855080868742502080882052202370605030405078504085303470206045308566403033701
10700040800060000000207030006000700040703050800080005040005000403000400000707000701
10602638808068843330803066402580458050505030628350684460406030405730328330702025201
10300000503030006000506000706000400020400080000060004000607070200050000030006040001
10754220306080605030404080804073364050625866886026703074428048458064325020567070481
10000030802070205040805040300080004030000000007030500080008000000050008070300020001
10747070202040645054207040262272606038857428806060304260708236836580508050704463801
10002040003000300080006060000000408000005000603000302000600040000050600020208000801
14606032283640605750404427223430303084502020606258508047555040477250208040802063201
10005020000030606000404000007040008000508080306000806080007060000000804040300040001
10867020446020507032523080502025855830703070206060682050854070525484507760656880671
10005020600030307000008050800080007000706020008040000050000070000000300060000050001
14804080805630406023202020226540805676206037256040335643705223375360864050457040301
10306060500060508000500070007000208000005000000040000000202000000070500080208050601
10204030308025402240575287867040508065226036455383265670245057488080308620706027601
10005000404000300030005000300060306000005040000000000020000080000080500030006000501
10322282684560806025302070402820704874403070808854532052767780568730734048348440301
10002000600000208000405070700080400020008000300040000070000020000080002070006000701
10607720603867568760506080228030485060304623368050882386724050824074682050407045301
10600000208000200000803030003080005050600000003050000000000080500080003030800060001
10288744807030203025688047503055747070537440607074834737705770204080308560226280861
10400080005040005000600070404000004060200020202000004000500070206070300000500050001
10504080762030453454802840704526404320705020405620804360624780306640568534503474401
10804000200030600000500000700000600070004070800070600000700000400080000000800000301
13505085208440205330505337573360877080278030655030578264403367428048263860638750301
10002000504000703080808000500050006020200080400080002000706000008000007030000000801
10567720504328207040865040803028305034508050607436822070547034207050608060646852501
10000050206000003080007030004000205040005050803000008020004000303020600080400050001
10544057502032735040806027257830307020522020806074807060207673603076805380708030201
10007000600070005060602020000040006000700040300050400020200020005000308000206060301
10803080334770507060508060556046584087704080265450305840274020536640505058708060401
10408050000070700070403070800060007080002040000020406000400070300070405000004020601
10502635224040508563205070525350504230364030302070684030408340626040806545474080621
10300000004000605000300050005030700000400040704000500070600060002000805000008080001
10345640807886473050744434202040836733553050746327806628506055702826608073502030601
10000030500000000060000000703080000000003040008000500000206000008000006080400040501
10225077723472334023357220307060646663708026705070453230346532734748406070338870501
10500070000000005000000040006040400000003000700020000030000000000000603000500000601
10608580744363403888326732652020702665322340677666686050273538673450478375204723301
10800080600000603000004000000070807000400040800000200040000030000070000000803000601
10322080502070205053605080247620808560208820208780606432743070883060572240442060701
10002000704050708000300020000030200040704000300070504000400040200070300040006040001
10505574604240808740707322846030636020202060553020702530626720306030754027502022731
10600000002000400000500080000050003000800070500030700030000000403030004000805000501
10527252277042457420727040642322702726876424705480838078878636403064403030204270701
10000000006000300030005040000030007000000000400060006000000020002000405050200020001
10844068403340563020404052337020252084885440263050804546343070865440803840523055341
10004000300040000070202050007080000060000070002060300080008000800000600070008040001
10408330365030803440803060406035553266642040202083423070805845507826322052404040501
10400060600030600030506000706000000000000020600020000060700000400000004000007040801
10225062505060438050304774502285543553344544848640282340564740655078304355653020601
10200020005020700040500000700000000050000000700040600000300040004000600030003000301
10708320784040225620384820458684837060658770304060405542405048505340204074306068501
10207000600020007000500000800000500060000030003050003000006020005000204070003000401
10204042654754202056707465808620804287333080578028562040766470627028856020405770701
10402040000000506000600000008000300000000020003000000030003000702020008030608000401
10305037752630205330877537726067787554245727865038762267707033405028502040734085701
10205000006000400080000070008000000000500000008040000030005000603000002000400030001
10203646502060554088625070808763334680505046806070475080686850802270772370507760341
10200000500020700040008000700000008000504050008000600080600000200070200040200050001
10358820463570206560808330857746305050802080634480823820404576672020305074257020401
10000070500050500070400040004000304040408020700070800000200060006050003000005070301
16474040232050748050507065302060808038604060502035504350836046305046276867757020801
10600040500040005000502000302060704000004070506000300060004000007000200000005030701
10406060304026208575388250655050805042847580606030775050303522665440802036208023801
10008030008000604000800060000040506000008000702030300060300050000060008020003000701
12633686703360603570603032665760704328322047505030267052676020302082628620428760401
10000000400050800000407000000050306000005050008070004080008000605000500050000070501
10477260603080776747607682272050205058705060346327308850308647302250406086637040401
10400080304080000000400040500070306000300070700000400000202000303000602000002000301
15205060303035726388387020702560604250738620703050535326805230707032502452706328801
10006000207000000080005000300000200060000040206060000000700040004000302000006000301
10488333468378677330606867556548842565232040403054554570383074485772305075552070501
10000000000000000000500000000000000000000040002000000030005000000000002000000080001
11111111111111111111111111111111111111111111111111111111111111111111111111111111111
