11111111111111111111111111111111111111111111111111111111111111111111111111111111111
10000000200000000000000000004000000000000000004000300050000000000000000000000000001
14703050707757678688765877504030472287826862607040587080708634705820207828527726441
10008060403000000000000000504030003000003000400050000040607000400060600040003000001
10404860306030766523822640204030604070206060875437608220206047744040578430704044501
10400060407020008000004000407070700020300050004000402000300040000050000000600040001
10224060803050704080406077808030584020335338206060577043284070533440654665224050231
10004020007060400080706060004080008050007000608070008000007050400020003000006050001
10627060567040543744702050853032505470807060203063703083804650503047405635605083801
10700080600020000000408020008000600050402080600050003060006000208000400000504000701
10502324705065343730207078306850424070503070746570777640606070808230533460804064601
10700000503030004000206000404000600020400040000070002000207080800050000040005070001
10835680305040202030707020607037226030337272323042603053223066378087687020582050781
10000080508060508070408070400030006080000000008080300080004000000060008050600060001
10878050304060247067808050277557208046555354507020302650206564763520502040303737701
10007030003000700060003040000000702000008000707000402000800070000040400070607000801
18606057573280703330608765625830208077405040706857304047238070447340805030805077401
10003060000030708000204000007020005000508070704000708080002060000000707050600030001
10654070356030706052446070207058674580406040407070453070852050257264408420736520861
10006020500050303000004060500050005000506040003040000020000070000000200030000070001
14206040507230207082504070363530806853207022247070673624804755452850387070375060401
10705030200040808000500080005000604000005000000040000000408000000080600020805050601
10307070402024702370362265447040208065344066887354854480768058663060708530805084801
10007000708000800060002000800020402000002050000000000070000080000080700020003000601
10878522832760605076408060406480605223306070305887358088347860876670624088576270601
10002000300000606000607020600040400020004000200020000040000020000080002050005000501
10402470408284666520807060245060876030805482246030737573438070385022624060505027601
10800000308000600000803070003050002040600000002070000000000080400030003020200070001
10256724305030408037767044702067748030228280705072583883403540803030405620766640241
10700060007070003000500040802000003040700020502000005000200060206030600000700020001
10406080426030787245204420405382707750502030207320508630776680805570267722702254701
10702000500080500000400000200000800070002060200070300000300000200060000000700000701
17406022207230603660207242376680842040233050658050384778208576374063688820284620701
10005000802000508030704000500030005070800060200060008000306000005000006040000000801
10633230307253503060673040702042303024803040303753257070658078704040203030523465801
10000070702000004050006070006000605040002080204000005080004000804060700080500060001
10564058808056587050803082833440308080686030502076503020306455406055205420802050501
10007000400040007030404070000040002000300030500020700020700070005000305000806050401
10206040457740602030404080538064238082308070475750708540484050625720807073603080801
10503030000050800060502020600040004030006070000020208000500020800020407000008080401
10304855484020703362804050347480206460355020308030525020503820263020303554385030821
10500000005000207000500030005070600000600020607000600080400060008000607000003060001
10525250403584677020642643503040458833555050833378205666202084706888306058206060601
10000080300000000050000000808030000000005040003000600000606000002000005060200080501
10768086635228685034357260802070227775703042408060382650244558722824507080242640301
10800020000000005000000060002070400000006000800030000060000000000000703000800000401
10307750854288806674342853553080602733467720655243838030832837854340445277204544301
10200030400000302000003000000030304000200070200000300060000020000060000000604000501
10545030505040802055207070365470803320705460308320203225268060685070276620637080401
10002000308030404000400050000050200030806000300080305000800020800060600070006050001
10204262606840702680702448267060566060208080253030404880323460506030532035408064451
10300000008000300000300080000060006000600040700030800020000000402040002000807000701
10772823463068238280837060755748302576865737808730422055335666506056204040706260501
10000000007000800070002070000040007000000000600050006000000080006000207040600060001
10282035405620535040208035332040236034535430423030804857628020834280204220873037681
10003000400080000040407060002020000020000070002040400060005000400000300050004070001
10208460368080503570803040402063285838382080605068583020307788403823786038404070601
10300030400060500030204000206000000000000060500060000040600000600000008000002060801
10424034502030636050404683702743586426323848878720232840426730788025608625573080401
10600020006050700070600000600000000050000000600080200000600060005000600080002000401
10405280535080736680463750827767633020737220608040803363304033207560406082707032601
10403000400070004000200000500000400020000040005060004000005070008000207050003000201
10306053535276803086708843305550705285353070832032236040748670356083885030808750501
10203020000000507000400000003000300000000040002000000060006000608080003030402000401
10404044586470206560347782668028576532374625567036822366208022403065704070775038601
10503000007000500030000020004000000000300000002070000020006000608000002000200040001
10505322303050867064565030305357376720405037203060325080755760207440325240205480851
10400000200030200080006000500000008000604040007000300080800000600060200040400050001
10247520377280307340403530423624504030307040373630554530407646443030805058845070801
10000030500040600020700060003000607020806050800070800000200080004050004000008070501
16363020424030273060204064706030404032707080706032706260667032804032686583672070601
10700020600020008000708000204080507000007080505000400030008000006000600000003060301
10205070507048704447838850244020507025224740403020532040606572737320302026603067201
10003040007000405000500030000040404000008000608060600040200030000030002080008000801
13464573705350607380306026256260208282426032803070634024782020306034536630635680601
10000000400060500000404000000030308000002080006050004030005000707000300070000050501
10427230408080382244406836454080203058202020353282305240303543606820808023732070501
10300070707080000000400050500070506000500070700000200000403000705000602000005000301
13304040502025755285425030404860703850252840407050688567202860802046807673708325601
10004000207000000080003000600000400030000030504040000000500030007000304000002000801
10424736752627488370605365452488573686276030802033868670526087537238703058665070601
10000000000000000000800000000000000000000020003000000060008000000000007000000050001
11111111111111111111111111111111111111111111111111111111111111111111111111111111111
