11111111111111111111111111111111111111111111111111111111111111111111111111111111111
10000000700000000000000000008000000000000000005000800080000000000000000000000000001
15204040702346286873624252304040675685548847408070853020804428504660803828237685451
10004060606000000000000000805080003000008000800020000040803000200080500050007000001
10507240405030225344485250604040304040605050432878207760802063872060673630402034501
10500040806070008000002000303070300030400050002000406000200060000060000000600060001
10767040203080807030606076605060653080425822808040878086876020545530743352243050641
10005060008040300060307080008020008040005000407020007000004070300030006000004050001
10228080437030378765405020622054707560605020803056306074208260807055402578205083401
10200030500060000000806080008000500030806030800020007050004000204000500000203000501
10308753504052465230603034605370624060307050348780848750506060408460457270708026701
10300000707080005000206000603000300020200080000050002000707030700050000040006060001
10572370703060606030302050203054528060644475336024602075386024657066643040824080751
10000050202070307020704050200020003020000000007070200070003000000030007020400080001
10226030507060332087504020326752607084287283303040204430504258257840405060302777601
10006020008000400060008050000000606000006000805000407000600070000080700050305000701
14806083467430706520708386783860203065405030508866303083674040428830707060205076701
10008050000060705000302000007030002000204070202000202040003070000000502030700020001
10856020426080502043783050207022335680805040806080354060632030285624602740673720571
10005040300030606000002070800020002000604070006070000070000020000000700080000070001
13507030604220408046202040426340305476402065487040833787207827836470673040352020301
10705020200040602000500060007000804000005000000080000000708000000050800020504020301
10405020706065406740828758825030405025632058425562567360348074522060404520303057401
10007000705000300060005000200030405000008030000000000040000060000040700070006000801
10876837246660202042208080602420503532805060203526465057275650474480572074532550801
10008000200000203000808020800080200060002000200080000030000060000080004050004000701
10304860706623728530503060377080448030404887787070378422222060852026372050504048801
10800000308000200000404040004040006030600000005060000000000030800060004020400030001
10835577606030508032556073802058534050322550605033375853202360503060305230252880821
10200060006060006000300060808000007060200060308000004000200060506050200000300020001
10707050676040573686705870508363306420408040504740603280284540707640527576403685301
10408000500020400000400000800000400040003080400030500000600000300070000000700000701
15606036804650405620205727364320244070746080636020486575505627283086867260756640501
10008000502000503050706000500070002080500070800030008000507000006000004040000000601
10347680802254802050584080406072507023202060502375688070464073206040808060867256601
10000040404000005050007060006000505050004030406000006030006000808020500080700040001
10583086607078828050208067784380502070848080206086805050402283303034706380205030301
10006000600070005070706080000080004000800080300020400030500020007000703000603030701
10604030222460303020606030364084877065204030558240804540354050683460508086306070301
10503060000040300050805070400050004050004030000050706000700030300040202000007080801
10808574647050808338603050228350802830624080805070224020202640843060606457853040471
10500000002000504000800050008040400000800060405000400040600080006000802000007050001
10586760408838883060437438302050282687837030554748205553705047805345406075808080201
10000030500000000080000000207040000000006070003000600000702000003000004050700050401
10463065472663683028552270602080457872706063505080345780423775583636703080277220601
10700070000000005000000050008060300000007000400060000020000000000000806000400000601
10504320585825602878786325733070602853837670557333527030828725624360654658208755401
10700070800000805000002000000070703000300050800000300050000070000080000000702000801
10762050204020204057203040724250706840606750206630605576855070522050358220825030201
10007000306040503000700080000020400050306000700050303000300020200030700040002050001
10406274408630307560508832772050665020604030385070208660428720408060287075403027761
10200000004000700000300030000030005000600030200080300020000000604070006000708000301
10538557347075258870846060235534202858465727403850432028878887704072306080404720801
10000000003000300030004040000020002000000000300050004000000020004000207030400050001
10557025407870583020304043286080527078748260462020707464673070566780605720453047271
10005000400080000080307030006040000050000080004070200070008000200000200080007040001
10604680652040402280402030205033443757274060408047765080604552603282362084806030401
10300020800020200030802000703000000000000020200070000060700000400000008000006070401
10386045305030877080702745303754765844775445882340435530565680653066307344852030301
10500040007050800080500000200000000080000000500050800000500060005000200030006000701
10802260638020746270234270457787664070385740304040605253203023606860806055402082701
10403000200050002000800000600000500020000020003020006000005070006000503070004000701
10207068325874207067706888308530807872355080537053353040627370637072768020603760801
10702060000000504000800000007000300000000060005000000060004000202050008050605000601
10505038278650402840463375836062777327763584677065884224703042304086803080368034401
10707000006000200060000050008000000000800000003080000050004000702000006000500050001
10305737207040636055663040205375665230803062604040754060642240407830843880603530361
10400000400050500050008000500000005000304080004000400070300000400030500070800080001
10236650637630707560605320834684403060804080277760265650805888442050303042524050201
10000050400030400030800060006000405020303040500070400000600020008040004000006020701
12458080278060774040508085406070702077804080608044402260526045603052734268348080301
10200070400060004000404000408040705000004050808000600050003000008000400000004040201
10302030305068804522335430833020803072872640407070643060702576524330303054503037201
10005040005000204000400070000060706000003000807060700050800080000070007070005000201
14636488208540406450705072453450604625378088605020724087462060603076544730823430301
10000000600020600000503000000050207000004080005020008040006000402000400070000060401
10843260507050548684304634864040406075607040755472502820604387205640302026432050701
10700030603080000000400060800080605000700080800000700000802000306000305000006000401
16306050408056835547645080604670206370432540706020446467304580508048208783705483601
10004000805000000080008000800000600030000020604030000000700040004000807000002000801
10648462728267643780804654358672374388543080604033246260643062827534803066558080701
10000000000000000000800000000000000000000070007000000060008000000000002000000020001
11111111111111111111111111111111111111111111111111111111111111111111111111111111111
