11111111111111111111111111111111111111111111111111111111111111111111111111111111111
10000000000000500000000000000020000000006000000000000000700000000000000000000000001
15504872455550846850803748667032802072603840508085707380358060503685787375253743501
10005000000080000060600000005000705000600000306000604000800020506000000000000030001
10508726242070542070423684702240202640343664872750304035306660535050568742662030441
10504000200070807000400000700080507000200070005080507000002080003030000070003030001
10404050306070408347506020676050205063503074305020402366353050707047588460605070301
10300060004080006000006060806070008000002000506000500000200080700040000000400020201
10747022368330364060823050206042687220868760803757586430506756237580232463228020601
10003020000070800030002050007000000050000050305000000030300000000000700000002050401
10508580407058506032303082465656642070286060604050663030837855585455504464607230601
10200080805000007000407000000060000020007060004050008020008000700000702000800050701
10682030208337868230602253788250507432607062683057306043203070608230305040478055601
10002000503000000040600000007000800020008020000030608080007080007000602070008000001
13307587508050608063755234363055854020508040604470305040353050287055655020303227401
10004000500040507000002060006060400080606000200080005040008080005000008050400000701
10262530804320363078606070503040207420404676653383856020405070703685304050622380831
10000000600070008000800040600080006000400000000040000080405040400000700040000050001
10257542805073605764726460878830463060766377348020644444508024674620434685575280401
10000000706000500000008000200030600070300050600040000030005000700000600000000080301
10237880862840235556707037425030308654506080502653656040335480506875308372585038301
10000060200050600000005000000070400000004080007000006080000000602000702000800070001
13532760704070502034587555808734704370424068343076362040675272823030205070504740801
10000000306060208000000000302000600050002000008000007080000060002030004050800040301
10756455404040706566707560674020742062383740304637206087452060405086653020566040631
10800030002000300000700050500030002000000060300000206060000020805000000030700020001
13202030403777458330263230403666504052235044603650503083654770402235723248605023801
10004030502000000080000040607000005000006000402000806000000000200060005000007050001
10272050737022773023447053602020335866808760402086804344307534546080203030326050381
10002000500030008080003000504020000040005080707000705000700070007000200030003020001
10706682203030804080653420335074842030755020644460407050258062508045388325204046601
10200080007020400020000080003050000060800060000030002040300050008000000050003040601
10563040478080387266347060707040728680304277877078442860704880302242643050764070501
10808000800080000000000060703050400030003050003000000080400000207000000040008000801
10802678404058633452275480203070405085328080705063545040657247283048538340208726301
10400060305000000000000070800060008000003000408050005070002000000040000020300000801
10602050805052386884853030606037276450707844307040207056206463236770488080583380301
10804020006000006000004070605020000060500030006000404000300000000040500050000060401
10446080788727606045602020802030453024446050436726307370606788768060508062436020201
10000020005000804000500040608000300060000030000000306000800020000080802000002080701
10647473303085705020542850702246627780408672656680703037325550404372308362362060601
10600000602000006070008000300050000000400050000000804080000000205000003000700070201
10504830508642868326682078888040686526456630247466202080807627603067568030404370301
10002000303000800030002050006080200000000050008070004000500030704000008020400040401
10237047505030506080705030274040407088474044702080608730772040708752405076866030801
10002000300040604000400070008070004070008000007000200040403000304000502000007020401
10203350873460404884748573405026562340602255327262876020306050803070305422603070401
10500040500000400000200040008040000020400000200080005020605070207040600000300060201
10838080206584753440308020422030265080303230405040803060505032807070872440254070701
10008020707000800050702080000030004000608000205030200070708000208060000030005030201
14836030607030306030803085776836803065505034606080242730705470702055384088807080301
10008060608030006080705000300000703000408000703080300070002000502000707000506060601
10708030704050343680506320504240806740403360275030337056787865503870504060405530701
10700040504030007000207000204000408040504070005050008000000000800020704050200080201
10633450503086605048207083808042406070506020802056205328782460208040402020527020501
10800030404040004040005000007000002000206060300040200000000000407050705070005000801
10604080805043356060303686806383446777602020737740606655757423707020508075302356501
10203000205000008020300000500020006000007080000000800000002000005020608000600000601
10704388508272207050706360322070702066786024568540402738362076852060508535365020801
10502000706050006070407000600030702070006000800030605000008020300040700000007060701
10508440303030455040806024402780704020204420703020468053807030608570802442406060401
10803000200070000080705060004000707000600000605060600030008070400000300000505050201
10203027335822773870708044568030706532327276807066207780306080286753686630404520401
10700060005000000000402000000020400000000000504000005000402070000000008000500000401
10767630804030733768408682428524342436523730386668478030404058337875204062232736301
10000000800080800000300000500000600030000020000000007040208000000000302070006000201
10566434755650205630507240205370708050887073774340408050405343482730602057403080201
10000000000040702000500060003000206070400030000030300040500000003050002000002050001
10836730537480803074278064875020437080207740347058485630605267603050268265764055681
10000070006000507000007000800070700040200000800070000000400000303050000070000050001
10237023308056706246508475307865405550737780503270652823822360204074257050632420601
10006000308000403000600000500000803000800060306000300070000050200040000060000080801
12305470308550303040833860563450308020307054606048788030243820285560508742237045501
10006000800060702080000050000040708070808000302000007030200020003000700000003000001
10707064483060303068708067326060203074606560507023607080802083306047464280706834201
10504070002030008000205000002080006000700040005000808070504070006020000060500000501
10722074705024662780605577777077463780884023728220703080805070673030234035285040651
10006000805030000000407080000060007000500040008020804030403050500050200020006020001
14604250607030605736506050367840804060207684202060704080805070367370608580305083201
10007000806050800000800020000000203060700000003000800040007050002060700000803020001
10654035803020202830338834855878805040823636778436476726484068407070207565602240701
10003000008000200050000000000000800020000000000000000000003000006000300000300000401
11111111111111111111111111111111111111111111111111111111111111111111111111111111111
