11111111111111111111111111111111111111111111111111111111111111111111111111111111111
10000000500000000000000000007000000000000000008000200030000000000000000000000000001
17406030608663758868387447507020765776545355505060685020406535703760708344854876441
10004020205000000000000000404030004000002000400070000020504000300070600070008000001
10603720603040258867378720808080302040504040344854507220207037483070673560303083601
10600030202040008000005000407060300050600060002000805000300050000050000000600070001
10225070207060406070205037502020253040647384703050362033337040832820525855263060651
10002060006080600050504030003040007050004000503060006000003050300050007000005020001
10752020346080686685503030452072804520503020805065704022508750402024606457405037401
10500060400070000000806070006000600070204080600040004060003000406000700000608000201
10207786202073676630308044703380757080403070233260642380206050302740448470808045801
10400000808060006000407000406000700020600050000020003000203050700030000020007050001
10463720606020303080804030302044573070646656484058208044237073634026442030345040331
10000070806060206030705080200050004080000000002060400030002000000040006080500040001
10458050602020874044808020475374405074767467707030405880203576547340302070405836401
10008080005000800050003070000000605000005000208000503000200030000050600020505000601
14608042352540303530807678382440603057605040703733805033733020267720205080705083501
10008080000050408000503000004030005000703020303000705040008040000000703050300060001
10626030336080203044844060303026867840506040707070384030722070448573608570786350451
10007080400020808000003040600040003000603020005040000080000020000000500040000040001
16707060605450705067304020543460206884804023628060484543202752423560355060524030601
10204070300060507000800050004000404000007000000030000000703000000070700030306070601
10804030805038302250864482345030305066325058422474264280743075278020303450405078601
10004000607000400030002000500070502000006040000000000030000020000060300030002000501
10634254647680305038207050503550306856305060507277287083378670333380435035478870601
10002000700000407000302050200040300070003000600050000030000070000020008020005000601
10408350203674472840405060874040762050807852534070655838536080478063282030306057801
10300000505000300000702030004020007060500000008060000000000060800050003030200080001
10388322806080604086733076803032436050433570508055477362505780208080404270587250221
10500040007060004000500030308000002030800080205000002000600060807040600000600050001
10504040467020546556808680503572504870707050708520306830426550204720643882207667301
10403000400040700000500000700000300030002030700040800000500000600070000000800000601
14602026305260702230207383482780575060486050288060886754408523832055235740835880301
10006000408000507050405000400040005070500060300080003000506000005000004080000000701
10885280407746205030226060707032406053302030507427328060866048707070205020756785701
10000030802000006020008030002000608070007030603000005060007000703080800080200080001
10688024704065332060305052587880603040383060305046505040302362603034208260303020801
10004000400080007030407070000080004000300070400080400070200080004000606000205080401
10808070447750407080608030665077227074808060637430303280836070223780602027805040701
10806080000060200050705040600060008020008050000040807000400080300080806000002060401
10405783748030806356302080486670204840266040705030746030602660353070806388438050471
10600000003000602000500030003050200000800070404000700080600030003000702000003040001
10633420303682472040877678502080644333473060277857803354602082504367505026602020701
10000050200000000040000000206040000000003030005000200000705000006000005060600030301
10577037673752542062275380808050575356405045402080563280785866422743306060374760401
10800080000000004000000030008050200000008000800050000060000000000000805000200000501
10805720733326406828432783355040802543263580677784422040722528643470347577208443401
10300050600000803000005000000040307000600060800000500030000020000060000000604000501
10363030707050703025404070672870402660504870408460802264776030734020677240225020601
10007000307020608000200030000050500070307000400060406000600080400030200030005030001
10803546408720602620604453242070724050805060865060405740754330402060273028208023541
10200000002000300000200060000050003000500050300050300060000000607060007000506000501
10876274264037325630748080742538706687584657308720486067285256702066204050403580801
10000000006000300070008060000030002000000000700070007000000030006000303040600050001
10527036207840732050502077873030278052272850258080706577836050843640408770854073251
10005000800020000070502020007030000040000030006040500080005000400000200050003020001
10208820483020705840304050807082432755668070608057477070205382305432277046407040401
10600040500030400020302000205000000000000050400050000080200000400000002000004050601
10573064305060786050807883307262524363588876727320768230778470737062603257438070301
10400060008020800060400000600000000060000000600070800000800070008000800050005000501
10804270767060844340567670735533878070557720303050803723603052708460307057708054501
10504000500070006000800000200000600060000070002040002000005060008000402020004000501
10208066868354404024707225406250202236533020357054678060542770343043768060705230401
10805050000000802000700000006000600000000040003000000020008000405050008060807000501
10505042238540206880656568247068337567536273365073262335503037503073605070672063401
10503000006000800020000030002000000000600000005060000020002000502000004000800060001
10704368802050875056262040703276857870205085804040643050578860503850884830307760441
10400000600040200020007000300000002000707060007000300080600000200030200080500050001
10357730538250507340708680373473204040506050577570337850705274574050602073732070601
10000060800020500050400030008000605050705040500040400000400060008050008000002060301
14428040832070263060802074708080205067804040403078608730547065808034385636357040601
10700020600040004000407000607040708000005020806000800060006000005000200000007050301
10504050203036804762288340843030302073274370602070243070403364237750407062402057701
10002040007000608000600040000020304000007000708020600080700070000020005060007000501
13726875407720506370606026768570405256522025608040445063424030305074855520433720601
10000000300070800000602000000020506000008020003030006070007000504000500050000060401
10744850204070426335302257855070802066804050734874805880705587605830607074477080801
10700020304020000000200080300020203000700020400000600000604000607000708000008000801
16202060608043725274826040504550808280334220404060346733606770708038504764505467301
10004000803000000080002000200000500030000080308030000000800080004000807000005000201
10486322253254744720304228453326846548267030204038874270375053823523507063477040501
10000000000000000000300000000000000000000020006000000060004000000000005000000060001
11111111111111111111111111111111111111111111111111111111111111111111111111111111111
