11111111111111111111111111111111111111111111111111111111111111111111111111111111111
10000000400000000000000000005000000000000000006000200030000000000000000000000000001
17604060704422364373863727702070752665287624803030545040604257306560804632324327241
10008070304000000000000000503050002000005000400040000030207000300060600050006000001
10403880405070282337847330403050407080602040326844808270207053333060778880607026601
10400040606060006000005000207060800030800080006000708000500080000030000000700070001
10268020805070303080507035502030232050377266206050352022822050528560433355725050651
10004040003020600050202030007070008070004000708050004000005050400030007000005020001
10824080756030747728704030845043302460604050403044703078303230202027206525808036801
10400060800030000000603080004000500060707030700080007050003000805000300000704000601
10205626808063858370603075607630833070305050783450885780603070303220348850308034501
10800000602050007000707000306000600070500040000040006000405020700050000040005080001
10363320305080807080507040505086478030236448772066806025667028748084763020758060841
10000020207020808080404070600030003060000000003080400020008000000050008020800070001
10836030206080742036305020475445404052228827208080404840503772227740405060306328501
10002060003000400060005060000000605000007000206000502000700050000020300030402000701
12805027475860205270203434324620207025408070704365204047273050257220807060305083701
10007080000050404000803000005040005000608070206000803030008060000000702020300030001
10756020782030705023478020407074384620302030204070263040277030686525508250347280621
10007050700060405000002060200060006000208050008050000040000050000000300060000070001
16507070708470307034706040646660707746607053238050235854507228465240783030477060401
10607040200020603000500040007000708000002000000080000000608000000020600060506020301
10704020603083503360273675573040302086788065325288356460643025455020702360708056801
10006000702000500080003000300020303000004040000000000060000070000080400080007000701
10776756755720203033605060208740706253708080804656487035627870255660576088846880501
10008000200000203000305070800020500060006000700060000080000020000020007070007000201
10608430402683832250807030736060846070205852643080586772358060536043455080308056201
10300000705000300000403070005070005070200000007040000000000020800020004040700030001
10342422308080506077278065308065383050566480206038737572803530302080802460762880831
10500040003040003000400040306000006030300040807000004000700040806080300000300080001
10605060343070536436208480707523605650505030406770406230835340802330752266408253601
10704000200020200000500000300000200080006050500030500000400000500040000000400000201
18604028705480806640607378524560887070863020873050872365608677438044234560367270801
10003000803000506070208000600020006070600050400020002000404000003000005080000000301
10528830407246505030473080603065604056608030704642625080747055703020305070832835201
10000050207000002050002020005000202030004030406000004060002000505050300050600070001
10532058804053553030204042462250805040352040306023405050602273402076703420407070701
10007000400060002060308060000040004000500060400030700070800050006000606000306040201
10604070668430805030605080874035544054803050282380707220634070456540606024208030301
10803080000080400080406020800030008050006050000060704000600020700070702000004050601
10305578646050807425306030247460705860523060403050346040803850286060206882864060541
10800000002000303000700080005070400000200020303000700070700080006000405000008050001
10785450504483635060435863504070323577367050256832303322308057802222808042505020601
10000030400000000080000000502070000000008060002000500000605000004000007020700060601
10277023885856675068785430702030624246708057503060436360673363452426303050784240501
10600040000000003000000050008080600000004000200060000080000000000000503000700000701
10404470736652505883843487827070708726458370565668872050732733868480487726606766801
10200070500000707000002000000080605000700020400000600030000020000030000000702000701
10627030807080705083304050674570207240402550306780802743658070638080887240857040301
10008000303030804000600060000020600040702000200050608000800030400060600050002050001
10505857607630206330303564368050336050408070546020802360527330302080847045308086841
10600000007000800000400070000070007000300080200020500080000000808020007000302000601
10253484755064453750284070552443307667424528404720486066823286604053204080606330801
10000000008000700070004030000030008000000000500050002000000030005000606080200060001
10747086408230385080208038278040567073646320483080706243562020587860407820463037681
10007000700070000060702020006020000020000030008040300070006000800000500020008080001
10208520683060504480406050704032323558565080503056865060702377208727254042608080701
10600070700020200030303000704000000000000050800070000080500000500000007000007060601
10323084608060346030306666607828743634244853256350747870763830483053408732357060401
10700030007070700040400000800000000020000000500050400000400070002000700030006000701
10805370786030264740383880474632442080672220302080805423404037708360608054803084301
10302000800030003000200000500000500020000050005040006000004050003000302040002000301
10407084256222602065704862608460505334787050576087244020535470683075433040708270201
10602060000000203000400000002000300000000020002000000050005000807030006040503000301
10507032353820602320865562354057866256357725842036728747203073807054302020677083301
10304000008000800070000080008000000000300000003030000050005000702000003000700020001
10606683604080245063233060404478228880303063205040248050874370305620448480504740281
10200000300020400060002000700000008000408080006000200040500000300050200020200040001
10475620734780702470205720266384202020308050547820326820707827234050508065443070301
10000020700040200020600050008000406050504070800040600000800030008080003000007020401
16227060878070242030206032707080608024607020603056806350744042507047256637577060301
10800060700020006000403000302040405000004050706000600070004000008000300000004020801
10304060204072503537338660774020807037665340505020863080202664342480408043802047801
10002080008000606000300080000040303000003000604030800020300060000030007050003000601
18385727603230802550505027684880706787826044802020728043528020206063574880677470301
10000000500040600000306000000080805000003050003050003030003000704000400030000040801
10275720307030337834807454486030402044208070757786303280707765602370803062844040301
10600060806040000000700020600040203000300080200000800000407000806000805000005000701
13707050604087557383534080706680205450253860807050727284707260405087206825708468701
10008000206000000080003000500000300030000050205020000000700070007000605000004000401
10258772237448327830207642786425443678372040606046462430372026763533303073225040501
10000000000000000000800000000000000000000030007000000020007000000000003000000030001
11111111111111111111111111111111111111111111111111111111111111111111111111111111111
