11111111111111111111111111111111111111111111111111111111111111111111111111111111111
10000000800000000000000000004000000000000000005000700050000000000000000000000000001
18803060707842354863686455508020843354428638305020588070706483502580702347734526561
10005050207000000000000000208060004000003000500040000040408000800050800040007000001
10203750608020748455854230304070707050604020428868802780506034733080578730602033701
10700030207080005000006000806070400060400040006000607000800030000040000000200020001
10672080202060606080304032606030866040723653803080287043864040527520886645888080671
10007050008030300020207030003080003020003000708060005000006050500060005000006060001
10442030783050848628806050844048208430205020202027304072503570304043508785702077701
10500070500050000000405080007000200070506060800080006070005000405000500000506000601
10604884708066747360403024802320647080804020556430435430207040503770632670205043401
10600000804070005000802000803000200070700060000070006000506030800080000050004060001
10665850507050706040507060208076374060578468442037506087642056683068883070884050261
10000050707080306050405030200050005050000000008060200030003000000040007070500060001
10828050607060655054507050578636304082834763608060505830806358467260605030503543601
10006020004000300040007080000000808000007000407000804000200070000040600030605000501
15408055735850507360403325832850603088204030607466207047623060772650608060505055801
10007080000050205000205000004060007000306060704000403070004020000000507070500080001
10848060767050403066853080406076785430303030703040328040884070887278705860425370541
10002030500030604000006070300080003000507050007050000020000050000000700080000040001
14705050602470406078605030876520704724203075578020284455503255284850743020586030501
10702020200020706000200050008000403000004000000050000000808000000060700050206050501
10702020602073802550375864876060807076367045255658564220328075348050405670302054301
10002000704000700050008000700030307000002060000000000020000030000070400080007000401
10764662452680405026307080305440704888606040803842337055465860765250363024365780401
10003000300000407000402070200030300030008000600020000050000070000060006040006000501
10504780302558857680503050637020474020403548666080423755678020582044285020407067201
10800000205000300000304060003020005040200000006080000000000030500040003040200050001
10868465805020505085625078704024448050735880202082456586505280406040303460472620661
10500040002030003000800050705000005020700040507000003000300030407020500000800080001
10304020766060633225608620806446204760606070507460506720638340708260443646808238201
10703000300060300000800000400000300040003070600040800000700000600070000000700000601
13404066207860203630802574482440282020222080255030758425607262534036257820268530501
10006000603000808050502000500080004070600060800070007000606000003000006020000000701
10242250503453808060533080308033807077207080603844678020463064305080406040678325601
10000080306000006080004020006000307020006050203000003040005000806080500070600070001
10248074705027426040607042384740705070263070505044604030704275205055307330404020501
10007000600080002030502050000050004000300070300050500050700060004000504000606050701
10503050844540503070702060767042287027506050285860204420485060752280707046408060501
10502030000040200070802040800050006020002050000020605000500060300060308000003050601
10708522746060505272407030668580507440486020808080677020603850748040304847252080271
10200000006000208000200020008020400000400040607000500080200070002000506000003040001
10454530704568834070632223503060425577562020426274504445706058208677703064508070701
10000060800000000040000000302070000000002040003000400000708000008000004050200060601
10435044648763874053637520408060225643605044207060467240823227338368302070327620301
10600060000000008000000030002020800000002000200070000020000000000000807000500000601
10306560557556806777856267225070203642423250434227275050646842543330673755605277401
10800040500000202000007000000020306000600070400000500080000030000030000000308000501
10763040302040208054307070686460204770402720805420704877633080344070884480543040201
10002000802080504000400050000070700060204000300050508000400020600070400080008040001
10505346304570704730403545758070487060307060887050608550566720708020466044302024741
10200000004000400000400030000050002000400030600070600020000000607020006000606000601
10667458556036637830734060547288208373584783707440434053722267805028405060608870801
10000000005000400050008040000080002000000000800080005000000020006000308040400020001
10482025405330364060606067653070476046742250666070804377736060263540307560735072241
10007000400020000060506060004020000040000040004040500040002000800000800020007020001
10802780337070705820508020608068482358265050307034624080304748303677678034705020501
10700060200020300050705000504000000000000030400020000050300000500000003000007030601
10483057208040738020507833505527267482647648448630277750535570748078503472822020201
10800050004040600070600000800000000040000000800070600000600040008000600080003000401
10703340667070454550762540582675752050475280502020604674302046204320408087508057401
10305000800020002000400000500000200050000050006070002000004020003000706040004000801
10703027835225308048803487304670305382237020388058352070348680854034647040608280201
10305060000000804000300000005000600000000060004000000080007000403060007070502000801
10408043554530504370835863257028633254725547634072627738706083208086307060844043701
10603000006000200070000080005000000000700000008030000070008000506000005000800060001
10703353307080843038448040306682738260705045306080568050477430407330572860206660261
10500000300080400050004000300000005000705070008000400080500000200060700080400060001
10864560475740406220605770534585804020306070355250276540508442832060502044378020601
10000070700050400080200080002000605040608060700080400000400030005040008000006050401
13366070252060542040208036203060505048508050507053304860554033606067473366384020301
10300080700040007000305000806050603000003060306000800050007000002000700000002040801
10805040508078307864347420487050302056524780306080422060605258637230406022508045701
10008060005000803000400080000030407000003000704040400020800030000080003020002000701
14822252203740307570807053773830605862637045707070842027387020508076524450747340801
10000000200050600000705000000070704000005040007030008030002000707000700020000030301
10276740308040852743307822754050402048803080456368808370508423204330308078276040801
10400070607060000000500030300040604000800030700000300000502000402000508000007000301
15405050506038625245432020302330604630434230408050682373203850605083806327307736201
10005000303000000020007000700000800070000060207070000000800030008000207000004000401
10627828428375344580406783465623627272274060503077366240548083567652204068558060801
10000000000000000000400000000000000000000040004000000060004000000000002000000080001
11111111111111111111111111111111111111111111111111111111111111111111111111111111111
