11111111111111111111111111111111111111111111111111111111111111111111111111111111111
10000000500000000000000000004000000000000000007000200050000000000000000000000000001
18307070706268575886257844508020648723837558305060462070404272506820505523765547351
10004030404000000000000000603080005000008000400050000040302000400020700030008000001
10402270506080483278256820508020604060408020548638604830203028386030584350306075701
10700030702020006000006000708040600020800020003000608000200030000040000000200020001
10244050708070707030205023304050277030252476504080573078765020223380787377327050661
10003070002040600030706060006080003030006000806050004000006030500080003000006060001
10227040446020244624302070687067703520508070803033406074407350508087705837203063501
10400080800020000000705070003000300070805080800060008060006000606000500000804000801
10302843202087824480306026803550254040407080456770634550605060605240728260806075801
10200000306070007000804000207000400040300030000060002000506070200070000070007050001
10763430503060702070206020606058756070548275457042706036268032686076626070276060641
10000020304020405050206020300020003020000000002030600060003000000060007070700020001
10267060606030388042407020242525708026668356305080502230304628338250402060708656301
10007020008000800080002050000000308000005000802000602000800030000040600040203000701
17402057654530205660803752678640606065605050305383502046233020425230203080406054501
10005080000040603000605000003020003000805060304000706080006050000000607020800070001
10786070523080205028746040602086826840706070807080853070688060357258205870645370861
10005020800040507000007030700080004000205050003020000040000020000000500050000040001
15303040606780805057503020364730503242203084742040273674305653737640524050833080301
10808050800080402000400060007000304000002000000020000000303000000030200020207050401
10607060202042407820357832728080206057358032856564454740678046832040705820508082801
10002000302000800040004000400070502000002080000000000080000050000030500070008000301
10674426363660707027603060603320206622202050508728373082835740257680475085238570301
10004000200000305000208080500080600050005000600020000040000020000070008060005000701
10804370502583524340707040376060564020605357378040654522487050532048657050505047601
10400000408000200000608050003040004030700000002040000000000080300080007020300040001
10584857505060207025357033505068427020537270404077376766602880605080707570883560581
10800080008080005000200020507000003050300030308000005000800060406060400000300060001
10202050287070442654405740303346303620507060805330408640655840408540837678508835701
10204000700040600000200000200000400040007080300080700000700000600020000000600000701
14606022604640206770402323434350837030574040777080553542803445883048646740878680801
10008000802000202020307000200070003060200020800020003000804000007000007060000000601
10578670206338406020823070205025703074307030208426745080766056207060702080375666801
10000020502000004030003080008000208030008020805000007080004000407070500060800070001
10234062604067888030705026753720602020622060407056803030303276203078503640502050801
10005000200040006080504020000060003000200050400020600060400050007000708000707020301
10402020646720404080708050677034854066206050675750405640622050365250606028205020301
10206020000080400050207030500040008030004070000020508000800080300060306000004060801
10807742632030508633703060355770606760537060408060688060307320588020804564868040521
10600000005000807000800080004080800000200040604000300080600040004000305000008040001
10442650708657664050354352307080876767776080234628503777407054605332305062606080501
10000070500000000030000000406070000000006040003000600000406000006000002050700040601
10645054753362344037786440604030347786606074407020664720333427866224707030882830201
10600050000000008000000020006070500000003000500060000060000000000000204000500000601
10505440662547603582847572235050303624364520646682553050838865456260844424504446301
10600020700000707000006000000050402000200030500000800030000030000040000000605000501
10772050205080306085304050276220608230403230208320408286282060737030383830675040401
10005000303070305000300070000040800060407000400040308000500080500030400020002070001
10808638608780408850406877645020362040708040546040207350782640306060788042203048271
10800000004000600000400030000040006000600070600070200070000000605060003000608000601
10346472752065355470328080575545403246435253506820224042778253506047504020802530701
10000000004000800020003080000030003000000000600050006000000030003000206050200040001
10832038407540627020502046563020433086747740654020806646525020575840707720534083541
10007000500050000030504070008040000020000070002050400060007000400000600020007040001
10206740248070302230607030302083588474627030203076878070506824408233362072306050701
10600030700050400020308000808000000000000050300040000030200000200000004000002060501
10687037302020587080806254505225468536355888775240658370285680728088707248465020501
10400070003030400040500000400000000050000000700080700000800050005000700070006000301
10202730434070357740258260445233853080774860605060308356703033604380402047305035501
10702000700040006000600000500000400050000080004030005000005030006000407040006000801
10202072853347505067204275204530302828688080767056852080228580767048475050603340501
10205040000000203000800000002000500000000040003000000020005000605020005060208000401
10306066723670202880676528668087686766787542428025867824407047608084807040368035501
10706000008000500060000080008000000000800000006040000020008000805000002000700050001
10504466206030376057234060706342533260204026304050828040525420304820646870205780271
10400000500030500030003000600000002000504050008000500050400000300030600030700060001
10756740857550304340704360745863203060808080528650355860805658764020502086243050601
10000070700030300050400070006000806040503050600050500000700070002080008000006030601
13688050682030354070502022508020603074506040408052607850577058606073528273854020801
10300050700050006000805000706050307000006020308000800070005000005000400000003040301
10202070604027204433626540477070402042222230602050885080508678588630703082708073201
10002020004000405000200080000030508000006000405060600050400050000040007060008000201
12752742404680506520502082667530403223442077206030824047664070405026438460465720601
10000000700050500000706000000020606000008070006050007030004000608000800070000040801
10346770606020664655603277457060802088203030536876808570507762804630705075782020601
10500060403020000000800070300020702000200080800000400000206000706000308000008000801
12607070208047655336226060306240603670284350304050673857208230803073208752506583501
10007000408000000030003000300000600040000050502050000000200070007000803000004000201
10238843387482552650706378856728826846273030405078423450344026328762608066473070801
10000000000000000000200000000000000000000060007000000060005000000000006000000080001
11111111111111111111111111111111111111111111111111111111111111111111111111111111111
