11111111111111111111111111111111111111111111111111111111111111111111111111111111111
10003000000000000000000000000000004000600070000000000000600000000000000000000000001
18302020307687802855867872642356704055602066635064807420306082503042225442802662601
10005080200000200020000000000040003000005000800060500020005000702040000000300000501
10442530605520488056273875256030704750756430708060268078383463202050276380433570601
10000000600040003000004000008000400050700000705050000060000070004000800000600000501
10765823685052304727806050407882723076306766804057523720605640658266307428406576401
10003000500050403000400030600000004020005000004000000070603000800000500050005000501
10303020306420407080336320538834805680608065464888528060604065543250428080508560601
10708050607000800050200000500060003000308000007000002000805000000000300070807000601
10608054306067425470767647305060348062548228203065808378404020585457708360603030501
10404000006000000020008000004020000020000000205040008000004040000000306000602050201
10408834343278837066307070822067868360604360708062458050585080555853206057482080201
10500000000000004000800030800020000000402000607070000060800080300000002060000020701
10764637843835703680355735608740708532304028705050676477505374205535436060632020401
10000040000000400000800080007000300000704000005000500000004000003000000020006050801
10325020707450336628702020654050522065708053886623483267635025352080247647802660401
10500040700030000030003030000040008050005000200000700000008020006080007000007000201
13508730687046533080644077437752507660648340705030403272306020403070278060543066301
10006000207080000080003000006000400070000030002050708000400080700050600070605000201
10885070603030827233705685204047722062482040535070707070758850466275405380307030701
10000020800040300000803000708000000030000050007050404030008000300000700060005020401
10342320676660808060605074306087737240576223388030705046606066605670368048375380801
10000050000080306070405000003000800050800020000050400060504000004040000040000000301
16856064746060708030204253578070206060583040752430882470404382347030432870326252601
10002080800070806030006000006080004020008050000060000040200040000050003000200070001
10608070206270703043277030504066342084305048644075577050686030603256342020604060401
10700040307000203070007050804000003000700080008000005000202000404000000020804000201
10622440805077303080307050303262578040848240203583602068807362408050882380505872271
10000000506000003040800070500030006030000040500000503070502000007080300070200000001
10666686604034858080605830605080202066566080703482302060807725557030708020248057501
10300030003070005000704000305050305000004000706000507000600050000080003070004060001
10602040254660603038547046325027304532502728637060507030433060572680508022706620561
10805000500020204000200060003000300000700000006070006060300040800040204000700060001
10408226387070702220605385207020628580408668702068726042503040483030577660787052401
10400000000080500050500060006030002000700000205000500070004020000080600000402000601
10243558235388238048638020375034505054675583702360506580505073276680606276507030401
10000000005000005080000030200050004020600000003000202000303070000000400030005050201
10872586408020604050552480206320234080706053683084362080502080384462255030804020301
10700000600080300040400000200070000060008030007080007080405070002000005000408020601
10703080655626868220504024526076424564286080704070506020404026405050685736256060401
10006040000000008050002000005000005000704080200070700030202000200080400000002040701
10687053854732604060524380504437306050207070374330602360507230766352205433203350201
10800060008000400080600030300000500060500080000000400030200020000000400000600020701
10607630806880604680677030284530752640308034728573464550436037577460882440746080501
10400040500000500050000080300060003000508040000050000000500050003060000080008000201
10238080504882447087227060607063746070208540806060888325804780807043338033407053701
10007000400000003000004070007000700040600000406080000000300000600040007000608020001
12706735404683302555706736482847307020222437558066743580608263722350507070604630851
10800000800000500000600060007020007060005000006000000060300000200020403070400030001
10823440208460502680778050303080204038503072403026863040558654502055805070748050701
10600000800020606050005000200020207040700040003000002070000000004000008020200030301
10806046673040305063703027237220408040207350206388204037444034324032466830307472501
10205040007080600020006020003000408000200040300070007060007060008060000030600000201
10608030303020565320635450304052507256706880283030656030806340303240252040233250501
10006000405050000060400000302000605000702000500030500020800020800000404070000070801
10638673765028733020502355207080806570206027888450503580305050846447708068375840701
10000000200070002060503000005030200000505000000070700000807000600000002000007000401
10633240405360806060508854538550207827803483552058542353242526308072273028706025601
10000020507000302050400000006000200000200000005000002000000000003070004000805070001
15364050306032302060588056807060274540404667504678307050674628885060702526607040731
10200070800050003080004000300050704000303000007000800060600000000020502000603020701
10208020378530388056706650535840405072222052356070665082208574548630205060604050401
10607060000070003000600050000040007000500080000050007030004000000070400060004070001
10505667333036505844532046784078583030806680542845708440458023646020705257607036871
10500000002000400080008000007050002050700000400000600040400020006000200000505000001
10477453706684204030406535306060408350888535407430683070203580503555665320676048301
10000000505000308020203000004030600000807000700020000030300000300000000060002000501
10668620802030758070403080753040633575405080507080763342405783838773428047606670401
10700080005040005060600070006030003000300060704080006000200000000000002020008000501
10804037237064605060523578256057604070338620305035375050308244857883705032855032201
10804000400060003080000050002080005080300000207000700040300000000000705000003000501
10706870803260304045807020204780476050805057304430706770702582375350306352503036201
10500060005000706000408000600050000020003030700060006070400000006020600020004020001
10753030756033207270703347203047642724458020644025858030607755507060536050748370601
10007060500060004000300000502000002000003000400080005000305000300020002040008000201
12207024602725865077566520803832302875404086208540203648833070365283705055322028601
10002000800050004070007000800000500000703000300040300000000080006000002080500030701
16535070252070403060402554878536646580805372287080322277558338502033344020706620301
10003040007000200030800070000050006000200000000040000000300000005000006000800080201
10506832667872485530802080803040308324333468673843552250507872526573278543762060401
10300000000000000000608000708000300000000000000000000000500000000000000000000040001
11111111111111111111111111111111111111111111111111111111111111111111111111111111111
