11111111111111111111111111111111111111111111111111111111111111111111111111111111111
10004000000000000000000000000000003000800030000000000000500000000000000000000000001
16703060804884205288384725474378606044702055426083803840203088503086644483604234801
10003040400000400040000000000020003000002000600080400040005000302030000000600000401
10443650305530322062435857358030308560747620702080285035252358708020373870736770401
10000000400030006000006000002000800060700000504030000040000020006000200000200000501
10884548286034707364402020602427278077704285803064868620708780423325507263506873601
10002000400080407000700030800000005020005000003000000060403000700000400070002000801
10307060702470707050288560362328305680808072425885367070502085782320826070303230401
10504020505000600020600000400060005000407000006000002000205000000000700020807000401
10607045406087838860726237606040254056482285505074404533307050282647606270407020601
10402000004000000050003000006080000080000000605020006000004060000000803000404030701
10205837634843736066606050247036673770507650206072768070758020283644208033368030301
10800000000000002000200020800020000000802000506080000070500030500000004040000050601
10428575725282205470676575604430408688406025303050482744408336806662654080282070401
10000030000000500000300050008000200000602000008000600000002000007000000060004070601
10855030606840357367605040348070525022705048477535448588757022338080648536702320401
10300080200060000050008040000070007080007000200000700000002030006070004000008000501
18605650484087758080387078586674203640538850408050605728406020502070287060874036501
10007000608070000030006000002000300030000030008040508000700080400030400020808000201
10442060807080423356706477508085884078423040362060503080635440525874503450306080301
10000030600040400000206000708000000030000020004080702080006000300000200040008020501
10275530835340304020404048408025532530338677483040208035602076504430722073853870601
10000060000070707070605000005000700040600060000070800020703000002030000080000000701
17854085774050307060703755776050208070274070678230286730502744342020844240753846301
10008030800050504020005000006030004040002080000020000050700030000030007000800020001
10404070502620802028466020402033525027304086332077535030463020707634868060406070301
10400050408000307060003020205000007000300070008000003000404000205000000030203000301
10256520302055202070507040504326735050257520704485707064402245203040632630306758641
10000000207000003040300050200040005020000080800000807070307000003080300040200000001
10563475308058756070808730403080408075458050606433507060506287886080804050568024601
10700080004080002000406000304040802000007000507000707000600040000060004080003050001
10606080752380808028476057332072602445706285872040704020476080825640603038305370221
10503000200030604000800030002000500000600000004040008080200020300060203000300070001
10705625655060703350208826204060456540605487503076853053604050778040465460356056301
10200000000040600030400070008050006000500000506000700060003070000060400000804000701
10548853877685265084328030287052306047364354404580804560306088562460407538606020301
10000000003000007080000080600080006040700000007000308000505060000000500070007020501
10872325805070705060837560402620442040803068558072743080707080262752483060502070601
10600000200070200080400000700060000080007020006040006070408070005000006000205070201
10503020288872546480404062543058742784667040702050503050306064303050574826522080601
10007070000000008050002000007000003000606080400040400030608000300070200000004020201
10353046877774503020574250705364202040302040227550603360806330255453806248708370501
10200050004000800050200060700000300060200040000000800030300080000000700000400060801
10402820805460504730654030225360844840508035236742685330468035525370774260723070301
10600030400000400050000030600070006000208020000020000000800080008030000040007000601
10333050206775622066563030407047282070804770606080743554403580202045422082604077801
10004000800000002000002080005000400020300000203050000000600000800040005000803070001
14808475408478508228303267454253702030254354522035856280206387573450803040207740831
10300000600000600000300080005040003070004000003000000040500000600050406070600050001
10365850508630602580788070504070307058206073305037688060725563203074508020745050701
10800000300030507050005000700050402080800050004000004030000000002000005070300050701
10603078558050506057502042835530403030506380807467205048562034724072526770708732501
10607030005070800040002030004000207000700020500030004030004020006060000050800000801
10608060208070528730477550208035404782802750226040647080408670305280384070562360601
10004000705040000050700000808000404000302000400040600080300020600000303050000050301
10588423343044546020402877508030508650603042867280302640305050387478204087828570601
10000000300030008020703000005050700000704000000040500000708000400000003000006000701
10375770504670803080608723634440804564702835774035874378487523705028336022703047301
10000070208000305020400000002000500000800000005000008000000000004060002000505050001
15725060806025402060862037603070676820504465507435705080372475535020505675708070381
10200040500060005030002000800030706000808000004000200030700000000020507000806080501
10708070872380454035806870847430605087478054878020448052805857225220802070403030801
10606080000040008000700030000040005000200060000020002040005000000050800070008040001
10207877543064408358273033444053878080605850676584304480426053563030707467805026481
10300000003000500060008000007080003020200000200000600040300030004000500000708000001
10546354304542203040408364807080302460524474804230287020208860407556842570687028601
10000000507000304060208000004050800000304000400020000060700000400000000050005000301
10342760504050465030506040878040545752202030308080457438705327532826764077303840601
10400020003060008070200060004060005000800050402040003000800000000000005020005000201
10206044832068707050535775285076807070263460406086256030703246273346707083522078401
10804000300050002040000020008030004070600000608000600070400000000000808000006000701
10507640302740204024403040503540747060207033307530308460208256743880203783808036301
10200020002000205000604000600050000020008030200040006030200000003070500040008070001
10548060372027707860605837504072347468668060786036436040504832803080838060265880701
10006050600020006000500000503000003000002000600050002000803000700060008020002000501
17303078806556745042765740307476203888204043204830206423848030428353403086678055201
10002000700060004030006000200000600000603000700030200000000040002000008050400030601
14246080447080602070206768255586246660807574386020832646324476507028252060502860701
10008070003000600040600030000070005000600000000080000000800000003000004000300050501
10707437856545384250305040505050402568574876466778846230705863886823275474527070801
10200000000000000000706000305000800000000000000000000000700000000000000000000050001
11111111111111111111111111111111111111111111111111111111111111111111111111111111111
