11111111111111111111111111111111111111111111111111111111111111111111111111111111111
10007000000000000000000000000000006000600070000000000000400000000000000000000000001
16505050802753802447357573627672304057406045453043408550803056208062544687307382501
10002040300000300080000000000020002000008000800030300040007000205030000000200000801
10463860408570825023284235333050605670655620607030874074237583506050274570524440301
10000000800070004000007000002000500020400000607060000080000060005000400000300000301
10758848228084307727606060205626823068207838402067454660405360765536605346803862801
10006000600040808000800070600000002060007000008000000040807000700000400040008000501
10208070704260408060735840474448406730205025787565374020404057778820772030303780401
10203040304000600050600000700060005000807000005000008000206000000000400070506000201
10505072607032668740833828802020685068468826606038204472204060386843703730802070501
10704000005000000080003000007040000080000000402070006000008080000000802000604020401
10302628754872557022202070358043378350805840605074448020672060563473508023267020301
10800000000000003000300020500020000000407000704070000040300080200000008070000030501
10477427282637802420375576602330303775403078506020557663208552205755223020527020301
10000020000000500000700060007000300000707000007000500000003000008000000050007080201
10627020704260374545408060567050352023402042375228425868283076833020565754408330701
10600070300030000070003040000040002030004000700000400000006040006040008000002000201
15207560466035837030277084667234302480847670704060308552508080306020846040657068301
10004000302070000030006000007000300040000070002050204000300070700080600050306000801
10387060205070438736303382407026676076475050886060605060742680523666406380306030801
10000040800030600000602000805000000050000070006060802060008000200000600040004050501
10766640685620206080706083405066836550248433688060208064604036305440472085784850801
10000030000020302080604000008000300080800060000080300070607000006060000020000000801
12365024633060302040506678256080408070484080788420327580808377727050248230353732801
10003070700030203020006000006020007030005060000080000070800080000070007000800030001
10505030406460808054224050806088746045505036285045568080575040208874566030605050301
10600040505000802030002080608000007000300050003000008000508000803000000080808000601
10335660505024708080507070407433225060862230504488607035702438703060832550305658881
10000000407000003060300020500060002020000020600000507020504000008080300040300000001
10682784802078648020203420306040205046554030803546302030406383455060607030684035401
10300070003040002000603000408040807000008000303000606000600030000070005030002020001
10804040784450507065474023545034402724605326235040207070488070255650406047506340431
10406000600020803000400050004000200000600000003050004050300060500030502000800030001
10806436386040605850608322802060577640803683203067866066608060523070388650374043801
10200000000040300070500080005040004000500000302000400030006060000070800000508000601
10663266285485344068284020738067704033467462508440307450303065544460803673805020301
10000000002000002080000070700030006070300000008000304000603040000000400070006050701
10873233704060208020483260306830785040202075753032836040807020553356542020203040701
10800000200060300080300000300060000050004020003070002030307020003000003000705070201
10304050675332332650608042344043833228644020604070405040205073302050577766637070601
10008060000000005060005000007000002000605050200030200030202000700080800000002040301
10233068726867407050427330302544407020603060577440406360604780453277402274203880601
10400040007000400020300080800000400050500060000000200030400080000000200000200080401
10205320606340208770753020335830382240205076328435824630342057623780663730324040601
10400040500000800060000030800080008000405060000050000000800080004030000030005000201
10326040306788565086246040405063247060205780702060873884802570504086844084806027401
10004000300000007000004020002000500080500000402050000000600000800030004000504070001
18702228505833608778404642644578305040747876667068376650202644428470304050305370851
10500000200000700000500020006030003030005000004000000050300000200030808040700020001
10438550702540606520446030707040406075704056502058382070848854804037208020622020301
10200000300020502080008000600080707070200050002000004040000000005000006060500070501
10608087867070705073402034545360405070206540203452804022557067428078837570804536201
10808020003020500020006030003000206000300050800080004080005080006020000070300000801
10603080706070658480452450305027302653203680868050574050508750202280363030746650501
10007000706020000040800000303000402000404000700080500070600050800000804030000080201
10668722522085665070802235808080202680802022762620703570203080282254302054227640201
10000000700020004060406000006060200000407000000020600000307000700000005000008000701
10436530603760807020508587335460704628704764627086322825443242407074534036504063501
10000060503000406040600000005000400000500000006000003000000000006080007000807060001
18232030607075708040586056803040842850308677405872306080653356275070407787205040781
10800020700060008030008000200080708000204000005000600040600000000080405000508050701
10702040888880566066803480882380406075586045734030886044605865755540306020504050601
10507050000050008000800050000070008000400060000020008030004000000040600060004030001
10207748682044204647587047238044235030708380342664408730228047826080704746605043481
10800000004000800070002000003050007080800000600000800070500060005000800000706000001
10862668305858405070202528504020503680472666405520458050504520303482844240647077601
10000000707000403050608000008050300000506000800020000040700000300000000030004000401
10465850303060734050502060534050742243608080808060286347507867464638858032708440201
10700050008070003080700050003020007000600070305080008000300000000000006060002000301
10708072454027605040756382847065405020486280607044524050304223682344506058342084301
10308000300060008040000050006030002060700000802000500080300000000000208000004000301
10304570808830307058705030804280455020408046702760607770806627547480407384703022301
10600060004000408000605000500050000040002020700060004070400000003050200020002070001
10247070565056705880806568703044337856346080375078556040307752207040547040855750801
10008030200050002000400000203000006000006000600070005000403000400040007080007000601
16307023606363474084856640808238505224607062807380608345636060823786206074537066201
10004000400060007030005000800000400000807000800040200000000080007000002040400020601
12674020257020606040607845442752478280302353732070427543633654602084583030707650301
10008050005000400070300070000050002000700000000060000000600000002000006000600050301
10507572486368738240805050606040504835325733824454852720408523367684488333244080201
10400000000000000000307000306000300000000000000000000000400000000000000000000020001
11111111111111111111111111111111111111111111111111111111111111111111111111111111111
