11111111111111111111111111111111111111111111111111111111111111111111111111111111111
10005000000000000000000000000000003000300060000000000000500000000000000000000000001
17508020208855502487468738275555803026402084546083208350604083506076358573708773601
10003050800000400060000000000030008000008000800050200070007000207020000000400000801
10243740605750842077657687766060304770834220805060357072464642707060577380577530601
10000000500050005000006000004000400050400000205080000040000080003000200000300000401
10324747358037403348808030506425548045206766406044834350203470487652808732204657201
10002000300070508000200080500000004050005000006000000040708000300000800080007000601
10203080504350807070242570228646308650703082247836736080707083758630782020406340401
10203070608000600060300000800040007000505000006000008000303000000000600080208000701
10607077202046347860288786605070854056475387702068307365502020386455708440604070401
10202000003000000030002000008040000080000000403080007000008070000000206000307040601
10308324258532864045302050428072863580307280207025226050677020874575606022774030601
10500000000000004000700030700050000000803000508030000060500050200000008020000060601
10325535765822305460823855408320606285306052808040785242606325706352384080365060601
10000040000000200000400050002000200000203000005000400000007000008000000060006080301
10633060605230547835505080623080843023502037723673266564566087545060433788305870201
10500050500020000060002050000050006030005000400000600000003020006060004000008000301
15403840846082425040552077627667706760784450805040606758506020405070478030365088401
10007000706060000020003000007000800040000080003050408000400070800030200020708000501
10224070308050348237405788407067857054438050684030403050376660363287206870603020501
10000020700030200000808000603000000050000080005070707020002000700000400080002080401
10684740778870202060304044703035636750742527864030502086306028804250428065655440601
10000040000080504020304000006000400060600060000040200020504000004040000050000000401
13284025622070206070202544335060208040238070624430732780602437345070635730668757801
10007020200020406050002000008040003070002080000020000060800070000040004000200080001
10507020806530603053287080506088746023307084746064766060466030304566472070806050301
10200050708000403070007030705000006000200040005000007000705000404000000080607000401
10648320507053504040407020805533665060272540307572503076802855707070454550507242831
10000000206000008070600050500040002050000070500000608080802000002070600030300000001
10834623504033257050403460307070606058862060202774508030608826236030403070462047601
10400070002030006000703000403080302000005000807000505000800070000070004030004050001
10604080647740207054584048837047602352708773758070603050778070725660204064202550281
10802000700020307000800020005000800000500000006020003040300030400060406000700050001
10503724247030408480707538603080645730407543804026322064402020537040467730653037501
10500000000040300020700050006060008000200000504000400040002030000020500000204000301
10775444746538265073474030357027308083365643304470304360606085237580506873205060301
10000000006000002030000060500030008060400000005000304000204070000000600020002030701
10478464508080703020637840504320333080202047884057353050605060637844857070403060201
10200000700080600040400000700020000080002020004030004040304020006000008000604040401
10405080282288687320608023633033836877483080604030207040506068502040833868636060201
10003070000000004030003000003000002000803070700050400050504000500080400000006050501
10522062374325405040772340608375402050303040247580405860808850345882504742807560201
10300040007000800070500040300000600020400030000000800030600080000000600000600030401
10207760806760808870735050726520638420503037547462535250744073476260865520876020401
10800020200000400080000030500080008000307060000050000000800070005040000050006000401
10474060606648746045742060707086538020507840303040864773502280706072537045805072301
10002000600000007000002040003000700030700000804080000000700000300030003000604060001
12504773704565406442206352557827702020574337677032832670505684376840505080406640621
10400000800000500000300080007060008060005000004000000020200000800070603080600030001
10888340402550306650433030705030806053707034203083566040767654702027308080773080801
10400000200080602050003000400070302050400080007000003070000000003000007050800060501
10608072262040305025708073646250707030604840202726204066767076365036254550402752401
10407050005070600030008060008000607000500040600080006040005070007020000070200000401
10804070408050544870864780508052706648306840532020278070405880207380583040424240501
10003000603060000070700000207000307000505000500030400030600020200000308050000070301
10877557273028344080202673202040403780806068245240202740606070745272202034745630801
10000000800070007030408000002050200000806000000030200000703000200000006000005000601
10268350608630808060208224448880403524205376482082475572636827804038823044504062401
10000030707000408030800000007000600000700000007000008000000000007050002000204040001
18234070205037203080622054505060862880507526306254405080683734568080403642203050861
10700030200020008050006000400060603000805000006000200030300000000060208000206050601
10703070623530884022804270466480402078354047342070276057607538667540305030704020701
10406040000050003000200030000040008000800030000020004070002000000060200040007070001
10605826365084303886366036847085382050608240658322706420338085257030307263303066371
10300000005000200050006000005060005020200000800000200050800060005000600000802000001
10858878408777304050808838405070602750434286803240845060802530205258635230276025401
10000000307000304070702000007080700000304000200080000070600000300000000080004000401
10763240307020365050203060377050623264208050305040427426403847634437836065406750601
10800020008020006070200080004070008000700050808050007000200000000000008040006000701
10807045422023405060647848576037803060278350407075373080804862275756604038762074201
10508000200060006070000040003060003040600000602000600070200000000000302000006000801
10206350708720807066306080605780843080702063307280207270407474786430205672203075301
10400030008000805000404000500080000050007040500030008040700000007050300040007060001
10528080745054203230803585808032877688472060347038426030808625803060573050444750501
10003050600060002000600000202000003000008000200040006000505000700020005020003000701
16206034305386877083624680505388708845508026204450407882457030662464308077437033701
10004000300080007070006000200000200000306000700030700000000020002000002060600030201
14654060555040403050504364642227748460202768626020784852834826602044284030706230601
10004020007000200070700060000040002000700000000060000000200000008000008000800070601
10804242627282847780403040305020508874485655563743428670204628747553475328442060401
10400000000000000000605000406000500000000000000000000000700000000000000000000020001
11111111111111111111111111111111111111111111111111111111111111111111111111111111111
