11111111111111111111111111111111111111111111111111111111111111111111111111111111111
10006000000000000000000000000000003000300080000000000000300000000000000000000000001
18502070607684205834723523426522808034506073434062207870405065502054462383406227801
10003050400000600050000000000020005000008000800070400030008000806060000000400000601
10255650203540628025235786262030802740424250608080558047542626503050274850686250801
10000000700060005000006000005000200070400000506050000050000030008000500000300000301
10674488262072702325202080207685888024405834506083548420808350243574808374304862401
10007000400060303000400080400000002070006000004000000050505000800000400030005000801
10608050303770208080746280887733402830504077658534447030303082387730576020207240201
10603060304000700070600000200070003000406000008000004000507000000000400070704000501
10308044304024578370865754606050646074658678508064306386204060784462204460207030701
10202000007000000030003000004040000030000000505060008000008080000000706000802080701
10804645678265337025702070462064263340705570608047675020654040583778603073372060301
10600000000000005000200080300030000000507000306040000050700040500000006040000050401
10728483847822805460725385603550206822604022203050758672506772703845236030238060701
10000050000000400000800040008000200000503000008000700000008000003000000040005050401
10842080803820382783204050562040824046703087245485766535822046467040625566408830401
10400080600020000050002070000050004070007000400000500000002070003060006000006000401
15806530248073825080486062638645504620257560703070705266504080307050336050654084701
10002000602050000020008000002000700070000040004060404000200050700020400020802000701
10338030207050562722207467602028863058274060234040505080434340646874806740507070201
10000030800050200000802000806000000050000030006080405060008000800000300040002070201
10757670353440208050807065502074864450677662672020308084206044803620722025342880401
10000020000040402040606000006000500060300080000050200050708000005030000070000000501
17233074568050508020802525286060505050677050784450268270403222747080227240486545401
10004050300050407020005000004020005020003040000070000080600020000050006000600030001
10206050804380403086735050508035772085607088686065756080535060504675424020303060501
10300030607000607030006080503000004000600080006000006000204000203000000050702000401
10847820804044702030505080305384578060572260206586207046603228302060227880504433541
10000000504000008080700070300020004080000060200000506030702000003040600030200000001
10484662208064628020305740407060304026238040502662304040208473573080206040832024801
10500080007030002000808000404080604000006000707000607000800030000020004070008020001
10208070482450803027775027672028803648803462738030506020467050644420402032303270731
10205000200080804000700030004000800000500000005060007050200040500080403000400040001
10404338262070303770402484807020686460405453208036848037703040878080665820858048401
10400000000040300020500020003050008000600000207000700070006040000040800000403000501
10858684848722875067753070557022402053244463807570808540306048467730804375605060601
10000000007000002080000080200020008040600000008000703000607020000000800030006080601
10634777803050806050752350302460777050505052278034586030502060683782853060602050401
10200000600020800020500000200050000050008040005020004050303050005000007000408060201
10606060554223725540308043347083632763248020404050602050502032608040376752334080401
10008050000000002020006000007000004000804030600040300020405000500080500000006030501
10633067834882808040648840808745505020808040875660802680703580663866506777203420701
10200080003000400070800030200000800060300030000000700030300020000000800000300080401
10506320603450403470463080852850378220602063762755436480545025556280534460264020801
10300080500000500020000050200080008000607070000030000000200070002020000040002000401
10686040504682426047526060306084723030808560207080475682602540207057327064406075601
10007000500000003000004060006000700050400000604080000000800000700050002000206020001
17802644803247702355708383737668502060452478727073553540206628586250707060306870861
10500000700000200000300050002020008080006000004000000070800000500040607080600060001
10564480402860303870633070406050308082406082205023756020583455702052502070647020301
10400000800070307020008000300050405040200060004000005030000000005000005040400070701
10305067687040204055304037635650706020705370504454602062745032658064437370404884601
10805050006060500020005030003000503000400030700050006080004080007070000050600000401
10202070406020428370672830702038702642708560873020266030507230604720643070236520701
10006000303060000070700000508000704000505000400030500060400070500000202040000060701
10586644355032653050506563707020802340502046364370506470302050586438302073563720501
10000000600080006050808000008020200000408000000030200000305000500000003000007000801
10255230802860707030704373544360207837208484627046484254636328608074584073408068401
10000030503000702040600000008000700000500000006000007000000000002030003000803030001
18355070407044505060667054302070523720602488408223407060736633585070602232403080781
10700030200060004040003000200070604000707000004000400060300000000020406000306030301
10205030336850684065504670855550506042777086562040444085703433738330203030202020601
10408050000060002000800030000060007000500080000070003040007000000050700060006020001
10206834844037603365322027243042553030602360656783503470467047887060405638202027341
10200000007000200030008000002080007050600000500000300060600070003000400000506000001
10257424608252803030705545502030508220748472506880845080408680608556748230474036701
10000000402000305080503000002050300000802000200020000070500000700000000050007000501
10573420204050447060605070672080328768602030408050278753607772623886635067805770201
10400020008060005040700080008020007000400070707050007000800000000000008060008000301
10807046263066405030652443766064408050466640608023725080802446473627504045883074301
10603000600040007020000040007040006040400000203000600040700000000000202000002000501
10506430703450706048307080803780364060208042205450607440308786327260603472406046301
10500030008000303000808000800050000050002080700050007070700000006080600020005050001
10568070532072806340302275408076486286277060877033437070604534503020223080465380401
10008030300050005000500000503000008000005000300020006000607000200040002020006000401
15703073707423642046542820508357704768306028506870402362874070868357504083626044201
10007000300020006080007000300000800000306000200070400000000070006000006070500070401
16288040848020603040507253357775436730807585424040445688238358407022678070403360601
10008040006000800050400030000050002000400000000020000000600000006000008000700020601
10404527744632376220703040506070605272227768686327725770505655276383876538837050301
10800000000000000000507000404000700000000000000000000000200000000000000000000030001
11111111111111111111111111111111111111111111111111111111111111111111111111111111111
