11111111111111111111111111111111111111111111111111111111111111111111111111111111111
10007000000000000000000000000000007000700050000000000000200000000000000000000000001
12202040503274202558546744432854805086206047336033203380202076807062645325803347401
10007030200000200060000000000070006000007000800070200080005000402020000000800000801
10233670605670567078722377556050402460248360704030827083486867208080626350424520201
10000000400030007000006000003000700080800000204080000040000050003000300000600000401
10636346866025603844806020705822222082303672306076476480803230824266308557204456501
10005000400050408000400070200000006050002000002000000050603000700000400040003000601
10307080207220504020483280268336506350303043465658836020405088725320763060805220201
10208070303000800080800000400070004000602000003000004000304000000000200060705000701
10508068204053353750254388604040577067567386802087207744603070333483203820203080201
10608000006000000020003000007030000080000000608070002000007050000000402000503070601
10706574487882732054807060267084683860603480204075584050326080242375503084528040301
10300000000000003000400070800040000000702000202070000020500060600000006070000060401
10545345888356604440433263308450408632403032502020855384403764307857754080522020701
10000040000000600000700020002000300000706000008000400000002000002000000050003040801
10676070302380732855707020682070276033208086782375884632742023656040862268404730501
10800080700020000030006060000020006020008000800000400000008030006050005000006000401
17305370233054347040442032622424706750627350803070703322507060203030776070786053201
10007000707060000020004000004000200060000060002060503000500050400050300040505000501
10348060806080635753304835702042246083387060352040405040338420648868405850503060401
10000070800060600000206000403000000070000060008020304020004000500000200020004050801
10464320586330805060504052607048766440748753277080803046206028604520686025325750801
10000060000020305020405000005000200080400040000030500050706000003070000070000000401
12634035583030506070702453434030405050677070222460357320304376728020344460757584401
10003080600030608040008000004060006040007050000030000060800060000020002000600060001
10708030202330408087562020705067527047507084252024725040724040406757478080307050201
10600080302000403020008050303000004000600050008000006000206000607000000080705000801
10624820403033302030704030302282642040734340302645403032605388402020337660807232571
10000000704000007030300050500050002060000040400000502070604000003030200040700000001
10334528506047268070506350607040704058584040702724608020807523423070507050647048501
10600030004020005000706000704060602000002000305000503000200060000040003050007060001
10705040638870406037476077565067302363504733474030603070285060665320408042407620821
10406000600050206000800070005000800000700000004050004020800050800020306000500080001
10704253524050508640506388708070523870208887307077334057804040374030854840672086301
10500000000070500050500030006080002000600000607000600060007070000070500000606000401
10724886748736866032327030752037507038837385303820304580304048727440808888203070701
10000000008000005030000040800060008070300000005000808000403040000000500080008060301
10564563705080505030728870708680524080204046263067756050505030374645357040506020501
10500000300070600060300000300080000060005040003050006030805020004000004000303080701
10505020283666273550604035462047626846863080305030805050308088406040578645878080801
10002040000000003060005000008000005000803070600060400050805000500030400000008030501
10846074882384202040366520203366807080708070762640706530508240482765406343608820701
10600020005000200060600070200000800030800030000000800070700050000000600000200060601
10802630503440706620757060283560463220308034658672655270776023463580233480442060201
10500030600000300070000080300040004000308030000020000000700070004080000050003000301
10648040307766738072446050704086282060302860502080722233606450708057844022308038601
10006000200000004000005030004000200030300000304070000000200000500040002000602040001
16405855504844208658208746544235803080372466728043278350308323227730306070803780431
10500000600000200000200070008070006060003000004000000050300000800040404050400080001
10888770506430508550865020606040203086206082504066648080785572202036204030866030601
10700000300070205020008000500040303050400050005000006020000000003000005030500070701
10404048677050405047706036884550702060706730704386205072625032625044855780802485601
10407050004060400050002060007000206000400060600050002030003050007050000060200000201
10808030704040453350332250403054406644604240637050874030305760704270387080437670401
10002000805030000070400000303000805000406000800080300070300060400000307060000050601
10344747645056738080304657205040702430808043535580707630206030566324807067623460801
10000000200030002050207000005040300000603000000040400000704000300000002000005000701
10625450607630604070206527643220605522807572448044233223758865302055354035306056601
10000040708000508080500000002000800000600000004000004000000000003030007000608020001
12275020203043404060338044408020474850206774408665706040573646828030508728503040761
10200050700070006060002000700080205000703000004000600040400000000060204000208050301
10807020373460732038406640787650507046337038283080883023604435668220803070302040201
10704070000060003000700040000030006000800070000040008080008000000080300080002020001
10802358732064302387345046323054784080304630634527802760467056346040604338703026371
10400000006000500020004000002070007070400000400000300030500020005000400000603000001
10225442606776804070206525206020804680883527208530726060304670403438476340668047201
10000000603000705020406000008080400000407000200020000070400000200000000060006000501
10478540208080256040506050357050383736808060702070853644203347275583787026505550801
10600050007030007030800050007050006000300040606080006000600000000000005060002000501
10708083373033706070673537356078304030747750308052475070308743442377405074735077401
10502000500050007030000020007030007040800000207000400040400000000000705000005000301
10602270203530605084802020707460663020302026204780707640402486337460708287803073501
10200060006000705000802000700070000020005050800030002080500000002020700070006060001
10677080873032207880504888708055485652626030628037578070502676604080648030355730501
10005040300060007000600000805000006000004000400070005000206000300050007040003000701
18804036404225536085584360404334505635404048405670406427478070467833804087545068401
10008000300060004080005000700000500000402000300030500000000020004000008050600040801
13273070857060302020705785843642735740504483377030743643847824606052465020506270601
10005080005000500030200060000050007000200000000030000000700000003000008000500060501
10606744382225672360508050202020702632725328623848552320202856254877553838665060201
10400000000000000000206000308000700000000000000000000000700000000000000000000020001
11111111111111111111111111111111111111111111111111111111111111111111111111111111111
