11111111111111111111111111111111111111111111111111111111111111111111111111111111111
10008000000000000000000000000000006000500080000000000000700000000000000000000000001
14705030703473305357446743283252802047607046234033703480208026406073826367602355701
10005030200000300080000000000080007000003000800080300050006000205080000000200000801
10778450806350353034422825884060408880388620604070737027488267508080658730833520401
10000000500070006000008000003000800030600000404030000070000020002000700000200000501
10564278525062403827307080405752246082605285803055244630207360272436302283608732701
10004000800050405000300050500000008080002000002000000060205000300000300080005000701
10308020304460307030663260435548703860302044452837743050705064872720363020505770501
10304020308000500020200000600040002000503000006000007000502000000000400030205000801
10203038304022777450384755206070484022755648708058606374805080873623205820704060701
10306000007000000080003000005030000040000000807080007000003030000000506000303080301
10708444847333422047406020463084827860506480707066835060855020582258303083258050801
10500000000000005000300030600040000000408000802070000070500040700000002060000060701
10353342887724708240233828206460707634308063504040334328308536202253455030244020401
10000070000000800000700070008000700000605000005000600000003000008000000040008030701
10747050208470826355603080688040475048806028773743536743482073823060575827502870501
10500040700040000050003040000070003050008000700000600000002040003040003000007000801
15702430688087727060443032258568702880466740202020807285306030707080483060637078301
10008000504040000030003000003000200030000070005080204000200050700040300030405000501
10648030604050328663308463408076522024825040333070707030584480663243202780206040201
10000050700030200000707000206000000070000030003080407070005000400000200050008060401
10366760643850704080205026304063564860376756438080705052604022804320665048747570601
10000080000040604070508000008000200080200070000060200050702000008020000060000000301
18867063856050203040503382562020407060258050787880544670508238752040764420886734701
10006030800030608060002000004020002020008030000050000040400020000060008000200050001
10307040304330805085587060306033622025404082333025875060754060807757555060405070401
10800020808000506060006070805000006000300030004000008000507000706000000080604000401
10372760206088302070204040807887788060378360602888602027603347302050777730808373341
10000000405000004030200020500040003030000080600000808020807000002040800030400000001
10635486204058346060603640604020802035786020306674707070607445885030208030825044701
10200030006080008000708000308020605000002000404000805000600030000080002020005070001
10607080654740502088466086735025506745503662532030605040484070282360602022408420471
10205000500060808000300070005000600000600000004040003030500070400020807000700040001
10407374832060603450304783205050263650503858207086338066705020777020442740668064401
10800000000030600030400020008050002000700000704000500070006070000080700000505000701
10577584648546545063445040653065205022285726403580805370402043867520604873205020601
10000000003000004080000080200050005040200000004000603000803050000000200030006080501
10688485407030206040573860202340755020407073328084755040808050784473863020506060601
10400000800050400060400000700080000050006080006030008020704060006000005000307040301
10404060478437686440507053766088267353376060808080204030303062408020543857653070801
10002050000000008020006000005000008000806070600030700020802000600050600000006080301
10433037872344503030464530503284603020803070366260208770304420348877607667408530301
10500020008000500030300030300000700020600060000000500050800040000000600000500050201
10405330307770707280746030286650656880506073343353385830787024222230735760545060501
10500050700000400020000050700030007000508050000060000000500070008030000070007000601
10686070403668553057868020802072472020806820605030536385203270306037267082602027601
10004000700000002000002060006000600020800000802050000000700000600020007000304080001
15607324404656505427203723337737805080352442828072877830408685466680304080806770551
10700000700000400000800050004050006020006000008000000040300000600080307040400050001
10682860407870202630855060605060705032508024505055377020756463806037403030382060201
10700000300040202060007000800080605040600060004000008020000000008000004040600030801
10803052877060608086802047623620804040802320208432205023372067738076753880704537401
10404050002070800030004070008000807000200020300050004060005070002080000040600000201
10603080706080375580726630503088802372707460535040222030703270605850863080552730401
10005000607030000080700000205000203000807000400030600030500060700000404020000040801
10232284286067683070802342407030502380302088252280505270305040685788803064384230201
10000000500020006040603000007070600000207000000030800000804000500000004000006000801
10557330804280705030704678872870503884802365538084738883724376303048585044402052501
10000080403000502050500000006000200000300000007000002000000000003030006000407020001
16528060306027504060452074202060688620406748205626404070686854883070304448608050231
10800050800020002070006000400060502000405000002000600030700000000040705000706020201
10804050354660257073305280485850304024374086426040438067205378286850207070503040401
10705020000070007000700080000050004000500060000020005040005000000040300030002040001
10602565545022704563456067477074743020407720762585303480478055364030404367203058641
10300000004000600080003000008030003030500000600000400030500030002000300000706000001
10527774404545702060304382805080506550325838607680353080507470204364857240383025601
10000000307000507070404000008030600000204000200080000040200000600000000080008000601
10875670603020678050804030565020875584206070407040243625703446678528665078408240201
10200040004060003040500020004070005000700060405030008000500000000000006070005000701
10507032542054607050826725568026502040333560206042582070505577878348204086363064601
10703000300040003050000020006060007060600000802000400050300000000000704000002000801
10605230504460205068507020402860643060602063206550808320203475245740208633405036501
10200080005000507000805000200060000060004060600040002070300000008030700020004030001
10878050724037603870802587504074853678666060562026475060702637502080782040252680501
10004020200050002000400000606000004000003000700020003000407000300070006040007000201
16602077608864664037776320208636602623403025402250806328825060742363208032228038701
10006000600060006030002000700000200000506000500070400000000060007000003030200030401
18784070555050702030503532562338378780702233258080822547264628802087735020608850401
10002020007000400040500070000040005000400000000020000000500000008000005000600070701
10504673755572343740406040705030806242485445752377338430605388832454646562254080201
10200000000000000000704000305000600000000000000000000000700000000000000000000070001
11111111111111111111111111111111111111111111111111111111111111111111111111111111111
