11111111111111111111111111111111111111111111111111111111111111111111111111111111111
10007000000000000000000000000000008000500020000000000000400000000000000000000000001
16205080307267407584777245455428606048706026674062808440206025406042842323406538401
10008050600000400030000000000050005000006000800030400040003000804050000000200000501
10764660303430544083333684767080807250673330305050363044223333207050885220884450201
10000000200070008000007000003000200050600000708080000050000060003000500000200000601
10633383632032405367804070503787553062702444605075576440803560225585402246505526601
10006000500050405000700050300000004080008000005000000060807000400000400050002000301
10802040306820608060844540622822803720407046577377665050807025878250868020202880701
10605050407000700050200000500050003000807000005000005000806000000000400040204000401
10602067404085345270587835803080538074252237703058802553403070387366703460708050401
10608000007000000050003000002070000070000000606060007000002030000000802000308040501
10307357274247574086707060287043254420304370706038843030744080278837707058322080501
10600000000000006000600070500050000000508000703040000070600080300000005060000040401
10656225635244604570452563503820706222806084303050743622607657408342225080677080701
10000070000000200000500040003000300000403000005000200000005000008000000060008080701
10786080603260867436406060673050555038204064448426836353538086587070643627604480401
10200070400050000030008070000070003070004000600000300000008070003070005000002000501
16503740268083538070455027672842203250746350208040205734802030306020835030844066601
10006000407020000030004000007000700030000070002050303000400020500050300080307000801
10344040306040284455207663208072733056675060464030408080234770472453702280403070601
10000050300030200000208000608000000050000050005070607020004000400000300070003040301
10468770357620708030303052206062855530775475686070803082602036302820574052848680801
10000030000030405070608000006000200030300060000030300020306000004060000080000000301
14585058733070402060808346552040806050577050465880374560605272884040688720567828701
10004050700050208020004000003050005020004050000040000060600050000070002000600050001
10504020602430604054348050408065582022208057563026367030523080607687873020202050201
10700040602000606080002030306000002000800040003000005000803000404000000030404000801
10665880804084504050708050308356682030672270502544807034208775407060873740607878631
10000000402000002020400040500070004020000050400000508060507000007020500030300000001
10765244304036335080705720606060804028484040702723603080702272722060203020574064601
10700040008040008000208000704070308000002000202000408000200070000020004060008020001
10702030878280504045823085688076806364406242545080402030662080746240302035605370231
10404000500030802000400020003000400000500000008020008080800020500040706000800020001
10203843247080606360703284206080835260307358203036852047703020248080467550656057801
10800000000070300070600030006060002000400000603000400040007060000030400000305000501
10365244527368352066532030877076502037742626206380204760403055732680608275506070701
10000000007000002050000030800050002020700000005000207000404040000000300060006080301
10456542708050208050254850204350476080308022288034424020602070536557223060708080601
10700000600050400080500000400080000070003080003030008050603040007000006000507060701
10305050234373366560608042328033688458854060702050408050808065602070333227388080401
10007070000000007020002000002000006000408020500050400080204000300020500000008030601
10646064827335208030836480708352404050304080867340705320804860775433602254605430601
10300070004000600020800070300000400080500040000000500040200060000000700000800040201
10602440604730707660635070462560575840303023765748754270565023844620253480725050601
10200030800000700020000070700040005000704040000030000000600070008040000040003000701
10258040606847627067478020805034542030408820706020534376803420707056486033805026301
10005000800000006000003080003000400070700000206060000000600000200060004000808070001
14504655306742704388705224735553403050668574356026747670402276558380407040604730871
10500000600000200000600050008060006030003000003000000020400000600060807040500080001
10884460507540803360656020607040703023208032304023252070883764502053305030327060801
10400000200050307070002000500040308040300070007000006040000000003000007060200080801
10606047866070808077608066528850407070508320706575603076432034672042623670602258701
10508040004080200020006040005000306000200080200020007080005080005060000030700000601
10802020703080472260742740408034602432506220677020562080607720703730823070287540401
10004000405070000020800000508000504000508000500060800050400060500000605080000060801
10737686467073523060308832306080506740608072575260208370808020377477307064368820301
10000000300020008080608000002040200000406000000020800000805000300000006000008000401
10363760408350403030803767856860303646406254523064637236356283707055582048303046801
10000080602000404040800000003000200000700000005000005000000000006050002000505040001
15828030703028508030475043607020848730307778506766605050833266325070304225703020631
10200080500050005080007000300050504000203000008000200080700000000070502000804040501
10603020253470768027802670464440808062787078546060835047808775486250306080308070801
10208040000040004000700060000020004000200050000080005060007000000070500050007030001
10705867363028304525263066427085535020504740222466408260334074853020602366506082481
10500000002000600060007000006080006070800000800000500070400080005000600000805000001
10648666505735306070804877208080804460663382207850784070605870208567727760623024201
10000000207000404080208000003060600000308000400060000060400000700000000050003000201
10364270203080632020807020773060246574707020307070878344402723745244886035704270301
10800020004070006020700050004040002000600020503030005000400000000000005050008000701
10303082866058706070333733387048806030584450306057483040506367357863807026623062601
10506000800050004050000020006080006040800000604000400080300000000000302000004000801
10805570308830202087808050607480446050606078207760703370204664862460808345504076701
10400070007000508000702000200040000050005020200070006060700000003080500040002050001
10762050284054205540504223605064782433334060273066566070808857504030776050324730701
10002050800020004000800000607000005000008000700070005000408000600050006030004000801
16503052504636386026833420705486706852307083303550505645875080663832602042846063801
10008000600070007040008000700000400000604000600080400000000050006000003030600040401
18525080747050202080502874722553688450507455745060724487285252503058665080802880301
10007080007000400050400020000020007000800000000070000000500000004000004000600060201
10705266464464548580606050303070206286462853343458644370203264476378466346625080401
10400000000000000000808000808000200000000000000000000000300000000000000000000060001
11111111111111111111111111111111111111111111111111111111111111111111111111111111111
