11111111111111111111111111111111111111111111111111111111111111111111111111111111111
10000000000000400000000000000020000000007000000000000000800000000000000000000000001
18506634345630828260607265824073807088507780406088303440775030303662884428254555701
10008000000040000050600000005000804000300000707000708000600040303000000000000030001
10707378762050674060443463206730704230374886454330507086706250773030224766883040861
10403000800050703000500000200050202000500030003070503000003020008020000050004070001
10202050502080807848302040867040204057404045803080406747766070705052574480307020301
10700040002070005000005060704030004000004000805000800000700020400040000000400030401
10462037684350734040232020807042368770427340408463236550405565657350223732257060401
10005060000070400070007020003000000070000060405000000070400000000000500000007020301
10606830502065604055402072666774453040446050602020843060863628346276402226304270401
10400030502000008000405000000060000080005040006060006070007000600000204000600040601
10338080703554446360506776745630407566508087446088703036708060704870805020422058801
10002000708000000050800000002000400040002060000070404030007080003000607040007000001
18507388802060704032545238533044754050402030204530308080444050538035566080605683501
10004000500060305000003030003050800070603000700080006040002030002000005030300000301
10672640608550887082507020505080405280507467353638445020706020208347505040725860241
10000000500030008000600060700060004000700000000040000040607030200000200050000020001
10458563502063706238238570254370425060673375624060446465805045645770822284834250601
10000000704000800000008000700050700050400040800080000050002000400000300000000080501
10538780454430748644503022576080807563402070205735532060432340205286503875355087501
10000080700040400000007000000070600000002030004000008080000000504000204000500070001
15435860708040308067227585505652604460232068677032627050442373846060405050808220501
10000000508020206000000000503000600030007000005000002080000050004080006050800040601
10536327705050607543503880777070758078535420804887502042254080306037528080576050631
10300030005000700000800030700020006000000020500000808070000050507000000040500050001
18804080703332588850835660705674504023522065205370707058437330706558278334302043501
10006020306000000070000070304000005000003000605000406000000000600020004000008030001
10833040323065823065433026802020738636708870805033407764404742637080508020258050821
10005000600050003030005000802080000040008040207000206000300060006000400080005080001
10707276204040604020576870525035534060666060542520208040338072403075542777603083501
10300060003020500040000040002070000080300060000080003030400070006000000040005030401
10253050255040688845346040502080686860303327477033625780808440704834368080685070301
10502000800070000000000030505030400030004070006000000070300000507000000080003000401
10403646405024836882648530506030604063744060703037663020626487364066486220708865501
10600070307000000000000050600020007000002000402080002030008000000030000070600000701
10404060708067742766233070602086522480506427608020504055403647635740538060632440701
10703080002000006000007070306020000020500020008000807000200000000020300050000070401
10225060524865302078207070204030826034564060847874304670805647257030402058242040501
10000050007000408000400050603000200020000080000000308000400040000040207000002050201
10778542407087205060473330307733686270202437722540604078482640306747206275466070801
10200000806000004060002000800060000000800070000000802030000000207000007000400050801
10606340402445463486277072665050564555458270827324807080305628805054735030607720501
10004000505000500080008040002040400000000020008080003000200080304000006050800060501
10684065604080207060208040634080605088857075202020408860374050805322203024275040201
10008000300020705000500050008050003070003000005000400050207000302000806000008070301
10803430685330608883338532603034787830807725677345277050305070402020204622703040401
10800050200000500000400040005030000020600000700020008020706080705020700000700020301
10464040404783486720703080643070246030407730305070205030703036605070468750445030801
10004080208000700060503020000070008000307000606080500050603000605020000050007050401
16625020708020706060404036788547604046405084602050332570404420705055446056306050601
10008040706040002050408000200000404000306000605030300060003000502000603000505030501
10605060406070268640802530208270204730407650833050285048256227502550703060407730301
10800030406060004000304000802000508040708020003080005000000000700030302050500080801
10388520804043705048206022607088706060702060307073702764487720802080403070886020501
10700030806040006060006000006000007000702050400050700000000000604040405080002000401
10702040202083273030808766507484454656405050654740805687375745403040304022403482701
10308000606000002050400000800020007000003040000000300000006000006080807000200000801
10506734707283603080702440864040404024687033756530404487554038554080807785652070801
10307000808080008050208000400070604030006000800030706000005050800020700000002060301
10208250303070855030608024802260806050704440808070438068306080502280705232203080601
10408000200070000040202020007000207000200000805060200070006080300000200000208030801
10403067345566328470403073533040506467228557805034205820807040238443267720505370201
10600030003000000000806000000030600000000000206000008000602020000000004000600000301
10633570708020453443608252228688457465572480374743482050704055635424604038436244401
10000000300040400000700000600000700080000060000000007050405000000000203080002000801
10566486343330308780307250306750602070828064787820606030408584826770302068604080701
10000000000020303000400030004000607070200080000020200040800000007080004000007020001
10244460643550402082482057483040462030204670623063678280702423602070242365236058481
10000050008000407000003000500040700050600000700060000000200000505060000060000070001
10852075502025706633607484506335504730624270802880278732758580606063577050856650301
10002000202000802000800000700000606000700070402000200030000030600040000030000060801
14306640703780508070474520266480504080208087704063454060832280287730805883565056401
10003000200020804050000030000080806020404000304000005030500060002000200000007000001
10404088366060704033705038875030405032606420502072808060702045206042355220205756601
10803080008030008000803000002070008000500060002000507020608060008030000020700000401
10276052603088482440307762427074728540563075332830806020504060242060886037624060231
10003000603080000000703060000040003000600040006040608070307030600020300080002050001
16508650702080408773603070535350403040203887806060803020206030458770507440402042401
10008000305050200000300020000000705030800000006000500060005020008060500000305030001
10867046408030606260765347485755707060325227287262652446375073307080206383207480501
10003000003000300050000000000000200020000000000000000000002000002000500000400000301
11111111111111111111111111111111111111111111111111111111111111111111111111111111111
