11111111111111111111111111111111111111111111111111111111111111111111111111111111111
10004000000000000000000000000000003000200040000000000000500000000000000000000000001
18506080403586503628763584787756707045806052753048206580202076807085487825802562601
10006020600000300080000000000080006000002000200030500060004000407070000000800000201
10667850607270725055447877837060606820648260306050252063325224806040324380852360301
10000000700020006000008000005000700060800000205030000030000070004000200000700000601
10262534576075502678603050502448347056802377804065426560605830868736408725707368201
10003000500070808000300060800000004050006000003000000030706000400000400030004000501
10205040306450607020752470372242606780606064837682545020806026452780778060608550301
10804020207000400030600000600060006000305000006000003000807000000000800020603000701
10308073604068624630774875702070672032244442505038406383408060286383705650806060601
10506000002000000030003000003040000030000000807040005000004030000000508000503040501
10502282383528524056408020288032268850703780306048464070236020475665504056433060201
10500000000000007000800060600030000000805000702080000020200080800000008030000050201
10628855852558607740444276602740506746207073204060453687303636805453524070736030301
10000070000000200000500050003000200000406000006000400000006000006000000060002050601
10248070506640628835402080345060226073305026335424574554445026332030582754804260301
10600070200080000040002080000020007050007000400000300000008080002060004000007000401
13502750543036638030463072746588403220784760808060303543803030507080466040553037701
10008000304030000070007000005000500070000060005040502000400030200060800050303000801
10268060604020563848605275304082388087868020577050204050267420263428307450604080801
10000070200060500000708000505000000050000060003080205070006000300000500070007020301
10647470557350203030508037405035348850754563328080408038603033502530744022454660201
10000060000080407070308000008000500050800020000060500060806000008040000050000000501
14887046228030605040205865572040706070773050685440538380404776463020663450482845501
10004030400030407030006000003060005060002040000080000060400020000040005000400080001
10204030507360508025483040505087227074203026866085858080288060608378626060204070601
10800060403000408060002060707000004000200050006000008000304000702000000020403000801
10238560407045808070205020808527344030756730407555803068302888802030336530702585661
10000000604000003030400080500030006030000030600000702080307000004020300040200000001
10375667305082847060303540705080506065874040405847506060604827835050806040354075201
10400020006080002000503000403040605000007000403000508000600030000050007050002040001
10502060623450403063657075774076702782708472743060403080368040222450307073606430271
10802000500060707000500020005000500000400000005040004080200080800050405000700080001
10708333257080502750403552802020322260504747508064528032704060857060375240857085301
10400000000060400070400060007050002000600000203000400040004030000050200000507000301
10278243627647374073856080853084506045342642407230804460204062873830308444704060601
10000000007000003040000070600040005060300000006000307000807020000000200080006050601
10384485808020402040756670805280633060508033265057677080406060634765482030807060601
10800000500050600070700000500050000030002060006040007040405040008000003000308080401
10702060468663843750508028562087567526326080707070808070706082407070553742265060701
10002030000000004080006000002000008000602080400030700030304000200080700000005050201
10832023564753803040234260402766707060808020576270705720602340828357808758208520201
10600040002000600060800030500000200060600080000000300020700050000000800000500060701
10608720304330403260326080464860862280502046574437444230465085485760272240876040201
10300080600000600030000060800080005000503070000070000000400050006030000060006000801
10643070303385443068623020506068677030605850308050538735203450603077786047505087801
10004000200000008000007020005000600030800000406030000000800000500070008000203030001
17703462408536207668207836538637303030626665733054864620804458432480604050407670361
10600000800000400000700050005030004080005000005000000070500000200040804070500050001
10848750508730203460567050708030605083804068308032756080533743307085403080273030301
10400000400040707040004000800050306070300030008000003020000000006000008020200020201
10508083442060507074606024568260303020502570308386204034353055543038266840805335301
10504070004020400060003030005000407000200070400080008050007020004040000070700000201
10405050803040465760758840708084705477304470747030255080305860203250468040853670201
10003000606020000030400000607000606000206000800040400030300020800000805030000040201
10587638856054324080205354607080404540306073844770406730402060825835206046724420801
10000000300020007020503000008050800000602000000020200000606000600000004000008000401
10575770708440807040704288622880704385302624437046535757658225304035277043308062601
10000080404000802020700000006000200000600000003000007000000000006040007000205070001
15887030504075506020637044806040664760506587804252305050677774622080707355203060641
10300070300070004080008000300060405000202000006000300060300000000030603000503040201
10502040856630388066304450656230308023743056235050576078705672427340205070307070301
10608040000080008000400080000070006000800040000030007060004000000050200060003080001
10402777666033308787645076438032883070306630643287805640522032482060307778303044341
10600000002000600050008000002020002030500000700000800070400040007000500000608000001
10474542207447403030608342703080204540628485408480858030407540507748565270778037701
10000000207000608030208000003030800000602000600030000050400000300000000040005000801
10423470506060226040202070537040582272606050703050642727808372887685354027208630801
10200070003030004040400030005070002000200030808070002000500000000000008060002000601
10602068286044806070562455282027502070787560602022765070503872728288205036755048601
10704000500060008020000040008050007050400000706000200030300000000000703000006000301
10702580602570703074807030802580375040305078507250206430704323472370203772603052501
10800040005000507000707000300020000070004020700080003030200000005030700060007070001
10266050625083706260504433404076647772756050227076448050502334607060277030255820501
10008020200020003000300000305000008000007000800030008000503000700050003040004000801
18306027306623433058285730202442808547204043404340804536625050847683507026566058201
10008000700040006030002000500000500000202000500040300000000070004000007030300070501
13635050636050607080702487544586252780805538475050566878254337306045542040806670501
10003030004000400060700070000080002000700000000030000000600000003000002000500070601
10605453273567682370507060504040703857634584228332228250404433546332564643227040801
10300000000000000000406000405000600000000000000000000000600000000000000000000020001
11111111111111111111111111111111111111111111111111111111111111111111111111111111111
