11111111111111111111111111111111111111111111111111111111111111111111111111111111111
10006000000000000000000000000000005000500050000000000000800000000000000000000000001
13302080603844402864644327552584608026706035854063203280604086302027782447406424301
10007070200000700060000000000020004000004000800070600070002000802060000000500000601
10884880304370684022838247342020804560887280205030584027348346705080545530842220501
10000000600070002000005000003000200070600000207060000070000050007000300000400000601
10263266356024807278502060304487886065205743408026374640203830653343803435805668701
10007000400040302000300030500000008020005000003000000050307000200000800060005000301
10502020304830404060635670552627408880702024663327483080402088253240688070302220501
10607060203000700060600000400070008000206000003000005000704000000000200050708000201
10807024203027223840446336808030882024725854206053607457502040542888604340402080501
10706000004000000050004000007040000050000000703030005000007070000000705000304080401
10603687768457362067406030467045864680506560307072838040538050363345308034727030401
10500000000000002000700060700030000000808000707060000040200080700000002030000080401
10256537642424203870787765208750706233503027805080454566502875706472557070543060701
10000070000000200000800070007000700000605000005000800000005000008000000060006080201
10445070405740486754708080846020743074503027573687545834462054388050823884805480401
10600070800070000030002050000020003030003000500000600000005070006060008000006000301
13808820244065857070565067523665806370887430608080204662705020608070526020222067201
10007000202050000040008000003000600060000030006030805000600080800030200050204000701
10782060606030666434604677803043824086664060678080205080254270477643402430803070201
10000070500050500000604000207000000060000040006030803050006000700000800040005070301
10346760424540504080802032707078537780638782534080308073302034707450266026766720801
10000020000070806070404000002000400060200030000030600060408000004070000050000000701
17748022845030707060707447854030708080727020526740363470308567745070475450236545701
10008060700080605020008000003050005030002060000020000020200040000040006000700040001
10605070302660202036636040807076663043606048426067466050737080305472875050403050401
10800070508000202040003050407000006000700080006000004000607000707000000040206000301
10357830608053408060206040404273625020752820808643307034603627503060446680308458821
10000000608000002080500060300060004080000040600000306020303000004050300070300000001
10788627704035273080805860707060406042243070303568506060304827857060205050245073401
10800030003040002000604000602050507000006000308000608000300070000080004020003020001
10303020735470505082647064243086303856407725468060706060264040482230808032702720261
10706000800050202000400030004000300000800000004080003030200070800030405000200020001
10307483885020304740202622602070873750307857603088425075206040482060767560465038601
10300000000050300060600070007040003000600000508000500080005080000020200000503000801
10633454286587827056268040746038202085234774806630403770208085277550304658202030201
10000000008000005040000060700080006050600000005000702000707070000000400040006030401
10757765704050404050226850604330362070506034524054357030404060786375585050507020701
10800000700080200040800000300060000050006060004020003030704020003000008000807050501
10706050243482427520504086845037874727682040504040608020707068403050242633286070301
10002050000000008040003000007000004000204040800040200020807000400070700000005030801
10363055243653604040382380706348307030607050784680505340405630267275307775807670501
10600060007000600030700050700000800060700080000000700040600070000000500000200070601
10608650805840802380644080353460462420302058445458575420565052434260466440224080601
10600060500000200040000080300060006000306080000040000000300040003070000020004000201
10232050703427327076747060205025557020705460205030657663804670807058353023805052701
10008000300000006000008070003000200040500000505050000000200000200060005000204070001
12208858203432802737302232463862207060735886588077888240807462645540406070807530261
10200000700000400000500050007020002050002000005000000070500000500070405030300020001
10244880502320402540643070204080808073503062708058838080454877602047205070762050201
10800000200020207070006000500050807080400050007000007030000000008000002020800070401
10207022476020308056504063327840804030204860307667606054852064727028353550508266501
10603020005070500060002070008000507000800070300070004020002080004050000070200000701
10603040808080876750787240304057208445503450475020674080502480806670235040325880401
10006000502040000040700000508000303000405000300070200060200040300000608020000070401
10626875328043245070405228305020402870403046567680207670408050237524205032446780701
10000000500050003080402000006040500000507000000040600000205000700000008000008000801
10666370208750204080807236444680302857605563758072826222833525407066886033203044201
10000080808000508020800000002000300000600000003000008000000000007050005000507040001
18782070405065202040828042408030376220205375708772707080242237857050303483402040781
10300070500060005070002000500050602000703000005000400060600000000020802000707020701
10707070338450857038508620348650607073435058527030653074503667427760402040508030501
10207070000020004000700030000060005000500070000040008040005000000060700040002030001
10802675745066207272246035768077228080405230776582506380258033844040505857504062541
10600000007000700050002000003040002070600000700000600030600080006000200000202000001
10532577403382306020806468503030607580484523402330555080206750406865288820438062601
10000000804000802020406000007040600000603000600060000080500000400000000050006000301
10847460807070525030602020665050763484602080607040282334203543682532524042504230601
10200050005030004020400070007030004000500070606060003000200000000000003030003000201
10506077478082505050552652432086503050888560402043744050307544483354607075352067701
10204000800060003030000030004060005050600000202000400040600000000000708000008000701
10206540807720202047606080202750354050706087208530505370603283783670404368405046301
10500050006000808000508000400060000080004060300060005060200000004060300070003080001
10323070647044303870605442508034723746874040522024773060504738502040723040486420501
10008050300060008000500000508000003000007000300020008000803000700050002080002000201
12705074507523355057756470305558607683604058502770605347686060776374704048654068301
10006000800020008050006000200000500000806000500020800000000020006000003080700050601
13637070366080805030204787687366233260308655465080383674334438403057535040607470801
10006040004000500080800060000060005000400000000080000000400000004000007000300030501
10502674746576482720406030507060804474828834788272278750205567252585864536462070301
10700000000000000000404000703000700000000000000000000000800000000000000000000060001
11111111111111111111111111111111111111111111111111111111111111111111111111111111111
