11111111111111111111111111111111111111111111111111111111111111111111111111111111111
10008000000000000000000000000000007000700070000000000000600000000000000000000000001
13706080204277203886225824535382307082308045766037303520407082803026657845704327301
10007020200000500040000000000060002000003000700070500050003000405060000000800000401
10835440705840728045858557836050803270337550602020253067675448307060474260352830601
10000000600080008000008000002000200050400000404070000080000020006000300000800000301
10245355825053502582503070304762548064203675402045826840503360766724207455802844201
10004000800020508000300070400000008060002000005000000060306000500000300030004000701
10503080307530208050825370385654606840505048423666586060205034527520525080503380801
10508050408000300050600000600070002000205000007000003000608000000000800070707000401
10403025502087358470755258407030475072424668503078407753605060253278705660704060601
10207000006000000080003000007040000020000000403070004000004050000000307000802060801
10202534648833325047202050645025526650303340306067866050338020678577604055327020601
10600000000000004000600020400070000000508000404060000040300050200000008060000080201
10366744524847504570787677602740608677808024204060835677507764505486472050424060301
10000070000000600000600070006000600000702000002000300000002000003000000060007080201
10684030803530335236606040468070857072303074753474252885736036364060844485307230301
10400020200030000030002080000060004050003000800000800000004070008030004000005000301
14804360428067677060547064632872503370354350205040705387704070506060248060563074301
10007000406050000070008000006000800080000070002020708000600080500040400070505000701
10577070304060863563602776406037554065533070644050606070674580525343302730808080201
10000030400020800000602000604000000060000020008080604050002000300000400050005040701
10454230786370406030706076807037866420857355555020508063807072607850437032623550401
10000080000020404020707000008000800050300030000060800020807000008050000070000000601
16384062888020607030407273237020402040457020276780237330307528775060547220386583601
10007070200070203040004000005080002070003020000040000050200060000080005000400080001
10508060808570805043345070502035347026804033827064248080362040703727243050703080601
10400040603000705030008050705000003000400040003000008000208000204000000020307000701
10882260604076803080506070204738864040526460705366507052806848207070386420505687881
10000000608000006020600060700080007070000030500000207050403000002030600030300000001
10756222803022257070603430303030204068783060808858206020707835627020706050222086601
10300070002050003000203000304050605000005000304000406000700030000040003040008070001
10402030477820204078684056328032503755202578727050708080288020544670808088202480861
10507000200030504000800040005000300000800000008060007070500020800080304000300070001
10605873622030503250507444607020552470305242808038735038507060884020427320268026401
10600000000020700050300020007030004000200000605000200050003030000080600000804000501
10562288885285526057648070742074207073847536205640702680602042666450305474305050701
10000000003000005040000060800020006050700000007000602000407040000000700050002020501
10858747207040503020468680308770666070408044673078842060602060426387663080803080601
10200000800020500060800000500020000030004020005040002020702040002000006000804070801
10404060354338657440207052787038247448623070608070506030205042403050587787544060501
10006040000000004070004000006000006000802060800070400070407000800070800000002020501
10427074847774303030763650202555508040808050463580406260603520524864703263205580601
10800060008000200030300030200000500030700060000000700020700040000000600000600030601
10502740803840403640856060828370472320602023672278347540726034562520728240323040701
10600050800000300050000030200030007000405060000060000000700080006080000080008000701
10275060804587537063245070602033525080406660808070375777606460605023278043503048301
10004000200000007000004020005000600050500000505040000000700000300040003000207060001
12502786802367702585705377575667206040867857445054642850703626448360805080206220871
10700000400000500000700030005060008030005000002000000070800000400060504030600070001
10838660707470603250878060705050503088308077403087485050645652705073505070527020801
10500000600040203050005000700070402020500070003000004020000000007000008040700080801
10308057533030203037606054286570306030608530206288602083527027353027856750702726801
10304050008060500080005030005000408000700040500040008080005060006020000040500000301
10508080302070538540837230508046206867208550424080645050705770705560622060667740401
10004000504060000030300000708000305000302000400030300070700060700000308020000060701
10224327453044836040706553403040606730206045384570303480205020642447603053566520401
10000000800020007030608000004020600000505000000070700000804000200000007000002000301
10284860805560806060705556247550506367806468232025453224564433807078272024808022801
10000080603000202040600000003000200000800000006000007000000000005020007000802040001
12887020205055205080237022705040335860208768505845503070285828858080507557308050581
10600050300040002050004000600030206000503000006000300050600000000040207000806040301
10702050245770266087702220756430507072842072367060267083505765378830305070707080301
10303070000050004000300080000040003000300040000060003020004000000030600040002080001
10805337585085207663758033642085775020702860584247306820867067586070406675604034721
10400000002000800080004000006020004070200000700000200020800030007000400000808000001
10486422408786208060703262202060408770543368204540285020808650303376822460857052301
10000000308000202030706000004060700000502000500040000040400000300000000070003000701
10838830202020462070205070883020633277603040403060386675503664677453782066705530601
10400030003050003020700030006030005000800030407030007000600000000000003080006000801
10205083836022205070578684725084205030473720306077672070308324544532607077648033601
10502000500050002020000070008020003080500000205000600020300000000000605000007000701
10506430707420202087706030305680483070203047304220307280602782786340705284405084501
10800050006000204000605000600070000060003080600050006050700000007020400040003060001
10875030632037606760807753803076446874544040262027467050602537207060885030247860701
10004060200080006000800000508000007000005000800070008000403000800020007050002000201
13705072306566452034843350208844207433207063203250603555744050682338408085283024401
10003000800080006050007000600000600000603000600040700000000030006000002080500050701
15237040758020805060407645556334848230807236226020543647686333305048562080502280401
10008050006000500080500060000020007000300000000020000000500000004000005000200050701
10305368232744452330408060404060402333472346546322787340202445345484673474846070601
10400000000000000000503000403000800000000000000000000000600000000000000000000060001
11111111111111111111111111111111111111111111111111111111111111111111111111111111111
