11111111111111111111111111111111111111111111111111111111111111111111111111111111111
10005000000000000000000000000000002000700070000000000000200000000000000000000000001
15606060703447307726673468668367202074202088357078606880207078307032654824206787201
10003060500000200050000000000030007000005000200030300050007000703080000000400000801
10227380303750473024722764745050408780385830403050657034226632303070473450252580201
10000000200080004000006000002000200070500000708050000060000050006000500000200000801
10676386325025503462205040306825263074505556207066728540702360545346208224605424501
10007000400050805000200070300000005070004000007000000060307000600000400070004000301
10707060402530506040663280844256508870803077345836737050602065356850757080207730401
10404020802000700080500000500080002000707000005000004000607000000000700080408000501
10605045607032574460868466504030684057566583605027407636703080244383604340504020301
10805000007000000060004000007080000020000000202050004000007030000000305000704060201
10703344762454858058707070862084323840305860706083422080455060722343506038652070801
10400000000000002000500060400070000000308000508080000050300050400000002020000060701
10274488282444605420246383207880402246407036402080435636704457503568826060382020501
10000020000000500000500050008000600000805000007000200000007000005000000030008060501
10355080503760335553602020887030635064508064426467776748663054827070565235705760601
10800060500060000080008070000040008040004000400000300000008080007060006000004000701
18704280275033572030623086652424708650782460408020605823604040504060348020344062601
10002000707020000080007000005000600070000060007060205000300050400070700060704000401
10233070405070226546706365206072863046524030753040806050752880754876603380205020601
10000040500050300000808000605000000030000060003040804020008000600000500080007080501
10756660538870207040402038202087636880532232474020802088803065708420663038384850201
10000070000070507050706000002000500030500060000020400070402000004020000070000000701
12642046842020202030302732525030603030587070544830442460808335873060767250358685701
10004040800080205070008000007030004040003030000020000030800040000030002000500030001
10808080507330205032826080404046328065806076622047573020265070706534468080802050201
10500020405000207050005080608000007000600040007000006000705000506000000060707000501
10736370503044506080803080506424553080443520702332703067704277702020587850303852321
10000000804000003020300070300080006020000060400000302020606000002060800050800000001
10456723706085484030204660408080707064385040605523803050307283678040803060464055401
10800060005060007000303000203060504000007000803000608000300070000080007050007050001
10403080857660807066267052466084202623505857227080802040642070588820203032606430261
10702000600030306000400030002000300000700000004030005020300060300070502000200030001
10606358432060202830303448206060543850808437202088362035206070336070833520386022801
10600000000060500070600020003070006000700000405000800040007040000080700000802000301
10234233283556487033778050625044204046464375207260502650302032687730207864305070701
10000000005000004030000040300030008070800000006000307000803020000000500080006080701
10627664403040403020683380602450568070407056458072873020508050575322484080508030801
10500000600040700020600000700030000030006030008070003020205040008000007000704050501
10605020825272685530604078268058682885758030305080404040508085706050635223828080601
10005030000000004070008000003000004000807070500040200080502000200050600000006030601
10573066437358506070258520203486605080305030753730406530603660347438305572206280501
10500080002000500020300070700000600030700040000000400030500080000000400000300040801
10707460403570608870556080268420224280408077727575432820767063683640283450358070301
10800020500000300060000040200070007000303060000070000000700040004080000030004000301
10577050206886326046886070404075364040305740208040837727708380306044348045703072401
10002000500000005000003020002000500040200000307040000000300000300040006000607040001
14805326308585303622806224478483507030624663462077482880605454458730804060806230671
10700000500000400000800040005020002070006000002000000070600000800080304050700050001
10688760506740406260633050302020302028802053808033587080454324405047504060255040201
10400000400080302040003000600030308020400030002000007020000000008000004080800050501
10805043543070402087402088275350806080707680606722408076757037433074682530405665301
10506040008050300080002080002000403000500030300080007070003060003040000080700000601
10706040204050688360653340703085603264504680235020537060707550606340248050844470701
10007000203080000050400000502000206000602000800070700040500080700000505070000030701
10835545344026822080502872304040404270703066625230407730206040353778408077848680701
10000000200050006020703000002030500000808000000070300000406000200000006000004000601
10444330708270405070208738784640307767507345577037832276672548308026267078807038701
10000040704000807060300000003000300000200000005000003000000000008040004000807040001
12447040304083606080258028608050223580703588603368604050875272835070404644307050731
10700080600060002040008000300080302000502000002000300070400000000070502000306060801
10808020725520455043403840757470705057674036344080546068507268682750403020506020201
10206070000080007000500030000040007000300030000030008070003000000030300030005080001
10204677333052204837882037723073684070304370546337304420678074434070408736805087641
10200000005000600070004000002040007030400000700000300020600060003000500000803000001
10763378302846305020805548603070508360564288608540577040807670502333327460663053201
10000000306000808030605000008080300000408000600080000040600000700000000030004000401
10423860406020666070507030364030434473303050707030373472406747735444772025702660401
10700080004070003030500020007050007000500060805030003000300000000000003020004000501
10803078242083208030286838528072402020784430702058223030603525447675603043228033201
10206000500030006070000030006060003050500000704000700030400000000000404000007000301
10703540505650504054303080303780374080305036608730705280606848876230705732705022701
10800020007000502000705000700020000030006060600050004030800000007050700050007020001
10237060334065808340807775405076753745842070646033228080205342504070482040242250701
10003030700080004000300000506000005000002000800060007000207000200060008080007000701
14704058505626563047444530706636704753404022202860704263566030274673802046874028301
10006000400080002060005000400000700000203000600040500000000070007000008040500060201
16737040834030302060203667536573438880703627527080334886357837204045456070502520601
10008080007000700050800080000070008000400000000020000000500000007000008000400070701
10207226655247528750807060403080303673582824336542324840407865587857526358546060601
10800000000000000000403000207000400000000000000000000000400000000000000000000060001
11111111111111111111111111111111111111111111111111111111111111111111111111111111111
