11111111111111111111111111111111111111111111111111111111111111111111111111111111111
10003000000000000000000000000000006000700080000000000000800000000000000000000000001
18705030402377508358574552654766704056508068644033208770208078505037888657207854501
10008070400000600030000000000020007000005000200030300020007000405080000000200000601
10668780604330545032567245667030803650738820303020766045484745605040486560448230501
10000000600050007000004000007000200040500000403070000020000050007000800000200000601
10242882476085204668208050606332724062504827708048436740708450748786802783505367601
10005000300060505000800060400000006060005000008000000040506000500000200050002000601
10703040708660505020776870356546307870204056873888567030203056572570627060402880401
10205070605000200060400000600050008000508000002000006000603000000000800020308000401
10208038407037527740246363703020634026858785406058406522606050728243604460703050501
10605000004000000080003000002020000030000000405040006000006070000000708000602050301
10206544376276737075608060454067262430302230602034787070886060633556705065434030601
10500000000000008000600050300030000000603000607040000070600050500000008050000050501
10225378872642408360672353704770207558306077206060852367404252402873657030275030701
10000020000000700000400040004000800000808000008000400000005000008000000060006050701
10645070808570565335504040342070635043604074782475843485538026254020682748805360801
10500050300060000040003050000070003020003000700000400000007020004030004000002000501
18502280775037868030655064348877308380638270302030407667703050306080665060546024301
10002000607050000020003000003000800030000030007020806000200080300060600020808000201
10653030307020236653208437608073238077225040838070307030546220486236806670707040601
10000080300080700000502000606000000080000060005020504040005000600000300050004050801
10777460668820502050405025804056354630246284688060707078806077205320338085258530601
10000020000040405070305000008000400050500080000040200070702000006060000020000000801
14438078552070304030306758332050705020445080634660647340802377654030265320667782201
10007060400060804060005000003060006080006030000050000070700040000050004000400020001
10503070305460604054733040805075846074604063285064673030547020806576524070402060701
10800030206000403020006080707000006000600020003000008000407000402000000030803000401
10486260805034405040302040304525655040362660503757306024806388306020248540607658381
10000000406000003070200030800040004030000080800000302080603000006050800060600000001
10326462204045844050302770306060705087632050505355602060605863865080507070855065701
10500080005070005000504000403060705000008000303000605000600050000030006070003080001
10206030628350205022388052722057407742806464234030303080828020722860406043503630251
10706000500060605000200020004000600000200000003080002020200040300030408000300020001
10203243254080406870202235407050744620804345606048736023306030437060732540862045601
10400000000080300030200030002050005000400000708000800080006070000080800000508000201
10422464482786747065224040338075506053825726203460706420706053283780805767303070801
10000000003000003080000040600060004040300000004000802000802080000000500060007020501
10464253506070307020878380703750263060802076885074788030707080235323265050406040301
10300000800060300050400000800050000020004050004050005070606020008000007000805020201
10205080282825758350202065675038457356675070208070506060608077402050568425538020601
10004040000000003040008000006000006000308080600030800060407000300070200000002050201
10546027564535304060653560802572803070503070438720302450805850528786304326307620401
10300070007000700030600050700000700040300050000000600040700020000000200000400070201
10303560604520504440258070223370353550806032335852772230586066368540466330222030301
10200030300000600030000050300080006000306040000030000000600040005050000020007000801
10548020602325565028842040702028823050606880405050455376403580604073374042308036301
10004000400000006000003070008000300060300000406060000000500000400030008000802080001
13402473508243705755707272724484506030385344665037732320307554345720605020306830661
10200000700000400000800080008020004040008000005000000020700000700070408060800080001
10263560506530804450423020605080306062805076802067588070252883502054202030557020301
10500000300060207030007000300070608060700080003000006050000000003000005020600030201
10604054455080604034204032437680603040705660402737505038744033668075368620508468501
10306070004030300080003060008000608000800040600030003060003070003040000030400000601
10508070606080445760464470408052806426703380787050583080302480805260685030427530701
10006000604060000020800000202000503000305000200050800080300060700000602060000040501
10538448545087325070403666704080706240506074467360404670406040548887306077373380601
10000000600040008040404000006050300000206000000030800000504000300000006000005000801
10452680608560208050704628784730305447602825867036833726554457607028748068408074501
10000030706000202070700000004000400000700000007000002000000000004070004000804060001
12537040306085607030556046606070667340306232204442604050257825338020402226505040321
10600040500040004020004000500050406000202000002000300080800000000050208000607040501
10306080483730558028204840434420306035572065353050256057706252627240306080608050801
10407030000080007000400080000030002000600080000060005080002000000020300030004050001
10604874677062803288235077237058235050207680222224506640627064432030607755403024671
10400000007000300070003000004050003080400000200000500040800080004000500000403000001
10348472404877407080503334802070406250768748304620328030406640406386643660836068401
10000000502000305050608000004060800000508000300060000080300000200000000030005000701
10433630304050688050708060567070666627303030204020468475708463625787767052508770601
10700030005060008020800080002020005000400030502080004000700000000000003040008000201
10406033736025208070662278384045405050835480407027354040702728883726507048654056701
10706000300070005020000080002080008020600000208000500080600000000000302000004000501
10302730402520805048305040506840638030504046604850607360606738454350704437405064401
10600080007000202000207000500050000020006020800020003030300000002020800070007060001
10225050243052502440803524307026744334677060556042754020808847205020423060275550201
10002070400060004000300000707000006000004000200060008000802000200070005070004000401
17602023407727435082643620806255605683607034202770604468235020738756705043624022201
10003000400070004040007000300000600000505000600080400000000020007000003020600030601
17766020868020405060606785266835286640408768327070227852634663604085576070207660801
10004060007000200060300050000040008000800000000050000000400000006000006000500060201
10308627377542366730204080808070608236657385543263853220603534448774265353378050801
10400000000000000000602000302000600000000000000000000000600000000000000000000040001
11111111111111111111111111111111111111111111111111111111111111111111111111111111111
