11111111111111111111111111111111111111111111111111111111111111111111111111111111111
10007000000000000000000000000000008000300070000000000000400000000000000000000000001
16808060407273205373762287672262802054807046758023304340506057303032324855504468301
10004030500000400060000000000060003000008000700080800060007000806030000000500000501
10647370506530568085878327868050403420783830306030845084838242606050356820478260301
10000000300040003000006000004000500060500000405080000020000020003000200000500000201
10386337884084807465208060602524864084806758203067258780706240437337404467205277301
10003000600080306000800070400000004050008000002000000080305000500000500020002000601
10804060607370806070566570256525403220207077665377774030804057545360556080207660601
10806070304000500070700000800020007000503000008000004000606000000000300060307000801
10205068806058738360655877306050774068436585604025303248208070748653402250604020501
10407000008000000070006000003050000030000000708060003000005020000000808000405020801
10204725454625244064303030738055266870207240707067563040482080885272205076525030301
10200000000000005000700080600020000000204000405030000050200060200000006030000060701
10336367455447403360746368605550305242605076205060834475306334607586755080873020701
10000030000000400000600080002000300000205000006000600000002000002000000050007040701
10237020502770548738805020575060863082606088225425283836334077855080766238603850401
10400030400070000050005040000080003060002000400000700000008050004070005000004000701
17205830752065572070263056756857708420775350504030808783308030808030853060674026701
10007000508040000080008000005000200070000080008050807000600020500080500020206000301
10635070602080724243204526603085544027254030563030605050577830242748708840805070801
10000060200070800000308000708000000080000080004060707060006000400000600080004060801
10455730262360705070303036802044733760888755282020705052603032608760784074454830601
10000080000060804060305000003000200080400040000070600050407000004080000030000000701
18283037426040805050802426622020402020432050673750877840505263624040875880455377801
10004080700020204020003000007050004080005020000020000050300080000080007000600020001
10607080702750606076472080704085323072702048342045764050262050306446754020602050301
10200060602000705020003020503000004000800060008000005000205000302000000060204000401
10336570308025507080505040508788534080228530304338203033408883407070534740307452361
10000000502000006020400070200070004050000030600000802030604000004020500050300000001
10756382303068752060506870208050205047275070308764505070605577742060405030646038301
10200050007050007000702000707060308000005000607000506000200020000070003080007030001
10304080375660803064374067382027206882802623878030504080363040274460207048304260341
10707000700050305000800020004000500000500000008080004080700070500040604000600040001
10404455582050606250306288403020548360804528408036335073808070536030752830382044801
10400000000050700030800030007070003000200000807000200070008030000070300000406000501
10634434866678574047782070737036705035727287206370806430808065864860602774607070201
10000000008000004030000080700050006040200000004000404000607080000000800060002020401
10588656405030307040633360508680372070302086356075554080308040547254572070605080401
10600000500030200050400000300080000080003050007070008020707070003000004000307050601
10302070373385564280206063388025855425328020508030208070308083505040343672568040801
10007080000000008060002000008000003000807080500020800040305000800050600000005080701
10364034864667706020283280806435706030308040435450204670402630883655602252604220501
10700030004000300050700070500000200070200020000000500080300020000000600000300080801
10402530802430203830648040668470822360702025823662576380767047564450274580646020801
10500080800000400040000080500050002000507020000020000000200030005020000030002000501
10352060807328683036457030502022455060702380504060682765204230803088338057403032301
10002000600000007000004040008000800070800000706060000000500000200070007000202030001
15502633705262804245604245526254602030363434285053653770602448663770508030707520671
10300000300000400000200060007070004060008000007000000030200000500030605080500030001
10852560807430204330687060703050802036302038308075242080878572508032307070652020701
10800000200020602050004000800070402020600020008000003050000000006000003040200060201
10702065668030308064304043483250205070702730702473203026345084477044443330406388301
10406020003060300030006060005000207000200070200040007030007020006030000030600000601
10508030402050472350532530604072703636207580876080626070808450708370442050234370701
10004000403040000060300000407000308000404000700020800050800070400000407070000080801
10865827728064427040402873206040604650602055333360504840306030344582502086357470701
10000000300050008080705000004020600000202000000030700000807000700000002000005000201
10563320203560305030804626683480507553203232568084854252575245805067877086505075501
10000040406000707060600000003000500000200000006000003000000000004060002000408070001
12356060704088606060874077506060674260808777604352207070854427843070807882804080641
10800060500020002030002000800060504000205000003000300070800000000070205000508060701
10706050463280764077607360825880405064744082587030747032404632522870302060308030301
10405030000040004000300080000050004000300070000050008020005000000030800080003040001
10707664833044808737265037854052438050503250464546204660465066526040808778804032421
10300000004000600030007000004030006030500000700000200040500020004000400000705000001
10743673208362703040806787405030608380456636702850228060804460708576232870756055801
10000000302000704050506000006040700000802000300050000060300000500000000060003000701
10343850204050345070502080636050582674507060506030884483205343855288266055708660601
10200050003040004050500020007050003000600050206060003000500000000000003070006000501
10807047822087207070523454786072506060844540207067766040603545755337605043333064501
10407000700020007080000020006060007030200000803000600050300000000000803000008000801
10603880708250306068504070203740434070408034308480503340704662323820703744606038701
10600030003000505000603000500020000020002030300060008060200000002080300050006020001
10672070747054708240803432405055866828667070583033542030604843807040246060552260801
10007060700050007000300000307000007000008000600030003000206000800020003060003000401
18304086705744285042523720208674502425405058305240607343232060567388508056244068201
10005000700070005080003000700000600000808000200030600000000080004000002030200030701
15436080554070408040803368282666564740407583482070288574227555405088546030603320801
10007020004000800020800050000030005000700000000020000000300000004000006000300040401
10404357427438884330508070803070608884264374362424462580204252866235353734588030301
10800000000000000000703000506000200000000000000000000000800000000000000000000060001
11111111111111111111111111111111111111111111111111111111111111111111111111111111111
