11111111111111111111111111111111111111111111111111111111111111111111111111111111111
10000000000000500000000000000070000000003000000000000000400000000000000000000000001
16206267736250757830404546784045708036403520504045804550486030205767346238252368401
10005000000080000080600000006000803000300000508000607000400050807000000000000060001
10602584266080645020337736802680302820825254285660605052305260637060867848363070241
10403000300080502000800000600060504000500050008020402000004070005070000070007060001
10707040306020604886505080846050805066404067605060204744355020206078282240202060201
10300060008070006000003030506070006000008000808000800000400050500040000000700060501
10568067262380867050872030803057557320825340406265752840208333422260782268545040301
10004050000020700020006060003000000070000030702000000040600000000000500000005040401
10207350203028606077506036373477632070832060706020873080574566586767704425503320401
10500040405000002000503000000030000080008080003060008040007000700000606000800040601
10535030808564832560702667422370603322407027588062508082705020302680402080846038201
10008000708000000030300000004000700040007030000080603020007040004000704030003000001
12208246306050303056645646322032465080802040204520703060355080784066278060702266401
10005000200080206000005080003080600020407000600070008070006050006000002050800000801
10868450206440252085803080408040204870603544777475825030404020303825406050786680871
10000000300030008000500040800040005000500000000020000060506080600000600070000080001
10352264507075705854245440536550666030753277432020736852703087373220832783285240501
10000000808000400000006000800070200040700050200070000070003000300000200000000060201
10423450658570585322306078237050205256304020502576753070532250703358607653475027701
10000030600030400000004000000070600000002050002000006080000000803000505000700020001
16763260304060207047452247308258805630556053774068856050385383583050208070702550501
10000000606020804000000000503000200030005000008000008060000020008070008060600080401
10323432603050406854603330228020745043625280207488803053583040204027638040525020421
10600060006000600000200080700030003000000030700000706040000030608000000070200080001
13802020203333338430785860603824703064346085507660707062568770405478542374808048801
10005050607000000060000060204000008000004000602000503000000000500070008000008060001
10563040554054255022572034407070523727303660505035602582603374858020508070246080781
10006000600060002070007000703020000040003070407000502000200040002000300070008060001
10702353708080503080638580845068665050227020664360506050483055305087536847402086801
10500070008040600070000040007050000080500080000040008060800030007000000030003070301
10536080657030755643835080703040783840807685335046844370408870605623278050658050801
10806000200080000000000080807060500050008080006000000060600000207000000080003000601
10404824305077234743567550602060803057527050806025565050868354633085722470204762501
10700030402000000000000030800050002000008000207020002070002000000060000080500000801
10805040403027746225663060503046726830706453407050804047605656872730655070245340801
10506030002000006000002050402080000030300050006000303000600000000080400030000060501
10487080487342707086308060406070776086277030255668603430703544267070505022522040501
10000040006000605000700020407000300060000040000000603000800080000020502000006070201
10552387707083207080778350508674475550606342886250804057543450402524308224488060401
10500000604000006050007000300040000000500070000000202070000000808000003000800030501
10706850608588237742277063247030347634526330437526802060505273307074357070205550801
10008000208000300030002030003030500000000020004030005000300080402000008060800020701
10278048703020203030508070742080207065332063307020705380253060306656704032482020601
10003000600060204000600040003080005050003000002000500050704000805000408000002030801
10408630558580605362828674507067572480506666533782626020408050404070604526202060301
10800060300000600000600040005030000080200000300020002070706080302020300000600040401
10336050305854723640305080646030727070702780607050302040704052808040467560736070301
10002080708000400070205070000070005000204000208030600020704000507080000040004070401
16282050708060306020302066564476303047303076704080582480706380304042745026303050401
10003020206040003070605000400000208000806000605060700020008000204000508000407040301
10803070305080864220508640603770806660302360543060845023567232602520808060607380301
10500060808050003000706000807000203020706030008040007000000000600040405040200050801
10688360705028708022604072808032205020207030605036303868575850807060604080822080701
10500030704030004050006000002000005000402070400040200000000000503030606030005000701
10805060404055254070206555704283524566504050447740803728523782708080305084306432501
10604000504000006040400000200080004000003020000000300000002000004050308000800000701
10507447403465307030803550577050503068746052758780802454632055483060603865748050601
10707000604050006050406000600020707080003000600070508000005040300050500000002070201
10604420303080337060406064803260204050504340803050345024506050603460203777503020301
10208000400020000050402020002000606000700000408060700080007080500000200000708020401
10406068452724756480306027666070208737327342805077705230204030247228226670603230501
10400050006000000000402000000030300000000000307000005000504020000000008000500000801
10522630603070727286307427477388772475856280733452528080808034538448603065543746501
10000000500020500000700000700000500080000050000000005070405000000000807060005000501
10668433434670603730606270206830803060472083386420307060208458462660306084305030801
10000000000020406000300040008000307050600020000050700050300000005060004000003080001
10825350285550204035227035852060675080408770832082253240402327704060356427443063821
10000040002000406000003000800080600020300000200020000000300000202040000070000080001
10386066404047706383506835803438403660658250803350787743835650502038233030435830601
10002000207000204000500000200000707000700080808000800020000060700070000070000040601
14802860805460708030837440744250807070705058802053225080726720466450205737437085601
10002000500060806080000020000070805030607000204000003040500060005000300000006000001
10706066847040602057603038552020708035205420608042808050204075703064254540206446401
10607060008080002000608000004020005000700050005000807080203040006070000050800000801
10845024703044553580305485536074684650782024724360303030205040268040542077233080771
10005000704080000000406060000080008000400060006080605070203020500040500040004020001
17805370405070702873505060586270205060402542504050805050704050324660404660305073601
10006000308020400000600030000000208020400000007000700020008040008030500000408070001
10446083207070608720276624488445308060337844435727352827733065508080305346302680701
10005000004000300070000000000000600060000000000000000000008000007000700000800000301
11111111111111111111111111111111111111111111111111111111111111111111111111111111111
