11111111111111111111111111111111111111111111111111111111111111111111111111111111111
10004000000000000000000000000000008000700020000000000000800000000000000000000000001
17308060407278302268745747537586602043406032677076706250406065303067778878402254401
10003040800000800070000000000020002000007000600050700070008000307080000000200000201
10287680407770863072526822876080703370557340507040666072844426208060728640577540801
10000000500030007000008000008000500030800000604050000030000060008000700000200000801
10432685473024407267202070704886226034808783603026585480803220887244806482708385501
10005000700070604000200070400000002030006000008000000070606000600000200080002000201
10602080805230306070443340368267203460208038677272726080405042364570345020407740201
10808080804000200050600000800070003000605000007000006000402000000000700080603000701
10606063505068673250422238605060227086832367507055507556307040677278308560506070301
10803000002000000080004000004060000040000000404050002000002070000000408000503080301
10707824574822863088308050572054872440602440403072723070365070262586704057562060601
10800000000000003000500060400080000000208000407030000050200080600000004030000080701
10472536284526407870323228807670402683806083605070267326708565704843224080665070401
10000080000000600000300060007000700000408000003000800000007000004000000080002050501
10828080306430678556602030247080368076703077375473286434535045358020672732204520601
10800060700030000040007020000030004030006000800000600000008040002030004000004000201
14805430887063382030555067264873402520735370605030204376203050508080825040652048601
10003000404080000020006000008000500070000050003050805000600070200020800020704000201
10767080706060785385203755306026567057788040772020203060387320378235608620708050701
10000040200070500000706000803000000080000070004030508040002000500000700060005070201
10636650745730807080607083604083865650663746368020805074402085805640583048638360501
10000030000040308050503000002000800030300030000080700060302000005050000020000000801
14577054566080202060807734484080802060578060737620428240204778636020766230263344801
10005030200080802070002000003080002020007070000080000080400050000070002000400050001
10808060705270508064454080504033623025405078345034438020725030402845522060708060801
10800020708000706070002040307000005000200070002000006000508000608000000020406000801
10555680602064205020502040202888824030856320507768706056408484607080785240707258251
10000000302000002080800070600080005070000030700000604070407000003030700050400000001
10443547405067555060706270506020706072572060802763704020702557774030605080885035501
10300080002030003000804000807080703000007000806000202000800060000080005020002080001
10204050262840202028858074626046507766502278885040704050824080273520808063804450251
10207000200050606000400060003000500000500000003040007050600050500050608000200020001
10406458344020205430308847402070787320605683806067248034707040335070562480523064801
10800000000060200080400070007020005000500000806000700060005040000030200000208000301
10683738335828365048786060474075806047833528202640704570406068566760406334806030301
10000000007000004050000070600040005050800000002000704000308040000000200070004060601
10733448207050507030327580207360758060707024686088547060808070872837883050707060701
10800000700040200080700000800050000050003080004030002040607060004000007000206060501
10508050665424446730305024737065666235872050704080802050207023603060438866545020801
10007030000000004050008000007000003000204050300080800080604000800030500000004020701
10568066563562205040624470205352408080307070345280703240407440222888707857802670501
10600080006000500030200070500000600060400030000000300020500030000000800000800080701
10606270604370808740423030375380784330807058742658584780837034665240773740743020501
10400050800000200030000070200080002000408030000060000000400060005020000070004000601
10222070708348627032623070506024334060607540604060468675205340804028545032506052201
10008000400000004000004020003000500020200000402050000000800000800060004000802040001
13407465808223302874503625277373404080535882264064666770507337828330308040407430261
10400000500000500000500020004070005050004000007000000070700000500030504020300040001
10267250802380603630538050703020502084304025305027853050482656308037206050848060201
10600000300020503020005000700020808030300030003000004040000000003000005050200070201
10807062728040202082204027634880305040805360402364406063758046754058536230604358601
10605060002070400020002030004000308000700040400070005050002080004020000080200000401
10606030404030677830385760606067402253405450468080474080408370504640548060435470701
10005000508020000060500000304000705000604000500020400020800070400000506080000070401
10588886444074428080307374706080606830403078857260307820203030557265804053776480401
10000000300040008060304000006030500000808000000040700000402000600000006000007000601
10264280706660804040702576327250405248804483736087488766882235205054353073803086601
10000030705000505060600000004000200000300000002000003000000000003070005000703080001
12457020705035708060773083804050564840206676704636807070455643323050704488403040861
10300040600070004020002000600030802000404000005000200040300000000050706000404050701
10408060883520466078806620274430804063383027234050378033603743223340502050403050301
10706050000020003000500070000080002000400080000060002020008000000060200040005040001
10503847422056502858386028322062572040303770777864303680688053322050807648207063681
10200000004000400040004000008060006070300000200000300030600040002000700000606000001
10738734206346807030608835208070403380456673305480563070405430202376672750728026401
10000000607000502030307000004040400000806000400050000040600000400000000040008000501
10436850505050628060806080345030473568403050707070482226705878333634874038203260501
10700060008070003080200070007050008000600030604080002000600000000000008060007000501
10207056577084508030386263825063408060256280403076734020204324784258205037262026601
10303000700030003020000020005060007070800000606000500040800000000000404000008000701
10502270702350202076407040204220533060804062305830308430404828632320803843603037701
10800040003000406000608000800030000050003070800020006070200000003050300030006040001
10252060555062807320803483703087875464426040265076273020208848702040652030785620301
10008060500050005000400000202000004000005000400020002000407000500030004070003000201
17502073302272354034563320502278604665204066705650805523266020878238407044363054701
10008000500070002070008000600000500000508000800060700000000060005000004040800080801
15845040724070305050203258448544257660504233286060678776456635206077228070208820201
10005080007000700060700030000080007000300000000030000000300000008000006000200050201
10307568632243466380803040808080804847386435275265728240502248752574888734766080501
10600000000000000000205000708000300000000000000000000000500000000000000000000040001
11111111111111111111111111111111111111111111111111111111111111111111111111111111111
