11111111111111111111111111111111111111111111111111111111111111111111111111111111111
10005000000000000000000000000000002000600050000000000000200000000000000000000000001
12705070503464205465783233345847203057304073234034803240408078508044347273302455701
10008040400000700060000000000070006000002000200070700050006000206030000000200000601
10624640505560873082643665283050506770276480307070848052275743705040488570863360801
10000000600070003000002000002000600080600000707040000030000080006000200000700000801
10326247528046304457404060802556672088706652807036253640802850677882705462807625701
10005000300070408000400030300000004040003000005000000060408000300000800020007000401
10803050502560802060243740448682607760506053332643343080405086526360623080403840201
10607030304000600080500000200050007000306000006000005000607000000000400070806000701
10507078804054635540567648506080245024547286702032607588306060555887302660602020801
10407000007000000040006000004050000060000000307060002000005020000000806000704050601
10205452322544466088407070458027663270704770704085685070233020565243302042233040601
10200000000000006000300040800020000000705000403050000040800040300000002030000080301
10676678526735604870364336307460807478307064704070438682406563808533372040543060601
10000060000000600000300030004000600000305000004000700000002000006000000050005030701
10662070202330342656205020437020222062807075466858825872377047542040247285808230701
10800050500030000080002060000060005060005000200000400000006030002030005000006000701
17507570252032754050626078556464807850625540302070807263806070505080746070363083301
10006000204080000080005000002000300050000030007070808000300070500080200070604000701
10346060807040367557207645508037776086586050546060203040652750286475207640708030801
10000020500060400000805000806000000060000080007070306070006000400000300080002050701
10487540344650705020508037507078833270574427268080808027805027704380463072273660501
10000020000030502060808000002000700020700060000080200050505000002030000060000000401
16588032737060506080602854862030205080474020746820835630803876437030346750234328501
10007080400030506020008000007030003030003030000050000040800070000020002000800020001
10705040807820207072772060203078872067402076762022734030472060506785622030308060301
10500060402000303040006020608000005000500060002000003000405000705000000060306000401
10422320205038304050808060506652683040248880408874303046507557807040565330405466751
10000000603000004060500080800070004020000060200000208050504000005040300040500000001
10234255705048386050203730206060504048368050308382203070807442438060808040726047201
10600050006060003000203000704080203000002000208000205000300030000070002080003020001
10406060654850605044273062277084802862704445644060508050656030666220305053404580471
10303000700050305000200020008000300000700000007070007070400060600050803000500060001
10707765664020704830507356505070544830208428302026623046307070748020277670457026401
10400000000070700080200020008030005000700000607000600070004040000030400000203000801
10685757437772683077472060755062604066776528208880608370208023366350502722508060501
10000000006000004020000050500040003020700000002000502000203020000000300040006060301
10648657606080402040742640407270582020205025854035846030303020278352772080208040201
10500000400040500050800000800070000050002050006080003030707060004000007000503020401
10408020553553566470302073528063866787486020704030807080702047206030425645888040401
10003080000000004060002000008000008000608040500070800030508000200060400000006040701
10367026857367506040628460807458608070703040456430808860208570758385404544402750601
10800020008000600030300080300000200020400030000000500070300020000000300000200080701
10803270307430208280776020574320848320805083533744865340654084443240437730542020801
10400060400000500030000050200040003000705030000070000000800060005050000050004000401
10687040606758887058542070708045653030608770707030875758303250208084326086605046401
10006000800000005000008070004000200070200000402080000000400000300070005000408040001
12402685802233402284607646373534205060843353684022224420807757762680502030205750651
10600000500000500000200070008020006040005000007000000040300000200080203040800020001
10834650706560303370555070707060803056405045405087347050326367806022605070572040701
10800000500080607060006000800060703030500020002000007050000000006000007020600060601
10402038866040407032606055535740306050305830603346708067467034582035435750704842501
10302060004050300020007040007000504000600050200020005050007080008070000040700000401
10603080202030636470575840304054703424802560273050856060405650508550273070756330301
10002000806070000070600000607000307000604000700070500030800030700000405080000040701
10384233854065345050806866505020704620808086872850702570408020768233305046222520801
10000000500050006080303000006050500000408000000080300000806000800000007000002000201
10882760206440802070605245557480403678604528546053578666537243602082845033406034201
10000040705000704060200000004000200000800000007000007000000000003050004000304050001
14226070308063308080277055207020388380305748203775402050474252633080508446608030851
10200080500050005040008000600070405000605000006000500020700000000060602000804030601
10402020864620746063205280867240603022652036573020372023506838287540603040708030201
10805060000060007000200060000080005000500070000070003020007000000040300060007020001
10507547767027305345372044872083722020205480285458702840583056563080605327808052431
10500000008000200030005000004050003070200000200000400050400080005000300000805000001
10867878403524603020505866505040707240242455203450552030604750804628423860233087701
10000000802000308030702000006070600000706000200050000050500000600000000080005000601
10245240708060568040406030673040364322607030305080844255802656378257756072808860601
10300060007060002060700070003040005000800020607050002000500000000000007040008000701
10205085864032707080742378623034402080257320807025234030608727242443503042522062401
10505000400020002050000080005060007070500000602000400080500000000000705000007000201
10205650402520606078605070505650672050204077404460808370608824358450705337206085201
10700050002000505000403000500070000060008050600040004050700000006070700040007040001
10784020576068403730202732507072273757526060524023466040707266603080886040754440801
10004080300080005000400000706000008000004000400080004000607000300020002080007000501
18204073505683836045666550507358507237207048205360204882387080838742202026465047301
10002000400030008080004000400000500000705000600050400000000050004000006050300080501
16882040825050803060406628258523486360403488528070427362452332604028368080808370401
10003060007000300070400080000060004000700000000060000000300000008000003000200040501
10207288478247383430404060402050608387332623574854865220307838246557724746232070801
10600000000000000000507000505000500000000000000000000000700000000000000000000020001
11111111111111111111111111111111111111111111111111111111111111111111111111111111111
