11111111111111111111111111111111111111111111111111111111111111111111111111111111111
10003000000000000000000000000000005000500070000000000000500000000000000000000000001
14805080604488306254467426872432203046707056528042602880304078707042273856507756301
10004060500000700020000000000020008000005000600030300040008000303030000000500000501
10765720704660245023773283264080307260558260805030275055322786702020355320527640601
10000000600040002000003000006000400070400000204040000020000050003000800000600000501
10458252553033308522803040405478874075805773504045833380506650778338402484302668801
10003000300080403000400040400000004060002000007000000060303000800000800020006000601
10606060705840205080535880786327803550305035844234374030405064332780334060505260401
10704070505000300030300000800050006000303000004000002000305000000000700020507000401
10806043205087522350368237606020236048866383805068703443305020868646204760304050601
10305000005000000070007000007050000030000000603080007000006040000000408000303060301
10307246833575272074605030577034754640503580505083738080762080762488403066865040801
10600000000000004000300080400020000000504000208030000050300060300000002030000070601
10433887564473203670357744508770806632705075705070543653702562607245553070472020401
10000020000000200000700020003000600000707000003000700000008000003000000020004080401
10556040803480556627206070882050585056703053266237724827528073743030254877803830501
10600040700030000030003020000020008020008000200000700000005060006080005000007000401
14802530683042756070362045638858708680232620506050302533704030607070355060263058201
10005000404070000030007000004000800040000030002080508000600050800030400080202000201
10258070808080572828307535207042572056345070677030306050776420228237802330206030601
10000040500030500000507000205000000020000040004070304050004000600000500050003020601
10225270755330203060403064204022572830767468363030608054308052602530675065753280501
10000040000050708080502000004000400040300020000070400030806000008020000060000000801
14735022676040308050308845867030507070373060334880582570307626287020227420682672701
10006030400050207060006000008050005030004070000050000050400060000080004000700050001
10704050403220503084274050606052452072507065757088777050822070302545646060202020501
10800070402000207080002060203000005000800070003000004000706000705000000050806000701
10328260804065705020405020406584525060255850407833303054402663503050333250806757541
10000000307000003030500030800040002030000080700000802030706000006020200030800000001
10278442206065475080605830204050703048447060805447308070502534468040605040583038801
10500070004030005000207000408050803000002000402000408000800080000040007020005060001
10305080754430603072445083372068406772406854565020606020683050336570202054407550561
10502000700060804000600020005000600000600000002060002060200060700050806000300040001
10604653468070807360408874608060747420507238403055677064402070586030866250283038501
10400000000060800070200040003030005000600000505000400060004060000070600000407000201
10237558274465382022837070523024202022656242508730206820403044383420605557807070201
10000000007000008070000030400040008080300000002000404000802070000000700060005040401
10465343503060606070584230808730353030504063722074784050307040524636846060802080601
10200000800080500050600000700070000030008040004020004070402030002000005000602070401
10802030556684888720206053627078726834674020803060503040603056302070353753268020501
10007020000000008020008000002000002000702040500070800070406000400060600000005040401
10427077278622703030747460208427605050505060777670605380607750788344805633606250801
10800050002000700030700040700000300050300060000000800030400040000000300000400080201
10703350205230203240672020522520233270805042226463547850445074583240467560585030501
10800060400000500050000080800050005000706040000030000000500030002080000060004000301
10638030804488624053766070502046543070404380408030324547206720802057336075302068201
10008000500000005000004080006000600030600000207020000000700000200060004000407040001
14802565406422605433305378863548508030873354822054677680205267875650708060504280561
10200000300000600000700040004060008070008000003000000060700000700040607070400060001
10866880405540408680782080703030205084805074308078234040827663805068405060562050401
10300000600050608080008000200060803020700080008000005060000000002000003050600030501
10404053583030404028207068834680604070204560703726806028865036478082548550608677401
10702070006050500030002040003000707000400040300080002060007020006030000060500000401
10806050704080237560366850405063305266304660287030668020506560304320826070826530601
10006000702080000070700000402000706000202000600050200070600020400000707020000070301
10888242585046373060606382306060403350505073554420603720502050487767607065534830801
10000000400070008060305000002040200000802000000080600000703000800000004000008000301
10285580208260205020202344823860506427205265472062664784283528407078743042208025201
10000030204000508070600000003000400000600000007000003000000000006050004000206050001
15457030303027602060373033704060253350804675404466708080885863343030606877608050241
10700070700050004020008000700080305000803000004000200050800000000040203000804070601
10407050756750548053208770728340802084447054763030354045503278785750202050504080501
10202040000060004000200080000030005000500070000020007050006000000070300060004070001
10208383554062705665687087386075386020604260888448508430352044288070607542706025651
10300000006000300040004000006070007060700000400000600040200040004000400000208000001
10834545203866204040704468304040207270243364403880887060403220607365454320584035501
10000000702000504020704000002080600000208000600020000070600000300000000040008000401
10686350204030354020804080423060356465508040702050553364304377575583843046304360401
10600050007040006060700070006060007000800040602060004000400000000000007080006000301
10507072273072205050457528476035302080755760503032848060702473328826706088352038601
10503000500020008070000020008080003070200000305000300020600000000000706000008000201
10806770704470208073408050808620764030802032802430803630404385222240804666303044801
10600020008000205000804000400050000020003040800030007020300000005080800060006030001
10524060368055506250604585206065875724338080378025827030505437407050748020672260301
10004020800020002000800000708000008000003000200030006000303000500060003020008000801
18504065707848285056434850704523807543305032805770503254788020432326303033732028501
10006000200080008080002000200000200000606000400060800000000080004000006020300050501
16848040345050205050303866287678346670204335227050685676246754805077324080808580201
10002060006000400020500030000030003000200000000040000000600000002000008000600030401
10404842828378622280407070308050705523557654274334334480405422458878326258636030701
10500000000000000000504000603000600000000000000000000000300000000000000000000040001
11111111111111111111111111111111111111111111111111111111111111111111111111111111111
