11111111111111111111111111111111111111111111111111111111111111111111111111111111111
10004000000000000000000000000000008000200050000000000000700000000000000000000000001
13408080808463306852536465372555303044308027668027203650407078804035836325603662801
10006050400000300070000000000050002000004000800060800030007000408060000000400000701
10673420503450224046452758487020506340737360205080872073275465203060827340884860601
10000000400060002000007000004000300020600000408030000050000080007000600000400000501
10663562374075806552205060508353886078708422706028545830404560422373603734305684201
10002000600050404000600040600000002030002000007000000080805000400000400030002000701
10602050304460308030286850756825606550308035364746376050402075576650877080608620601
10403050505000500030800000700050002000302000006000006000607000000000700070705000601
10704088706082525340857644506050488036828637603078302725505080772726703430308040801
10505000008000000020007000002060000020000000805030003000003030000000703000306060701
10402675677235483075802040737033886840508880507054538020582080768383308086335060201
10200000000000006000400030600040000000505000803040000060600050700000006080000030301
10822638253353705340852886308730604452508022604040888867803437406527577050423070401
10000050000000400000600050002000400000805000005000500000004000004000000030005020301
10484040606660552787302040648040745062603043263453535876463085285060733464507370501
10400030400070000080002030000050007060008000200000700000007040002030004000006000401
13303330874024726070626088268622502530225470304050304547203040608080837050627037601
10003000807070000040006000002000400080000080003050403000800040200080600050402000401
10684030705030833828404484804056534036827080554030203060875570332343406630507020501
10000080600020200000705000802000000040000050005050204030004000600000600060007070501
10826780652560605020704085407085466320886844848040506047405046608530842064762760201
10000040000060503020803000002000800040700060000020800030303000002040000020000000201
18474047827080804020705534323060707040222080333860854230507226546050352880425274601
10003070300080205070007000007070007030007040000020000020600030000080007000600030001
10407040507350506048457080508074763084302057585028787040446080402832548030204020701
10600020806000203070004050405000003000500080007000005000508000404000000060607000801
10566330406085702080504050705354587060787720505687503063706626707020857530708836461
10000000808000006060600040400030003070000020600000704020804000004030200040300000001
10442576803077628040703430304020807022572060508743805030803675683050408020844076501
10400060007050005000208000803070805000007000503000606000800060000070002030004020001
10704020724640406036736077734086703463504375322080208040542020852550402037205260431
10504000600020505000500030006000600000400000003060002080500020800020505000500040001
10402746386070604420702524303050288570505754708052562045704060572050462830822058801
10400000000030200020600060002080002000600000504000800040005030000040500000802000201
10258888667738842047225030782075803085234865608280204840705057873450508247202040801
10000000004000008050000080700040002080600000003000605000307030000000600080003080601
10288686202080802020576240704560646080206066523062668080505060656348548070203050801
10800000200040800020700000500060000030008060008050006070808050005000006000608060801
10706080775853637440302027484053785238364080507050404050405025808030273827823040401
10006050000000005070005000003000006000607050300060500070405000500080300000004050501
10236068554783606080545460802748306040206060733860608880608220384526602276304820201
10600030002000800080800020200000800070800040000000200050600030000000700000700050601
10508440202360708550555050743530722330605078833327543550772075436650257380656070201
10700070400000800030000020800040005000302050000020000000800070004030000060002000601
10757080708686222082262060502056434050705760807020328575205830806083466046402072501
10003000500000008000004030002000400020500000405020000000300000400060008000403080001
12505366407657808422708658867462303030376388524057257560707673585730708020302270481
10800000500000300000500020006080002020008000007000000060200000300070508040700070001
10865880207880802520533070403080404083604072805078773040487736608046202060875020501
10600000700060208050005000600080808060600060006000005040000000005000008050500020701
10804076532060603076806073655450702060507360502555808038426046628057666740803728201
10504040007070300080007050002000208000300030800030006050007060005070000020400000801
10505050202050256460678620203087404545807750674060655060708630804740537070842450801
10004000804020000050300000207000804000502000600070300060600030800000205060000080201
10483456324038358060508244206050504620804047628680306460508050225547506024242630601
10000000800060002080307000004050600000204000000020300000208000300000004000002000601
10272870602370504020207665762330803346603836836023436737722378704075333023803057801
10000080203000703040400000002000300000500000007000006000000000005080007000305070001
17375040805083708020784088503080487330407448502428204040732482742050608355608050681
10700080300070007030004000200080207000508000006000600050300000000030803000804050501
10202060553380857078707350833440607072738082266030667065305737856470507070706030301
10805030000080003000600070000060008000500080000060002080002000000040500030004020001
10204422846032205473628034435058288020506680827825605880736026656070705258603068731
10800000005000800070004000003030004030500000700000700030600080004000500000508000001
10777262603674202020702776807070805530555344202360743050207520505672755240626035501
10000000808000504020505000002050300000805000500050000070400000400000000050004000201
10353680507080778080307020565040385627705040406040457573202654724777422087503550701
10500060008060005020200020007030007000500040505030002000700000000000006030003000401
10303047546025607050372664558024208050638740203063575080804266826265502057472046601
10607000600040003020000030007080006050300000706000400040600000000000302000007000701
10207270706670703025806060703280887060308075507370602730508472465670607523402033401
10300070003000306000708000200020000070005070400040003070200000008020700030005040001
10852060476047805580305323303084535652754020528067428020802622205070565020457850501
10004070700060003000800000804000008000003000600050004000506000500070002080007000501
14407035608354644047322560303375307786408073602860306238464030376883603022264042701
10005000200040004060006000200000700000408000700060700000000070003000003080300040301
16863020347040604040203778428334268650202327673050725638444574708036347030406320201
10003040007000200020800030000020007000400000000030000000300000005000002000700070301
10608863787752474730304040402060807478433638447857476220507665766435534884763020501
10800000000000000000505000405000400000000000000000000000200000000000000000000030001
11111111111111111111111111111111111111111111111111111111111111111111111111111111111
