11111111111111111111111111111111111111111111111111111111111111111111111111111111111
10003000000000000000000000000000003000500070000000000000400000000000000000000000001
18604020204765608567368826875683504023606024333043604360802088703076326266404583501
10007060700000200080000000000020003000007000700050500080003000303030000000400000501
10245880302770447042287648822080406770288670506080525067537858407040648730772830601
10000000200080006000003000003000600080700000206050000030000030005000800000300000701
10265772447078306646702080205882823073505773507084765460607550264237308263606737601
10003000500030605000800050600000007070002000003000000070306000500000300030008000701
10508070506350608050227330265822302730206073667435548040302062724350628070702820401
10505020804000800060400000400040002000206000008000002000202000000000700030202000701
10803052402085288620832257302040836088465565506038507365605050264584502420505080501
10307000003000000080005000005060000020000000704050007000005050000000506000408060301
10502545684743832063408080766068567620402730604066742020436070478473306087527070301
10400000000000008000300060700060000000307000506060000050700020400000004080000080301
10263333472267205530242783205820802825604058208020785664207242305878333040874050401
10000030000000500000500060007000700000202000005000800000002000002000000020007080301
10572040404630356263508070786050248047703058558275562778738052362070788352505230301
10700020300020000080004070000050005050006000300000500000006020002080004000002000201
16506880587032627080237084352835607660782670503050806524406030402050766020262074601
10002000802020000020005000006000600060000030006080402000500060400080300070207000401
10278020502080273423206677202083684025432020276070507060864230648854306850206070501
10000040500080500000302000306000000060000070005020202050007000600000200050006020701
10882380852450702080603076507034762450424223478040402072706032306630433024644520501
10000080000040507020406000006000800030700060000050400020503000006040000060000000401
18667044342070506030505862482040405050657040433860736720503533734040542640435365301
10004080200050708050008000007080003080004070000030000050400030000070002000600080001
10707040306580305085386030805035647076304082734067262050264040603457554050508070401
10500030403000608040003080402000006000600020008000003000404000405000000070204000601
10253270503038608060208070206734642070538730803334806076407587805040376760405342471
10000000507000003040800070700070007040000020600000208020303000004040400040500000001
10825565508036475050707570408040606073885060808832404020604634642020202060382022201
10300040003040004000706000408040807000002000702000203000800040000050005080004030001
10802070374850807065774048724026305628206787734060706050247020884650403024304830621
10505000500070308000700080005000700000600000002030007070800080200050808000800080001
10203247267020505420703274802030586820804467707024583026708020277020227570447086401
10800000000040600070600080007080002000400000804000700020008030000050500000206000201
10627366378823257026778050363065507042252733807560403350803023756260508746805080401
10000000006000007020000050600040002040200000008000803000605080000000800030004080601
10674425708020605060577320707780465070204027473023775020205040342352757040408060701
10200000500070800080700000500050000060003070003040005070704080007000007000607080601
10707050553885662460404027663038534665267050502080802050604052602030366632657080701
10002040000000003060003000006000006000602030200070200070803000400080700000007040801
10365036747627803070784430804736306020308020732870302680406730355272202522703760301
10800070002000700050700050200000200040600080000000800030400030000000200000400040801
10407850606350302640757050766440556530606085344388858440256042272630682260352070801
10600060800000500080000080800070002000504080000040000000800030002050000060008000501
10464030306745448068455020306063536070407220703080672868706230203056325026307034501
10008000700000005000007080008000700060200000604040000000300000200030002000202080001
12308876805636408428805446254644803040232468728055578340604823237240405070203550671
10800000600000600000700060008040005080006000008000000050600000400070607030200060001
10377770702780407340687070606030604063707087704044263030255738307076608080363050401
10400000800070706040007000800050302030600020003000003080000000004000008050700050501
10303078543070805064705032728280207030604680602234205052332032754023244840402533501
10505020003030200050002070005000303000400030200050008040007060008040000050700000301
10605040607030555270582620607028303776202880446040224040508620206730472020337680201
10004000303070000070800000206000803000208000800070800040700020300000206070000080301
10733242375068222050304662605070303530304066552380408340203020484775802083773860501
10000000600020006080308000003080700000607000000060200000305000400000003000008000501
10826360504870702040807487353420806848806776434046435566468476207085372043604038201
10000060604000407030400000007000400000500000008000004000000000007070002000203060001
13386050206028207030632055405080754730307252208667408060682654474070306555808050451
10800040800040005070007000300020702000505000002000800050500000000020208000706020701
10307040287470857052708820787560307067424028235020786072406853345540206050505050201
10306030000060002000200020000020002000500080000020004080005000000080200020003060001
10808656876026705448454022725067472030804360684247208460683057352050305572508043581
10800000003000200050005000005020007050600000500000500030500060006000400000603000001
10475335804247607020804365705020504250624722707570632050706320302566344270256054301
10000000702000305050705000002040500000706000800060000040300000500000000060008000401
10247430705060587070305050282080472764708020808060873428807865327228232073603260501
10300060006080005030400030008060006000400040302070008000300000000000002070008000601
10307037645047607080635268578023208060433230607077772030206447255636508078267066201
10707000300060005080000030004050005050700000605000600070200000000000305000003000801
10806260208250506034506080203860627020704085702360206330607875334730205466605024501
10600080004000304000505000600060000050008080400030006060200000007070500050003040001
10244050828047805340702735703068855584572080742082432070503667508040664070352870401
10006020500080007000800000702000006000005000600070005000708000500050005080004000201
14308033502383265087444620204242502562404052808880803246556050352837803073443052501
10003000200080004040005000500000200000403000200030800000000050008000002080700070201
17636080366020405030205574422378826670503227784020484435466386507037535030306660701
10003070004000500030700050000020003000200000000040000000600000007000003000400030201
10303287683735622570202040507020704846852255675748386280803436825786832264828020201
10500000000000000000807000602000200000000000000000000000600000000000000000000060001
11111111111111111111111111111111111111111111111111111111111111111111111111111111111
