11111111111111111111111111111111111111111111111111111111111111111111111111111111111
10003000000000000000000000000000006000200070000000000000600000000000000000000000001
15405080302873403663278285788562407057506075333028407260705074707054486333507358701
10003070800000200040000000000020006000007000700040700080004000608070000000500000601
10776350807250362025678362774030804330652270302060442055326444706080758360878420701
10000000400070005000008000003000300080400000207020000040000020007000500000800000801
10827874575056405743808020606742575058303674702045374350803670783264507226707346801
10007000200030706000700020300000008020002000004000000070302000800000600040002000401
10505080204270604070752270774384807650402035383655637030307053357370252060505680401
10707080806000300060600000800080005000705000005000003000404000000000600060404000201
10804043305035474260855862605040787022374578502037407522602040552773604420308040301
10507000005000000080005000007080000060000000206040003000004070000000802000307060801
10208467836456488022204020238035668260206680602046448060456070874532404066835030501
10800000000000008000300050200040000000807000806050000040200040400000008070000040701
10865878776348607580726686803850503782304078702060338366202735605763774050775050701
10000070000000600000200020003000400000206000005000500000002000008000000020008050201
10337030303850552745507040552040275038307052358242468337624054335050638468206780201
10700020200050000080002080000060008040008000600000800000006080007050004000007000801
13307660668084386020744073758355408850235780807020305748204070304040775020354072401
10006000204050000080002000005000200060000040008030305000300020700030600080407000501
10875030208070767482208553408047883056787020267020806060825360372352703650307030701
10000060600020400000807000803000000030000080003060204060007000800000700060005070701
10724580777880704080608034506054552640766774758040704085405084503260825052685760201
10000040000030205050707000007000600070500020000040800080803000007020000060000000501
17724068646040202030603356737080604060857060827650436350507538387030664660486273701
10007030600060703020008000002040008020007080000020000040200040000070004000500080001
10402030305550206072435030304046266086303062232086826040352070402853224020204020301
10400080803000307070005050307000004000500070002000008000204000808000000060703000401
10255860502034704020208080308723472060257630304446806052308587208020577330702372241
10000000404000007020800070800020002060000050800000503020604000006070400050700000001
10826368503032843020302580508060605077546060506446305060208548778030804040727052201
10500060007080004000202000407050208000003000404000207000300070000050004020003070001
10306080636230306048762056847082806488406756566040405040666020747520807038805560241
10507000600030304000400080006000500000500000002070007030300030300080307000700080001
10204465344060807530706626307030544340203628507073583082407080652080725470488033701
10200000000080600040600020006080002000500000506000700040007050000020400000206000601
10248823545737476068855050428075806087686347706440802660304022676370407325405050401
10000000006000004060000060800050007040200000002000205000805070000000400070005070801
10223258508060705070744850807340887030704024335056664040706040782882745020605070601
10500000400040700050600000500040000030002070004040007040306030006000008000402070201
10404060524626576820202047732056483877555020402030308040508068606050742673466040201
10007020000000008080008000002000008000804040400060500030503000800040600000004070501
10554037344368502030643560605785806030306040767850707580202280377538408387602560801
10400040004000300060400070500000700070500070000000500060800050000000300000500030501
10502430207630806740342050647280383750402083556427477420864074286230253380345070301
10200030600000300070000050200040008000507080000020000000500060007060000040005000501
10237040402733365057644060403072235040206750205050567585704850708086772027604027701
10007000300000002000008070003000500040200000304060000000200000200040008000406080001
16403643202836404744208458774747607080534483758057522550408283667650608040303270481
10200000600000700000800030004020003080003000002000000020200000700030407060800030001
10246860202770406880676030203020306067206037208086556020473252408075208020454050501
10200000200040203020002000200080304030500020004000004040000000007000003020400030201
10708027422040306028503042244440806060507270208667706028274074826054367870604765501
10206080005050300030004040007000205000700070800080002060007080008050000030500000601
10607050204070847450823230602063605884402540854080645050705270505240278060244250301
10008000708060000080500000705000707000607000600020700060700080600000704080000050301
10544544277035863050307277704020804750307058556280507730304070326856703032546660801
10000000500030006070408000004020800000806000000070800000403000800000008000002000801
10755280403320307020508428366350404323406526688033432524758262805076475063305055701
10000080505000604020600000007000400000800000002000007000000000007060006000307080001
12682050706068505020677042502060286350603285807377805050382674386080803656505040271
10300040300030004080005000600020604000503000003000800030600000000070204000402040501
10705040722660578085302870388560305082286082858030534026806572265470507050607050301
10402080000040007000700080000080007000500060000080005070004000000050300050008060001
10804853673034208542726025485026624060408230662448408360437057876020805467408072431
10400000003000600040007000002070007050800000700000600030700050007000500000604000001
10276628806744202030407225704080807220743574504370462070808850507332244340784038201
10000000606000204070207000005080600000305000800020000040700000800000000030008000601
10476540405050224040308020467030478753302030302030538567706845337234767026602470701
10700050002050007040800070007050004000600050602070002000300000000000005080002000501
10307076877068602020367337386072606030267280403032355040204524564825703086562053701
10706000400020003030000050006040002070800000303000700020500000000000304000003000801
10303230605660407055208070706480656030302046703580305780304777565250506577207045301
10300070004000603000708000800030000020002020600060006070500000004060200050002050001
10677030645038502250207586307042737547676080254075276040602656603070632050864350801
10006060500030006000300000805000004000006000600080004000203000300040008030003000201
12204088707687655064658660605277205343704034207530207478443050728334502034448034801
10006000600050006060008000800000200000807000500050500000000050006000006060600060401
13325080464050604040504537256486556770505325646050235747227858804042887080306240701
10004060007000700050800040000040005000300000000020000000500000004000004000700060701
10602768436884774580602050708070802628757376535472748580303672445683346276275040801
10200000000000000000708000304000400000000000000000000000200000000000000000000040001
11111111111111111111111111111111111111111111111111111111111111111111111111111111111
