11111111111111111111111111111111111111111111111111111111111111111111111111111111111
10006000000000000000000000000000008000500020000000000000800000000000000000000000001
14703080308877407366885378773557405033302076655077702750504023402087836367306648201
10005050400000800050000000000040002000002000700050500080004000206070000000600000701
10555870707570532043266585373030303540484850204080522066664622206070886430657370601
10000000200050006000002000004000200020300000602080000020000050004000800000700000601
10654852835022306583504020606564623075302752303074435540308640757348208637604437201
10005000800050607000400070300000002030002000005000000030705000300000600020005000301
10304030206680702040458860826343506530602042776434586020508058853450567070803360501
10408060405000300020600000600030005000402000004000005000208000000000600050504000601
10605085406035425520676787805020674066235237704052502747802030467853202720808020501
10808000005000000060002000004060000070000000804030006000008080000000405000203030801
10204578247735847032603040233026487220507270707062632070622030652344202042676040501
10400000000000003000300080200080000000304000406020000060600050300000004020000060601
10756856582746507470486863202420606848402086604060367257502635503753588020844070601
10000020000000400000600030003000800000203000007000700000003000005000000030004020801
10543060405870534673604030666080448047804078477435588283365047457030526776203550201
10400030700060000060003060000060004040002000300000400000006050003070003000007000301
16605850246055743080455083853754604370523620507070307582507050406080835080424074201
10003000706070000080003000002000400030000070005020208000300050800080200060204000301
10644080407060847843806864204063362052728080368080705070486820546455804520602030601
10000080700070700000302000804000000080000070006030408060008000200000200040006070301
10623560587750203070702064202034488460537667274060506065502063204670764062858460701
10000060000070607020604000002000700050600040000030200030506000003080000060000000301
12572046624020606070406754876060405060433080442520758470507728566030475330744327501
10005080800060705080004000004070005080002060000080000040300030000080005000800040001
10606060503380508032266040402057472033503077526038354050365080703765857020306080701
10600060705000402070006060703000006000700040008000004000403000307000000030608000801
10378380804056205030403020705356464050676640402733408083308528206080862420203572521
10000000206000004060800070200020003040000030600000403040404000004050300060200000001
10583555206063447080606350405080606054848030502333404040808378456020603070824067601
10200050006050008000302000705050707000003000205000505000700070000030003030008040001
10503050866640407026677037285064604874706637638050707030737030578740804068502530461
10302000600080308000400060004000600000400000007050003070700030300060306000800070001
10408874768060704220604674402080563880504573802085855066803020687020338220545082501
10400000000080800020400020004030008000600000707000200040004020000070500000507000201
10858633736736234042823040332057604027757348706870305550506054856570804243204080201
10000000003000005040000070500080007020300000007000302000707060000000600020005070201
10862854506030704030477440302760852070407045368022855060404040666334675080606040301
10300000800050300060600000700050000070007050002050008040408050007000007000406020401
10807050733858575840504067745054272236833020706020607040504036608040422226285060501
10007040000000005030005000006000005000806070300040500030504000200020800000007030801
10824057865472805020862270607563403080805050578360607420506560588437402585207660701
10400040007000800050600080300000300040600030000000300020700070000000500000800050401
10503450603470703860752070385560777760804053322465574850473088332220648760484030501
10700070400000400040000040800030008000407080000070000000700020005080000050002000201
10656060202342656043382070303055488040603370807030888566307230807058575044507048201
10007000700000003000007050005000200050200000808050000000700000800070005000608030001
12207765603525704646708672733247703080536254462084477660304475357730207030306340881
10200000500000600000300070002020002050007000004000000080200000300070808080700020001
10845680407330406550476070604030506084808076206048837050357444703023203040434070501
10700000400030406080003000400040405070800070007000003070000000007000006040600070501
10706072844080304063303043765540704020604380402743507036557056372068245780306674701
10802030004070300050002060007000206000200060700040005030004060002060000030700000201
10803050305040348760578240608073802454408280362080652030308780406380753070585780401
10004000208060000020800000605000306000708000200020500020200050700000308070000070301
10686376665037346050808572208060403730507085538420502280608080535786302044267770801
10000000400040006040604000004060600000806000000050700000203000200000007000003000401
10675570308470404080505852658670804364603887787025564584884428403028332047304036601
10000020208000308020600000008000500000700000004000005000000000002020008000706060001
17563070603048407020863057403020446580304664803742407040746674873070202743505070781
10600060300080007080004000400030707000206000004000600020700000000050303000304080701
10502080753670434055506850388270403042282075424060285043404276333340303030308020701
10605060000030008000800050000030002000600060000080006050008000000050500030005080001
10607553228022407653573044678066648020703640223554202560383065536050207268503025841
10400000004000300070005000004030005020600000500000400020600050005000200000503000001
10482624606347702070402868705020608640864878505270486080703780505372742760774075701
10000000606000607070704000005050800000506000600030000070400000800000000050002000801
10443480602070677050705050536080446635408070803060326788507884632585485024808680701
10200060002080007080300020007020006000500050705060002000200000000000007020008000201
10607035547033206060532255437072708050564580204055555020203632274552706056578075701
10804000400050006050000020003020006040600000504000200020200000000000604000006000201
10607860407470704085407040603380854060402065507380305670708778748870703777603037801
10700060006000403000806000200070000040003050700080006040800000002040600050002030001
10454040667038804370602277202048627252356060767034533040308728505030283060277750401
10007040800070003000300000607000007000008000700070006000202000600020005080002000601
17602035404684385062662540607457508824302032502740402243858020757885604034548035801
10007000800020004050006000800000700000405000700050200000000050007000003050500020301
16746030545070803030204257263233466740607646872020378733856248505083856050605370701
10007040005000300060700030000030005000600000000020000000300000002000004000300070301
10705336825665834380507050406020403487364635882275674750703324656678766735855030301
10200000000000000000802000607000700000000000000000000000200000000000000000000030001
11111111111111111111111111111111111111111111111111111111111111111111111111111111111
