11111111111111111111111111111111111111111111111111111111111111111111111111111111111
10000000000000700000000000000020000000003000000000000000300000000000000000000000001
17802762272830535270704822536063702035405550308055406520685040208287635624267654601
10004000000050000020400000003000802000600000805000604000700070207000000000000070001
10605327674020468050854432607520506530274673755380402067807530272060463768348070781
10304000700030402000800000500040608000500060003070408000008070006070000070006050001
10707030705080602843403070888080502028203026406080206475338060503082422760804080701
10800080007020003000006080502080004000002000504000700000400080700020000000800070501
10874073563440544020665040606075232350226480308288342380203467254720522787765050401
10005080000080500070007040003000000050000080402000000060600000000000400000008070501
10305340707084303037403066875277878040766040604080373050734878283882707747807230801
10700060408000008000805000000080000050008070003030004030007000300000402000800040201
10442070408882666220308446823580205472506085828078807055208050406570302040374042501
10003000704000000020200000004000200060003060000030804050005020008000306050008000001
17507346504050707062585233464023577020802020505680704060364030255047736080306854501
10002000500040506000007070006040200050402000300030004030005070007000004020400000401
10653220606330268076208080702080506360403423485472864030306070602474203060867730821
10000000500070007000200060300020008000400000000070000080802050800000500080000060001
10865833308057602736855740766780244020255365428050672274205058637850373574575380801
10000000706000400000002000500050400050800070200020000040006000800000800000000020501
10254850564840578882507048875030504863303040206224784030746730208837202662673038201
10000050700050300000005000000080200000005040007000006080000000405000608000600030001
16855420305070603045363554203882304850556035584057858080387277477040303080808360701
10000000402040602000000000508000700030006000006000007080000070004030005050300080801
10665284604060803458604720364060558033542550305332307077427020305055885080635050771
10600020005000200000500040200030004000000070400000606060000050205000000080800020001
17703080608365685360327330202724703044782077302720804055268370403285283726705064401
10007060504000000080000040403000006000006000408000805000000000400040005000003070001
10573040277062252077443088804020225747607720207044808552202273547070302030373040631
10006000400050003070003000807070000050005080208000708000600080007000300080007060001
10505435403040404020887850858082863030352080885520506040775066303034725856605052301
10300080007050300040000020003040000060500080000070003040400030003000000080008020201
10428030747040353564324020603030283660202423446055327550602420603386874020235080701
10507000200020000000000060207060800050002070005000000020700000807000000040006000401
10306365305082567874322530607080605072474050402056377030487336432033628740204375801
10600040205000000000000050300040007000004000704020008030002000000060000030700000201
10407030708067547354754080703056763280306338702080206044204588367320872060353850501
10702040005000004000006040606070000080600070006000207000400000000030800040000070601
10784040736736608078705020504050228076365060644228403640307857737030204026424040501
10000070004000702000300060503000500070000020000000406000500050000030603000002020801
10465354402068802060458740407385373350707755277660803082422660806385705848886020501
10800000505000007020008000800030000000300030000000705050000000207000005000500040201
10808240306376753743262035427030535782474360456474606020707627604028466050805840701
10005000403000300030008050004060500000000070002060007000800070206000006060700080401
10546028502050504070603050556020207045822057305020207250762050606778408077377050701
10002000300070602000600040004070004080005000006000300050307000704000403000006080301
10604820886740603538528587505054437260403747273638674080807070708020403584704030201
10600070200000400000700020002050000030200000300070008070208080302050400000700070701
10452080703744658520302080837080888020706770704070602060304022205080843640636070801
10008060703000400030704070000060006000608000304060800070802000303020000050004020301
14522040204070803030307054234628605042306074508040853630607350404085553026207070401
10006080306030004070405000800000506000204000208040700020006000806000604000405020201
10206050807080377840608550402580706250803740783050422075624448303680704030604650801
10700060403080006000204000407000204040504050007050006000000000400070708080300020601
10233370402022204053508088206026702080303030807046703258635520506060504030384060201
10300020605030003060005000003000002000305040600070300000000000608050303030008000201
10705040202038664060803357308748564357708030433350407646624738205060402047808735801
10603000305000005060200000600030006000003050000000600000006000002080208000500000801
10603386802884808060506520344020605082553072423370603268488042785030503733753040301
10607000307030008080802000500040503030005000300070707000007020700060800000005050701
10608270404020486050802072806420506050303560307070858065204080406620804356208080601
10505000200040000080202030005000203000200000406050500050005070300000200000304080601
10705028543727556660805065788080805537325265806078507280607060427623287650302460401
10700020003000000000808000000050300000000000203000002000505050000000003000600000301
10466770607070485228708783882422652346333480552548585050703068423625603087548274601
10000000600080200000600000400000500070000020000000006040702000000000502060003000201
10426643522740405320807230703260702070356078886430506070708774578630307074508030401
10000000000070305000400070007000503030600050000050600070300000004040003000007030001
10656820735870505057437082643020445020507730263086825330408222204050466476877068621
10000070006000808000003000500060200020600000600080000000800000506020000060000030001
10576023303064607555707782407524607760546580702580348363738330803083624080532240601
10002000507000202000600000300000703000700080806000400020000020500040000080000050401
16802280303360703070367850735820405080708056307078236080847660465750603738527033401
10003000500030405060000030000030303050702000807000004060400030004000700000006000001
10404084548050807038205078237020203054506470505044604060506025502026575330605672501
10305020006050005000506000003060008000700080005000406070304020002070000040600000301
10782038202034654580604242553046478270237083577540708080503020683070558028237020771
10003000706030000000605030000050003000200020006050807040207080300020300080002050001
17206670508080708672205050337480603040304683506060402030405030453780405480708066301
10002000704060500000600080000000302080700000002000200030006080006040700000808060001
10677063804050708680634783253745405080254774325854747438855072307080705886805330301
10007000008000200060000000000000300070000000000000000000004000006000500000300000601
11111111111111111111111111111111111111111111111111111111111111111111111111111111111
