11111111111111111111111111111111111111111111111111111111111111111111111111111111111
10008000000000000000000000000000006000300050000000000000500000000000000000000000001
16204020605264402766462844628788705027204082656035702630702052504033753744305345301
10007040700000700020000000000050004000005000600060500060004000606050000000400000601
10363630204630534063473375466070808850328630306040427047754634202050465680457260501
10000000300050003000004000008000300020300000403070000020000020004000500000600000501
10384354755072702735408050604554658085203747407024575560505740433766703645404585601
10003000700030604000700040500000003070004000002000000040504000800000800070004000301
10605020505270403060663680476273707850307073282376385050506088555440763020604580601
10407060605000300030300000200030007000606000007000003000207000000000600030608000801
10503077202048828620468775807040354085626548602073804862803080424547606650302020701
10206000008000000040007000005040000040000000806020002000004060000000506000208020701
10608422452868438066305030387067783780202450304084626030476060478268602032585070401
10400000000000003000300030700030000000702000806080000050300070400000003050000070401
10885223544654603270684755806470607528706078405080364566306834307322584080837070401
10000080000000200000700060008000200000307000008000800000006000005000000050007050401
10533070803620223454707050257080848074804062742655277352288047685030755257303750601
10300080300040000070006050000030008060004000200000700000005030008080004000003000501
12406380482073434030822065283637203630257330702070808567203040705030327050273034301
10003000408020000020007000007000600040000020008020805000200040200050600060304000401
10666070408050557685702235506024637072442050672080405030344830787667804860204060501
10000020500020300000702000204000000080000030005080803020008000200000300060006060401
10777420782250304080306053805046865280623687666080805038802044305740423052682570301
10000060000080303020604000003000400050200060000020600020408000003060000030000000301
13383078477030207020302863877030203080427070536870357720203387754020622540848844501
10008060500020403020008000004060007030007060000050000080300030000080004000300060001
10203080406280203035386080603054465088206028888074556050736080303625663070405040301
10300020503000206050005050508000006000600080005000007000508000602000000050404000201
10686480307055806060802030603265664020638780207674604068504437606050652780606353221
10000000606000007040500070800060005030000080200000603030202000002060700080700000001
10444545707037248060702530505020502064866030302855702080408224878040202030286027301
10800060006050003000805000607020202000003000205000702000200050000040004080002040001
10606030872870402054378066457074408222505484832040804060675030267730703084606520221
10508000600080803000700020002000200000600000004020006040200020600040203000400040001
10204363257020604880602652303040443660306728403075537086402070637080767820474052701
10800000000080500060400070002080008000500000208000700030002060000070500000402000601
10268287888327337045675060534072703047887886404880805750703087622650203823508040301
10000000005000006040000030200050007030500000008000506000204060000000500030002070301
10232566502030803060362270703380752050602057667052585040804060288554224030405070801
10700000500040400070300000600050000060008040004080005060308040006000008000607040701
10804070686543872680707073276023585573525080307020603040603032306020772382673050501
10002040000000004050006000005000002000705050600020600040306000400040200000008050601
10287033557448303070573680606345806040607060236770308830702470388852308248207320301
10800030004000300030800030400000200050700030000000600020700020000000300000200060301
10403730507380803780863040727430488520603066438375435270733088248320523530556060801
10600050400000200040000030600040002000408020000050000000600030002070000030005000201
10644030307833758024275040505045665060305750306040785332506370203034366055502067601
10008000800000008000007080002000200080600000204040000000200000800020007000207040001
15303577506347607733205537628533306030326552882028855660702847776780504070808460551
10500000500000700000500020005030003050003000004000000050600000400040503080500050001
10667460705760803570544040504080502025802078307053376030568484803044206060775020701
10800000300070606030007000400070707070500030004000003020000000006000002040800040501
10502042657030407065602052537460307060208630302267308084887057723048364870405257301
10405070006040600080006070007000205000200040300050005050006030003050000040400000801
10402070202030758720354480803065707567203750647050447080603530702680526080244280501
10007000606020000050400000608000508000604000500020200020700050300000806060000080801
10337662778026624070206886204040805670704067544220305670204080887352206037678760601
10000000200050002040803000002030300000203000000020800000403000500000002000004000601
10675870304450205030602748582370807367705235336056582853247352508083334052303057501
10000060205000406070700000006000600000200000005000007000000000008040004000308040001
17838030606072707030343063403080525740607825808585806070475532678050802236205060641
10400020200080006030008000600080707000706000006000700080300000000060605000702070701
10707070268540556027306680585640804034656022544020457088503266464270807020806050201
10306050000040004000300040000030004000800040000060004040008000000070500040006040001
10603682656044807526653077473066764070804720525755506860554073773020404467406046771
10300000005000800070005000002080007070400000400000200070500030004000700000508000001
10535528604466404030703444507040307770554854306230478050608640208635437740672085701
10000000804000803060208000004060200000804000800070000030200000700000000030007000801
10354820405040852050803070234070832576606060806060233743507582626382726064602570301
10600020004070002030300040005020007000800060407060004000200000000000002060005000201
10605058484033407060638275835077805070732240203067834070306636357524704053583026501
10205000300020008020000070008030005060800000706000300020200000000000805000002000301
10605460204670508063707080308560268080305055304820602580507445627870504276606038801
10200020002000702000304000400080000040007020400070002020300000004020200060004030001
10544070436037206740707724203046248623625070885067252050806838305020225030755660501
10007060600080003000400000404000002000004000300030007000703000400020007050008000701
18508032402757526053455840407534206525204062603850508252775020765226508046823052501
10006000500040006040008000700000200000602000200080200000000030007000002020600030801
16256050453080203060705384543388543470507583753060447644284586302082628030408280201
10005070008000800060200030000040004000300000000050000000800000004000004000300030601
10302656625622727540406060207050506668474352343463646470702567483754582588764050301
10700000000000000000308000405000200000000000000000000000700000000000000000000030001
11111111111111111111111111111111111111111111111111111111111111111111111111111111111
