11111111111111111111111111111111111111111111111111111111111111111111111111111111111
10002000000000000000000000000000003000200030000000000000600000000000000000000000001
12805080706477606383888288752737708038608074488082803680308053803056834864403587701
10007050500000700060000000000070005000005000500080700060006000306050000000500000601
10828660508330375032344682366080605460366680507030445025686423406060636620732720701
10000000800020008000006000008000300080500000402080000020000070002000600000300000201
10555583368054708244707050306266357073302547304023523440504780686387807585607867701
10007000500060203000800020500000004070003000007000000070502000800000700030004000601
10204050707370403060575760464554507640504064624525774040706053557570526050305620301
10505060508000500050500000200070004000708000002000004000207000000000600030806000201
10707082203085445820463826503070722072462646302054706862708020346655504340306020501
10202000002000000060005000007060000080000000704080004000002050000000508000302080301
10806238578766524085405050582077853480502630408053227020686080225656705068283060601
10200000000000006000200040300020000000405000308040000050300050300000007040000060801
10476445835767705360747355406830408626205056204030544454606482804623883040783080601
10000030000000200000700040006000400000205000002000200000005000004000000060008050301
10652070408530744452802060765030484058305082528346473268728027684060248486805450401
10700030700080000080004040000060005030003000400000800000007080007020005000002000301
14203240744088635020575052478684502530537820704030505542507060707020864020575033801
10007000304020000070003000006000200020000040002070302000300020200080400030404000601
10768020207080725686303334702076826058662060474080808030658760323533807220805030201
10000070700020200000605000507000000080000050006030808070006000700000300080002040801
10234770535430405020506075403062422840673344343050406088808025606280335052766270401
10000070000020405060808000003000200040700050000040700060704000002030000040000000701
15346032646080208040805874755030405030724080248550836350505828578080878650662368401
10004020800040507040005000003040003050008080000040000060500030000060007000400070001
10308080702360206036488080803047558056202066282047638060666060806848446040406020201
10500070605000504050003040306000002000400020005000007000502000602000000070704000501
10838680608055502060306070307784645030225460302864804034703286708080833580604823571
10000000204000006020800060700030002070000070700000503040704000004060700040700000001
10854848203025875050502760504040706068484050405452402060804883872060305040772033201
10400020003060004000503000503060303000007000602000203000600020000040003080004050001
10602050554370302072468065372048605224502676648040608050745050548360705064603560461
10404000800070608000500050002000700000300000002070004050400050700060704000400080001
10808354827050507250408384205080673330505347207056636033603060275070542460553058401
10200000000070800050500050005050003000600000804000600020008040000070600000508000601
10582555878762866064583040257056307054684577802220607870507062733480803483307080201
10000000004000008060000040400070008030800000003000507000502060000000200020006020201
10853566808020403070666550202450656070306024684062637030308040225664626050607020601
10700000500020700040500000500050000040007050004070005030705030002000006000304050701
10807040886776686870707058365062787346283040807040608030205024803050862376725050201
10004060000000004020006000005000002000307030500050300030203000600080300000005020201
10326057858554405040387660602632804060307070546870203250405880585233205582605240401
10400080003000300050400050200000400030400080000000300070400060000000300000300070501
10404840802740202750327020747430535650803035746557646870725085754630688880782080301
10600050200000700060000070700060008000408070000060000000700050002030000080008000401
10378040206335228088562080203062787020303420506060633828807830203028673027807083301
10008000300000007000006080007000200060700000208020000000400000300020006000502040001
17704285305576204465503283458724204020378453552025356370204568242340306030804880431
10700000400000700000300080004030007030006000005000000020700000600030304040500020001
10652550802570803760873030702040203027208035702026622050272474206088708070636080301
10400000800050202030003000300070303030700070006000005040000000008000003050500060201
10702074725080208044807084378350607070407550308458408085564066434063475260504447501
10406070003030700060007070008000408000700030700040008030005040003050000030400000501
10708040203020538270556550805034308337607320333050274020307250704230383040724640301
10005000508030000080600000602000808000708000600020700030400040300000708070000030601
10734246466075867060203352307080505360603058252450703380503030727466702035656430401
10000000400060005030205000002040800000308000000030700000402000600000002000002000701
10774320503220707050305868328870406328606654544072426774674223303078422063406022601
10000080708000404070500000003000200000700000003000003000000000002030003000703030001
13623030604038306040433076802020863540205626703768308030862554564050407588506070351
10500050300050004050003000400020405000507000006000200060200000000070505000404060201
10302060227260733032707660422570405023655066822060438026307786554380604080205060801
10207030000020003000600020000060008000400030000020007080005000000050700070007020001
10305677438076604376856064577053875020403480668838208330388034655030308363608063841
10700000006000600040004000004070003040800000800000800060600070007000800000803000001
10472433705572302060207622705060305780683873506880725070402880503464734840457046601
10000000804000208080308000008030300000807000700030000020200000600000000060003000401
10584630305020636030703060578060428664604080604050475776507682744463668056708860601
10800050006020002080500070004060002000700080702030008000700000000000006020002000701
10602028774075206020635286746033706050778620408058756070607676645856803035433025801
10504000500040004040000070006030002060400000403000800050300000000000408000006000701
10305560507770608067405040504880348050202067406770308640206328288570505537206032601
10700030005000702000405000200020000050006040800080002020200000008050600020003040001
10764040435084804530603562508087722732533040272028452020404733502030253070628240401
10005070800040002000500000302000003000006000400040008000303000800050004060006000701
12606056805234342066453650604358506373305046607380307472624050463277704064782036401
10007000200070003080007000200000600000503000500040800000000060005000005080200040401
14264020725030803030603685528244852550308763728060283533374576803033386030808240701
10007060007000200040200080000020002000300000000050000000500000007000007000800070801
10502222623372544880608060204050304467252762864856362460704874836854675877358070401
10300000000000000000802000308000600000000000000000000000400000000000000000000050001
11111111111111111111111111111111111111111111111111111111111111111111111111111111111
