11111111111111111111111111111111111111111111111111111111111111111111111111111111111
10005000000000000000000000000000002000500050000000000000300000000000000000000000001
18807050408332403288475886522284507086604037823057808450306088402086562562403375801
10002030200000800020000000000020006000003000800070200050003000505040000000400000601
10483670502830776077552485837070202320268530604070735035683383505030663850754720801
10000000300030002000008000002000400040700000807070000040000070004000700000500000601
10522237436074406886704060703652758023503747208027725570402520785356803346308764501
10006000600080702000800030800000006060004000003000000060304000400000700050007000601
10602030505250507050722760674258305460306056553575253030607028728870563020307480801
10507040808000500050500000800080006000703000008000002000302000000000500070504000401
10407056307043326660284778407050556024424636202048503448604060687283605220506070201
10803000004000000020003000008080000040000000806060008000006030000000202000308040501
10802665456673842067702080425063322750508320702053766020558020324877803074533040701
10500000000000002000800030700020000000402000207080000040400060700000004070000040501
10222278683727505720258736408330605256206064808020285288603284308877854050765040201
10000020000000700000800020007000500000406000006000700000003000002000000070003070201
10863060303840845747708030487020462084304063463563834245733052422080344438807840201
10400040400040000020005060000030007040004000500000700000007030005040007000007000501
15608460454075232030338066757522805660652820605030203746702030308070355030664034301
10004000303040000040005000004000500030000060006060206000600080800050200080304000201
10665030303030254456407236208025684026726070532070403070655880457276502780705030601
10000030800040700000205000206000000070000080002070303040007000800000400030002070701
10686520267440506030302022607074826770566746658050407037605057305420768036268670601
10000030000060708030508000005000200030700030000050200030307000008030000080000000601
18523086275050504050502657236040206080267040573440454650402435226050847680583842601
10003020200070506030004000003020006070004050000030000030300030000080003000800060001
10807080204630604052264070605062642068707056668034222040684030203575365030303050801
10500070303000707020008020404000004000400040008000004000403000705000000030206000301
10482840303063504060605070508288366020276250202733205033303835502070882730603335681
10000000307000005040500020600030006020000020700000203070704000006080700080400000001
10567427602046242040405470508050405053883060705685808030508264347020708080583035701
10300070008080008000306000502020207000004000503000203000800080000080002020002040001
10306070642470404065338082276065705267606277667040608050658020675770603087504780561
10707000300040704000200060007000400000600000006080002030700020200060502000600030001
10706627458020807650706563702040724360704366804077283083306070765080636470345045801
10400000000040800030800070007060002000700000207000300060007070000030200000305000801
10872545763467487073534020526085205054625335208670508670505066525420504842605030401
10000000003000002020000050600060005050800000007000507000403030000000700070005020301
10472346204060706030427540207230624080502055224067236060206080656483567080805070301
10200000300070700050600000700030000060005080003080006030508070002000005000303040401
10406060452837252540502048224028287722473060203070407070205048307070482387752070301
10007080000000008050006000007000002000304050400070700050604000700070300000003080201
10765048325678505080456740204686304080607080488430802670607220257633402846307860801
10400080004000700050700050300000800020800020000000600030800050000000800000200020801
10807720707420407340462060685670662480306025334655358350788053823260763220286060501
10800060700000200020000030700030002000408020000040000000400070007020000050006000801
10577070607488427048268030706074642050805620403080453654606250802076587026307028701
10006000500000007000008050002000300060700000708020000000400000200020006000708020001
17302227308553503687408788442333406070828374752065668640605373285540308030303330561
10300000600000800000300070006050008040005000004000000050500000800060608060300070001
10746860404680607380873040202030607072502058703035864050234345302046704020273050601
10300000600020404050007000700030207070600020006000003050000000004000008040300070601
10307076368040502046305075224280402020408240806664205082232024433054757750403247601
10502050002030700030007030007000704000200040800070003020004070006060000060700000701
10403040407060677630544220803022502873805630667060433060404740508250332050546250601
10006000505020000070200000203000805000407000700040300050600020200000502050000020501
10775477348054348040505377604020306620705026462820807840508060385288305043478420501
10000000600060005080702000007020500000205000000030300000805000700000005000003000501
10364320602330406020806354246380806625407656862064368555642567507067376025804054301
10000020802000407060800000006000700000300000005000005000000000008080004000702080001
15435060205044703050823088203020767740607565502554206060654234245060802555302030471
10600020200040008030007000600030607000603000007000600020600000000020408000707050701
10202030886860426038302760672270705075357055636050755028802873562630506030702040701
10305080000060003000300020000030002000500060000020003050002000000070700020002070001
10603788225052607366622043788045485030605230663342602680244027522080504273204082731
10200000006000200070006000008030006040300000600000200080600060002000400000803000001
10865246806686404050308344407020704870725274204350288080605360707226533550445065501
10000000507000305020508000002040700000705000800080000060700000300000000060004000501
10856680606060668060607050665040227235303060303080878736308687636335523032408570401
10700040005070007040300030004080003000600030602050002000700000000000007040003000501
10804086452035406020737586523066705060457560603053227080707782623846402073484085301
10607000700080008040000070006020007070500000605000600020600000000000305000002000401
10803870205860502044804030503370544080808047206550208220306365427540306334806068701
10600070008000707000402000700060000080006040400030007080500000005040200020003050001
10337030686085408580306252606085463745467030435023878040407776407030737050542260801
10006020500080004000300000806000006000006000400070004000808000300080003030003000201
13506043205776856034222870702367505766502068504670705824683070733567803048747063201
10002000800030008050003000700000800000505000200070200000000060008000008020700060601
12472060774020303060305728543434833360502248725020576672758835408054768060503850501
10002060004000400080300020000070003000300000000060000000400000007000006000700020401
10303757537878827630503060507040706634582636454525337820302543555356464467646050401
10400000000000000000506000407000400000000000000000000000800000000000000000000060001
11111111111111111111111111111111111111111111111111111111111111111111111111111111111
