11111111111111111111111111111111111111111111111111111111111111111111111111111111111
10002000000000000000000000000000007000300070000000000000500000000000000000000000001
12706050407888206878483884423648503047505027472034805830502037502063734383206886401
10002040500000800060000000000070003000006000300020200040008000704040000000600000501
10887650204220887048727366657040402550544430404030462036625463706030273520885440201
10000000600040003000004000008000400060200000602060000070000080005000800000300000601
10477378422058605554208040604873266047208285702033664220507370568443505655405673701
10003000300080406000700060200000004030008000002000000020603000400000400060008000801
10506020503330606020584850257542305350208073463866848070405044277570766050608250601
10806050603000700060600000400030003000502000007000008000605000000000800020604000401
10605044803063652820328778208080348065827653602057603372807020668482606350807030601
10706000003000000030004000007060000030000000206070002000006060000000208000802030201
10704848675732787075803060886037743240808370805053872040358060223344702066274060501
10300000000000005000800060700030000000703000707020000050600040300000004080000030401
10386653434427803270888276705620305828508085603030644545202324805754876070374030201
10000020000000800000400040005000500000304000004000800000006000003000000080008080601
10874050802380853286804050628080826033208082237445875745644065388050642576208480601
10700030200070000020003080000050007020003000200000300000005020004030007000003000501
18706770586036865080232085778384804220453360402060404545705040605050332070886065301
10004000605030000060008000007000600020000060007030202000800030800040500050308000801
10724070603080646337205746507085785078888080848060802030236530347748302460303020801
10000060800050400000303000602000000050000060007070606080005000200000500070007040801
10634530528840603040206087404036478620738887654050703083705073508240885086837350601
10000050000050806030507000005000800070600030000050500080704000004080000020000000501
14625034625070305080708786645040302060755060624880642460603852346040623630346723201
10002070700060305030008000003040003040004060000040000030500030000040002000200020001
10706020606540802058327060702074327086207035767026222080466070503444378030202040301
10300070708000506060004060407000006000800040003000002000503000602000000050505000701
10386320805086202020508080503443583070234680606858506088504787807050673380508386621
10000000805000004020600040300070006080000030800000607080506000005030600030200000001
10233435203064863060803270405020605046672040204647708020304662686060302040585055201
10300020008070008000402000307040707000002000202000303000600050000060003050008050001
10607050386520505028563025482037707882506633863040608020637080758320303084407670551
10203000500020604000300020003000300000400000008070004050400040300070208000400040001
10802453627040807540604345404070448330504528406042773087503070465020684760232032201
10200000000030800030600060005070007000700000506000700070002040000050600000508000501
10235573765733437047833060762076403037732477602480406740403063876280804822808080501
10000000002000007080000020400060004030700000004000604000306060000000600070006040601
10373687702050608020324820508330423050806083727026822030603080357722485040506060701
10300000800020400080700000800050000070007030004020004030805060006000004000806070201
10802050364828586470808048324028732648862020703050404040705043408040758245448040401
10006030000000008050003000004000002000205080700040200020602000700030600000006050301
10762026826432408030337430506783405080404060678340708630203340684886408383704520801
10700020005000200080800030200000800070500080000000600070800020000000300000500050501
10702730305380806830266050326260636470408046743566262770483057785450328560687040501
10800040700000200050000020200060006000206020000020000000800080007070000060004000601
10758070606386377064422070408084548050205260206030486654408860604044638076404023701
10006000400000008000003020006000800030500000306030000000400000500070008000503070001
13804747203385705864603735436626207040777483644045727720506424748430506020707770271
10400000300000500000600020003050002080006000005000000060400000300030406050200030001
10576540406780206260868050604070302034704052807087233080852656408058806060464070701
10500000200020507040002000500060805050800050008000005070000000007000002080200070201
10206023846070202073704077372860805080703760203224508043258053443055658260503267601
10302040004050700070004050007000402000500020400050003080006070003070000030800000201
10408030303040686370887550802027704782303580347050346070707460407330745030687520201
10003000408020000070400000707000602000408000400070300030800050400000304050000060301
10274777755037627040805623205020707230803082234780808530507040275332608062584830501
10000000700050003050503000008040600000702000000030700000602000800000004000003000801
10556260402730606050307727862360508332204236268087525764862246403064772082403052801
10000020504000803020400000007000400000500000002000008000000000003030008000804040001
13286040207026803060585068505020774430404634706654702020658348434060706465405020541
10200080400070007020008000300060805000703000004000400060700000000040803000203050601
10805050338780682076305320788380404057387062238080232058307442584430203080702070801
10805040000020007000700040000050002000800080000040005050004000000030300050006050001
10607765368026803337325023727065252030306540328468306260363088733030405462408026461
10500000002000500020004000003020008050400000600000700080500040002000700000203000001
10725547407324304070705545706070805340288485407360268070803420604532225620274067501
10000000508000206050705000002050600000502000400050000070800000800000000030004000301
10654370302020425080704080282070876435804080807050372828805828745365837063302740501
10600040003030004050200020006040003000300060203060004000800000000000003070008000601
10806025747042707050784665568062602050348850608052445050602424266343802062486047801
10404000200070007050000060003030002080500000605000700080200000000000607000006000301
10803670308460706065407060404460468080703037207330602880206632888820408264808052301
10300050007000606000604000800020000070002070800020007080800000004080300040007020001
10325060725052203340407486208026547263847030723067682050206477808050235040643760401
10007040800040006000700000704000002000007000800050006000805000700040006060002000701
15406027403273255052733470205665207433405032602780403543655030452663407065587065701
10005000800060003020005000500000700000606000600070200000000050005000003050200020701
17345030378040407070503677524366235680304632448080374535543434706074348070308740201
10005030005000500040600080000080004000800000000080000000800000007000002000600040501
10808576347335827850807050504020408584852434244668228660306837675864523288445080501
10500000000000000000708000307000300000000000000000000000600000000000000000000050001
11111111111111111111111111111111111111111111111111111111111111111111111111111111111
