11111111111111111111111111111111111111111111111111111111111111111111111111111111111
10004000000000000000000000000000008000600020000000000000600000000000000000000000001
16608070606626706367876387336626404082807082284054303830202023208032848833508665601
10003050700000400080000000000040008000002000500080500050004000407020000000600000701
10632360508780775033286258245040307880525750503050273075245876708020428480265340601
10000000200060002000002000003000600070300000304020000050000060004000700000500000301
10372575644043405873505060702788753066702363202077633630407770427442808687504276701
10007000800020705000600020400000002040006000008000000080706000800000300070008000401
10707030402820602030855480787554405360706028328768684060305052383680235040303580301
10404040403000700030500000700060003000707000004000006000804000000000500060305000301
10507053703063366770885688606060854044486358304086404767706050425454503450608020301
10506000002000000060004000004080000070000000206060002000006020000000705000508050301
10806523757838575085205030426058755230204370402034575030476040543478804022885060201
10400000000000005000200020500050000000506000808030000050300080500000003040000030301
10744632344723605870557257308560202627604067604050748338205726404565686070446060501
10000020000000400000200080002000600000203000007000600000004000003000000030004080501
10847070408360654387706050466030335024804084444787653284762088387080553436604720801
10800070400050000080007030000050007080002000500000300000005080003060007000003000501
15304540885086744030747082435732206270534260603040808362206060507020326030884034201
10005000405040000030007000006000500080000030003040708000700050200040700050506000601
10276040403030736887303463202038426043885020467020306060284880734643202760208030301
10000030200060800000703000406000000070000050003030602050002000400000400020002030501
10352470662320502040604026506047425870373728287030804082404027707550327072277230401
10000070000040805050508000003000800080400070000040800020407000003060000020000000201
14343054784040306050403822328060607050583020437240824530808875337050547370737353601
10007030500020306070003000002030005070002020000060000080600070000080006000700070001
10802030207840306027364070706033276048807027252047284050843080207385465070506080501
10400060807000205030006070805000003000400070006000004000508000504000000040404000301
10342780408077704020806060308853234060285350402222807046404254503080572670205685771
10000000404000008060600020800030002060000030200000508080707000006050300040400000001
10232635404027372030207820404050407058732050802386305040204565372020508080286087401
10600030005080005000308000706030205000006000206000805000500070000020006030006060001
10405060882750402082334067552033305648605753778030205030674070866580802072202430661
10306000500050503000300080005000400000400000004040003060300080300060404000400080001
10605537837070603370802668708030582270408776504036267084303070735030765250334082201
10700000000030200080400080005030006000300000402000600060005050000050500000407000301
10738646462763366065536050524054704048455737802330604660607074665250403327804030501
10000000004000007060000080400020003060400000008000507000504050000000600030006040201
10448386602080306040546880707370258040406052333048463060306070273538763040202070801
10500000400030200020500000400050000040008050002050004040707050003000003000506080801
10302070355388372470603063825036825776365060802080303080303076305030462368328060701
10007030000000007080007000002000004000208080600060400060504000500020700000002060601
10847067332635606080253360305367508030802080547370207650703380485622404473708380801
10200060002000500080800030200000700020800050000000700030700060000000600000200070701
10307580203780507570348080653420733760808027427265333450248084567830873880323050201
10300040600000300070000030600020007000307060000040000000700050004070000070006000601
10563080202486883075547030407086643030204680403080363678604450405085358062508036601
10002000400000003000002070007000700070200000504020000000400000500060003000405080001
12804353504535204357503756552323707080487484843067682360804543427320608060302420561
10400000400000200000500030003020008030002000006000000070400000700030408060400050001
10754580408560806870444040506070508066303053505032242070262777207023202060822060801
10400000300050605070004000800020307030600040002000006040000000007000002020500030801
10608073544020202077208064684460807060602420508355603047625042288045735530506543601
10205050008070700020007040005000406000500030200050002070004080006080000030500000701
10407040803020638870367220806087207824706750487060222030205580307270228070884470201
10003000608020000030700000208000802000806000400050800070200070500000604080000080501
10826725682052265040704667804050707740505045422230406620302040363482208056888720301
10000000800080007040606000008070700000508000000060800000707000200000004000006000601
10352440502880803030605585832830303765404676787057446376784855507063587084806032601
10000070708000702070400000003000400000400000002000002000000000003030008000203080001
16422040803053205050775044505040322660704367206844706030868738466040605555606040261
10700030800060003080003000800070408000207000003000700030300000000030308000602030601
10702030784270345032402760747520404046642045765020878063208736344760305060806050601
10403040000080007000700020000050006000200060000080003030002000000040200070004060001
10507765425068403878345064336022225070506380868485807880433054652020605776308037641
10500000006000500030003000008080007050300000700000300050300060007000800000408000001
10366774804385706070604567302030507680244372403550543080305460607533874850288068601
10000000206000206030505000008020400000604000600020000050300000700000000060003000501
10874360404040555030306040633020627862705060707020383832402344385546583085703680401
10700030006020005060800040002080002000700050707050008000200000000000003080005000501
10507087862076704030348327765032203070454230307084536030302782333245306075337034701
10404000300050002040000020003040003020400000304000700060500000000000805000002000701
10203530208380305064808050805340252050404082705350308450606578246760808252406052301
10800060002000507000506000300060000080004040500050008050400000005070500020004080001
10752060676065803660305288503055632878585040854068273060603683806080237080755380701
10008080800050007000200000605000002000007000200070007000205000300080006040008000201
17603073505375783025834420603548206337607082507530406833787020428454702068432022501
10003000600060007040005000300000300000407000600070800000000050004000004060200080601
12353050645050605060705744865472254240308463488060626588444523303048253050503750301
10006040007000200020600040000080005000400000000040000000300000003000002000600080401
10407784732825866860702060206070408644474536866867437340607483848874624447733070501
10400000000000000000308000304000300000000000000000000000400000000000000000000040001
11111111111111111111111111111111111111111111111111111111111111111111111111111111111
