11111111111111111111111111111111111111111111111111111111111111111111111111111111111
10000000000000700000000000000020000000002000000000000000400000000000000000000000001
13203737362630884440506726334082707032707880508046308530343060505536655626642553601
10008000000080000020700000007000605000800000808000303000600050603000000000000070001
10607723264040887030646382807330203780472223254380406064508650747080572232682080451
10806000800040605000800000400020307000800060002040702000005050002040000060008040001
10302060602030407644706030438020802053402023502080505534287070607062687660307080201
10300030005060004000008020602070006000002000405000400000700080600070000000600060501
10537024766570374070846060406045538740453480603844243230205527555580728625326080501
10003030000060300060004020006000000020000020208000000050500000000000800000005080501
10408340704074305085807087327483338080442060203020823040577828463823607785305560801
10800070603000008000504000000030000080007060005070003040004000500000607000600070401
10255080506642445230803735453440303587606042833064803057605030706580306060555026501
10004000208000000050300000005000600070008050000020203070008020005000305060006000001
13405888403040507047775272787066236060704020505470708040837020658084746060202863801
10008000300040508000005070007040600020407000600020006060008060006000004070800000501
10446230602460874044705030204040407830303326224356836020403020504733507020362460881
10000000500020004000800060400070008000800000000050000020606060800000500080000040001
10526482404044703438787570727830273020326233357020686227504085243230733735766550701
10000000403000500000002000400040300070800070300040000070003000500000800000000050301
10648750528470244376605023673060208446308080408676865070383870502838505536756022501
10000080700080600000007000000020300000008060005000007060000000608000502000600040001
13426740802020402085454625607347204570888047574058368040727635344020806060508570501
10000000807050605000000000202000300070006000004000006080000040006060008070800020301
10767662207050805783502270487040726088555580508464707023535060302063786050373050831
10400060003000400000300080400020005000000070600000202050000020802000000060800050001
14703030402564344460823820808738403033376078208230508076776860405887326645608048801
10008030605000000050000070308000007000004000605000703000000000300040002000008060001
10656060536026375067667053804030867753302750406068408663404238448050402030623030231
10007000600080008040008000808080000050007070607000507000400070008000300080003060001
10607276304060207070788850572055626040286050333540408060634062303066323385306038401
10800040008030700020000070004040000050700070000020006050200070007000000050004040301
10537080643020422758848070406060784460408626242086883420407470203622257080524020401
10808000200070000000000050703040500040007040006000000040300000405000000020008000301
10603587203067835845538320507020803028432050306065465060755664474084876740605853801
10700080403000000000000080300060008000003000202070005020005000000030000080600000601
10302050403053234632753040405068268840607773608020403028806367847730475080775330501
10503070006000003000008080804040000060500030008000303000800000000080400080000060501
10777040274324304087208020502040554057428080775844408560306654624060602022562040601
10000020005000405000800020705000700030000060000000503000800030000020403000002060201
10322767302076808080646730605482285620603225835450302023238520508257606858248020601
10700000807000002080003000500020000000500080000000802050000000504000004000800040501
10407740704772258576638068324070675253735750386328806060505382608065724070703460801
10002000208000200020006070005080800000000070002040005000700060602000008050600040401
10752058806040504080805060465030702046787044208060302230756040704545403076635020601
10007000300030505000400080008050003070004000004000800080703000607000302000008040401
10206650654470504632332558705027422670705778568823248080204040406040406744406030801
10400030400000800000400020008080000050400000500070002030702060304080800000300040701
10737050703837774440603020742020334020304370806080404050508072805070864620845080201
10005020403000700050303070000030002000605000607050600080707000808020000030006030601
14668070303060804070304053683542708055808023202050546880808370702033782047502030801
10006080307080008020502000700000404000205000505080800080008000604000802000404040401
10304070404080462850302240205480802340708820863050625034572722203880506040402720801
10200060202060004000205000204000608040502080008070005000000000400040405060500020501
10353320207065307048403085302033403020505030507027505455228260806060402040834030501
10800060306040006040003000005000002000203080300050200000000000406070707020002000501
10207030304047272060806555705656386573504080285670504478584726808060703045608536801
10802000502000007080700000200020005000004060000000300000008000005060603000200000401
10604577608237605050503720234030305077534088324460704882837025255030603538428030501
10805000807040003030506000300060505070006000200070306000007080600070400000006020401
10706720304050388020704067508270208050607820304060524068203060502620306842604060801
10807000700080000070203060007000302000600000604080800020008070300000400000204080801
10306066628775463450605037638070702422765722408082604830603080225836524370308430201
10400030006000000000205000000050800000000000504000007000702050000000004000800000501
10425280707060758676205486774454368382745750873727747050805046386766804045482733401
10000000600060200000300000800000300030000040000000003060503000000000703070005000201
10742457535480404340202280205430308020385054323250503040404835548280608056408050501
10000000000080806000500040003000203060200070000030600040600000008040004000008050001
10856470258320304064884038447080536050807330626036637520805323207070883234582086281
10000060005000405000008000600030400080700000600070000000600000804060000040000070001
10838032606025308224806658508546502750786750506250237826668280302083664050878830801
10007000406000207000200000300000406000700070705000700020000020200070000050000050301
16204740705650207060735870622330505060608065405048675050267680642460408722872053501
10007000300060604060000060000080502030604000602000006060700030002000200000002000001
10805035385050607087303075882040407075203460807077403060707037404052286680804585501
10202060007030008000306000006060008000800020007000206070306060008050000020200000801
10247066304063583520604737348024266370453052587880806080706080678020835084887040451
10008000507050000000705040000040008000300060006040204060803070800030800080007080001
18704560706020805368403050375660402020807474504030806030603080778830608520406023301
10008000603070300000400080000000807050800000005000800040006020005020700000508080001
10582077807040608550725884638638602040247735566638288685225085506080504785707550701
10007000004000500030000000000000600040000000000000000000004000005000400000800000701
11111111111111111111111111111111111111111111111111111111111111111111111111111111111
