11111111111111111111111111111111111111111111111111111111111111111111111111111111111
10007000000000000000000000000000007000400050000000000000500000000000000000000000001
17404050806333203767624685843575306066702053738043702680308087506077833223306422201
10002030700000400030000000000040002000005000700050400030003000806060000000600000201
10524520303740363044247865384060705240475640605040427053833855606030766630455250401
10000000500070006000005000006000300020300000405070000030000080006000300000700000501
10262773652046605656505070806787642035204424703087335470405650428568405326207773301
10003000300070303000500030200000007030008000008000000060308000300000700050003000501
10403060704270407050225330378374502360402028573623333050204023354670368040807560801
10807040205000700030300000800070004000704000006000004000607000000000300030603000601
10202064303076223780738742302070884065627384407057204867402030753623402840803080601
10508000008000000070004000002040000080000000706050008000007080000000306000603030501
10307655354464884036804080356063458750704570806087434040732060577435508046623080401
10800000000000003000500070700020000000704000603020000040300050700000004030000080301
10747643328276404520635843705450705884502084305060663886208322804633454030682050301
10000030000000200000600020004000300000204000003000300000003000007000000020008040701
10264030204530233457406040632070538037803038772786276386475085378080326852405750201
10500080500030000040005080000030004050007000800000700000002080007080003000006000201
12408680826034687080875067442787605680843850306050405756602080807070458080463048301
10006000707030000020004000007000800060000030005030507000800050600070300020806000401
10426080706060376457406574207033388026337070487060808080768350888576808780402030401
10000080700060200000406000805000000050000070005050804050007000200000600020007080401
10262520523460208040204058503024225270533837436030403058305072504770523044734650401
10000060000020708060507000005000200020500040000020300070708000008060000060000000701
15456085226070305030505345773040306020438040846350268420203463364040853540567538701
10004040800060604070005000003030007020004060000040000020700030000020002000300030001
10505080407240408033752060304043822062403025733068772040356030705446746030205030701
10600030307000706050002020307000008000200030004000005000407000204000000040505000701
10673720402043304070708060208282664060863470603537405038608773302030677430604333381
10000000605000006030400040300030003070000020800000305040503000005020800080300000001
10422557403057754050507340702050602046686070502555306020308756558020304020778045401
10200080003040004000807000803080605000007000308000403000200050000070005080007020001
10306020775670703034788022488085502488708285635070504060578050378360707086207630631
10303000400080402000400040007000600000300000007040008030500080500080204000200040001
10702437266060702860502886307070423230205365602025684033306050456060647240426025201
10200000000080800020500070008050004000800000307000300040005070000040800000506000201
10837582448356438068443070527058602034888487603270302730405078276770603344403030301
10000000007000003080000020400050005060600000005000804000402080000000400070005060401
10624457805020705020345770704540245020807056267055475030206080746468574060302050601
10200000200030700030400000600050000030008050007020004050503040006000008000503030301
10407080438344427780508046574035482485464070504030807060207078805070353436733070201
10002050000000005080004000004000003000703020500040800030708000500060400000007050201
10244024653446602020552640402664204050802070444320204350606850365547707273608580601
10400080005000500060300030700000400030800040000000400070700060000000700000600020301
10506360305240204670778060265460225430607086674323335670725067355220224330753060401
10300020500000500040000070500050007000405040000050000000600040005040000070002000201
10274050504836667075287040205038647080408280306060247754706870405064465075502062701
10002000600000007000006050002000200030800000608040000000800000200080003000405050001
12808387203882202228304322346532207040883472445064383660204772542750605040205580551
10200000400000200000800040006030007040007000002000000020600000500020304060700060001
10867260804760602830357030805070702045402086807072437070872672608083407050883040301
10200000600050605070008000600070703020700050004000003030000000002000006070700050801
10802085474040605054507042752650604070807420704537204037422077326043432550806773301
10705050002060600040008080005000605000600040800040002070003040007070000030200000801
10806080808080738680623460302074802458802520634030678040207430802220836050642320801
10002000202050000020700000208000602000803000800080400070700050700000708040000030401
10374778868032244080506585406040206580404048243240604260804020226475407066446250301
10000000700060004020404000007030600000808000000070500000208000300000003000004000201
10636660804440402050605738363740807282804372528087742435622757603057388078503082301
10000070506000304070400000004000500000400000003000002000000000008080007000603070001
14637070504053406050674085605050588470408334402448402020448752876080804372703040771
10700060800050006030004000700060203000407000004000200070300000000040505000508060501
10308080562230544028405630623650307037578033244040484025303546285580303050408070301
10705040000080004000500040000030006000800070000030003040008000000060300050002070001
10206276564062705567836073886035778030806760873242404540483053682050205552503055341
10300000005000300080004000007030005060700000500000800050500070003000200000204000001
10587886407388504070702672305040702420548458403830225050502630704245887420422046501
10000000206000604080508000006030400000603000500040000020800000700000000070003000501
10857780204080384070604060738050677683508060708050448884307537522247445076806440201
10800020003070008020400020002060002000700050505020005000300000000000003080002000501
10806037337037402020387535776074603080824250302038244080505384552722706056763027501
10202000500020003070000030002080008050600000507000500020800000000000704000006000801
10207350604350308078303020507420573070408043202240302780203437348360802376802087501
10300060003000402000306000600020000030005070600070007020800000008030300040005050001
10374030844042608220304445402063632487227020338067465040303744302040546070647420401
10002020700070002000400000808000002000005000600070006000505000800050007040005000501
14308052804857525087883770208424802486606072303650406647563080533578602037784057701
10003000800040002060007000500000500000607000300060400000000040002000002030300060301
15524040245020805050504642332548772340502346228040568338875822705046445040505560301
10008020006000800060500020000030008000400000000020000000400000002000005000700070301
10604464472383225530707040706030804466476422337747574630205588847836555777374050601
10200000000000000000604000605000700000000000000000000000600000000000000000000080001
11111111111111111111111111111111111111111111111111111111111111111111111111111111111
