11111111111111111111111111111111111111111111111111111111111111111111111111111111111
10002000000000000000000000000000003000500040000000000000300000000000000000000000001
17802080208437605587775267288782807067306065256037506480207078707045356287607453301
10005060300000200020000000000070007000008000300060600060008000408070000000500000301
10563770404230466077226385455040704370352620306060684036623882703050467380864760801
10000000400060007000002000003000800080700000206030000020000030002000300000600000201
10646348438044303778802020405582467062408234807052847780408670784662408624205387601
10008000500060307000500030500000006040006000003000000020607000700000500080008000501
10305070707560202070676450643648405270808084628337855020205044474530473060803340301
10705080304000400070500000800050004000703000003000002000508000000000200040805000801
10608064303068872430676344308030647086784643304032207537604050656588505270806030401
10802000007000000060007000007040000030000000805030007000006040000000204000606030801
10604225483646438023205070387022477560802260603072724080385080545832303068235020301
10200000000000003000700080300070000000306000705070000060600060200000007080000020501
10786888867286503870453355803280808372708045403070726277407874405478377060544070601
10000020000000700000500040008000400000204000004000600000004000008000000030007020601
10727050305240323666808060724040832076503062662333887342248028265050348775204580501
10200050600070000080008040000080008040004000200000200000004030005050007000003000601
18702460666057436040752038287456607840257260204050705246505020207080626080653073501
10002000504050000040006000003000500040000080004050803000500030700020700040408000501
10883040206030325484802468203078464088472070278020204020364320374735605460302030601
10000030400030600000708000803000000050000050002050808020005000500000300080002020301
10454240364240705020808058706027685250788364826070603058607025708770634085458880401
10000020000030708080704000007000800020700070000040500040408000005040000040000000601
16676022824070405020808268227070606020853020578780283360704465673050374250835633601
10008030400020605030002000005040004020002060000040000040500070000050008000200050001
10708020307750203058352060203074286083506058544028588030387020504344564030208070701
10400030406000806020008080304000007000800060005000003000804000703000000030806000701
10575220606067703060606070806525665030677430202362507085607684806060744560706354861
10000000506000006020500070300030004070000050300000603080804000005060700060200000001
10278756506023264030503660506020703088644040402332307080307646645020606070524037301
10200080008030002000508000404060703000002000703000706000200070000040006040004020001
10605020765860202067325024457072605347305434744050607060728040436580508046507880261
10308000600040707000800070006000400000200000005060003060300060200060202000700040001
10403583658020803680606784406070455420207683306035383088403060552020626550884065801
10600000000030200060300070008030003000200000807000500040002030000020300000406000801
10827825658467333043842070885067603026283858707240507470706042233840608747208020501
10000000007000002040000020400070008060400000005000504000407080000000700070006080301
10835837308060703020676580602370473030203047472036577040805060252247468030705030201
10400000800060300070300000300050000080002030007030006050803060005000006000507040601
10502070732336428250207037865088785276385050308070404020606034302060462665444060301
10002060000000004060003000003000002000804050700040400030705000700080400000005080701
10358035556646208020778870404686806080608030786350507470606770782252402256407560201
10300070004000500030300070300000600060500070000000400060800020000000600000200030501
10803220807580204680557030462420734550406077563222878680662043845350847740844060601
10600040200000200070000060800080006000702040000020000000700020007070000070008000301
10544020706526524052287060505027547070504870204060423882806770202085738058207024301
10005000800000002000008060002000200040500000406050000000600000200050007000605020001
17703883607367502637605438726654306030444643786037386820704842824760205080508460421
10200000300000600000800050006080008030008000007000000020400000800030702020700030001
10252320408480402580862030603030807036505088603058647060878727505025406050262050301
10700000300070803060006000700020806050500040006000007020000000006000002060200040501
10507056333030407034208063883570805030308550203878603072738084774042566240403385501
10508070006030800080002040002000207000300050700060006070004040005060000060600000301
10204040704070564770788250603063504274307350673080845040605850406380538050334540301
10008000807030000040500000304000303000204000700050500050800070500000603020000060501
10788838244076672060804784608020505250202076562480705420505080427436505044375540501
10000000600070007060803000003060300000702000000080200000502000500000004000006000701
10266380803640405070604346733680705877506367663054664685777685402063463024606073501
10000020703000404080500000003000400000500000002000008000000000008050003000807070001
13628070707048707080342056506030256480604262607886306060575687436020202362202020641
10700020700020003030004000700060706000707000007000700030300000000060806000402080601
10502030385360663053203720838550304058237038644050783045805245342580706060204030301
10608080000030005000400060000020006000800060000040007040007000000080300050007030001
10207635458082304836385022344064364040308480672427505820426084238080604483207068371
10500000004000400060007000007070007070300000200000600030800020007000800000408000001
10375522208353603030807237202030605780282525402380748020805230404232577680363036201
10000000203000202070308000002040800000603000300020000030700000400000000050005000201
10567670407060473060207020624080668842307040607050675387808473473876857084208580601
10300080004030003060200030008040008000500030608040004000800000000000004030002000401
10604074477038302070437455533043808020447470708077834060305785743848502085523063701
10506000300060003020000020002020002070300000705000800020400000000000703000004000801
10603630505280303048807060505720284040604055704250706580802232572480306337408023201
10500060007000506000306000800060000050008040700020004050200000004020300040008050001
10838070262047806480203865608047875472248050824057454060706733804070648050566220401
10006040500040008000400000808000006000005000300080007000206000200040002080004000801
17505022206346272053548440606585403647604047406570504473824020546522605075553034301
10002000600060005060003000800000700000503000700050200000000040003000007030600050501
12524070275030206080205252565726586840504223755070342264737725302074326060706540501
10006070006000600030200020000080007000800000000040000000300000004000004000800080201
10508324657654863730805040506060808338843453885775652530703378784454853653385060201
10400000000000000000208000604000200000000000000000000000800000000000000000000020001
11111111111111111111111111111111111111111111111111111111111111111111111111111111111
