11111111111111111111111111111111111111111111111111111111111111111111111111111111111
10006000000000000000000000000000006000200040000000000000300000000000000000000000001
13806080805786503872424453456635403053406072632052802730303038202085284724806228501
10006020700000500050000000000020005000005000300030800060002000807060000000200000601
10536880708880723032773546334060805450266350306030324063425348603040365850353550401
10000000700080007000008000004000300060800000705020000070000030006000300000500000401
10372222722075605343703040807463838066308787405022246720603520436766702582208367201
10005000700080408000700080600000003030005000002000000020403000300000700020007000301
10202040603640204060882350844643303240706082766576374020702073358250454030704830401
10702080708000400060400000200050008000708000006000007000206000000000500070504000501
10702044703068675260273544306070443074626644806078208425404050287472707830703020301
10408000005000000040007000008040000020000000504020002000006070000000304000706080501
10304846852365273085608020467085877440503730702052553020667080486554403086372040301
10600000000000004000600030700030000000608000804030000080200070200000004060000050501
10334868275274206780677855303880704237302037405060734546605766205237576070654030701
10000050000000800000400070006000200000804000004000200000004000002000000080007050701
10726080802840584323404030547040537024803067252227234358272025585020858585807820201
10500070300040000060002060000020005040005000300000200000003080004070007000007000701
13603730365042828060822028733667204380422550208030605328706080405070252030287036201
10003000506050000060008000003000600030000020002040208000200080200020400070308000301
10687030507040455685304827606076748028662040488070705080223760538227806350502060401
10000050400050300000207000605000000080000080006030703040007000300000300060002070301
10678280378880208030308067308053554630788553346080802047402043704540653042552680501
10000060000080802070502000006000500040800050000040600070807000007050000050000000301
18475055285030308070607877287050607070253070357680526640503738534080463320377525401
10002060600020502040003000006030006050008050000030000070400040000020004000300050001
10604070608350505048543020403035388075402088523074363030742070505258225050702070401
10200050307000305070004080804000007000600030004000007000607000707000000060303000201
10287850306038804040206050406638623020746260806644305056502667403020478660607767541
10000000504000004020800040200050008040000020800000307030304000003030500080600000001
10822268504082432030604530702030807045733080302325304070807352228040508050786063301
10200040005040004000203000503070308000006000405000202000800050000060007020004040001
10802020552560207068874024833073803386602672258080307060582030775880203038204220771
10408000400040204000800060007000200000500000004060007070500030800030303000300080001
10202732462060806320605848602050655720403454502043478088606080838020274820254083401
10500000000050800070700070008080008000300000208000800070002040000070500000708000701
10348583672787478065272070722035408086835872603220807230406034757350502373304070301
10000000004000007030000040800040005080300000005000707000506020000000200020006070801
10758354507020702060728530703660556040804056288034752070305050565632348080708040201
10700000200060600070600000400050000020003080005040007020207040002000004000705020701
10208020638382385770207037864028834422454080706040804040408068705040877747476020501
10004050000000006030007000006000008000208040200030600050404000400020200000002020201
10554048458377407020475330608373505070403050383350605680204320836554607284308840201
10400070004000800070200020600000800080500030000000800050700020000000200000700070201
10708740508220206370456070825240537740706023885455534860732075325850253540843050501
10700020200000500040000040500050007000503080000040000000800030006050000040007000601
10844070808552676074274040807024457070208680606020523672306230408064345084805036301
10006000200000006000004040008000500080400000308030000000700000300040006000704020001
18304378805724608436503464443256506050473673543034368820705428425280206060402470421
10500000700000800000300060008070007080003000006000000020300000300080807050800040001
10482820805880503280622070305050702034203028708075258030637723308047208050624040501
10300000200050407030006000800040305040300040002000008040000000006000008040800070701
10303032862080708033807032338650804020407550804773602046777087734045236570604222501
10405080003050400020002070007000304000200020600030008080006070004070000030700000801
10604030406080365330266570404065304745505250587070353030208660602260343020478620401
10002000508040000080400000207000408000708000700070500040400080600000506050000020401
10555482238048677050702654602060506870808033824780203740602050753457202072637850701
10000000700030005050608000006030400000304000000060800000503000400000003000007000201
10488360808440805080308437845460303344402862562088888583864754204067222072502028601
10000070507000807060200000004000300000700000003000004000000000006030003000405050001
18884030303033404030365047402040648650506787302232703040867628747030703286503040561
10600080300060002040006000200050505000503000007000400050500000000020506000302060501
10207030222350334078802350842240706085535057547070888048205744475580703070204080501
10707020000060006000800050000050007000300050000050008080007000000080800070005040001
10307766585033407224724027627085885020702580247652705270874038467080304337508088861
10200000006000800050006000007020002040200000600000500020800060005000200000404000001
10635636806523405020806773804080507240527673503220324080402720203535655840668072301
10000000608000802060803000002070300000802000400030000040800000800000000030008000401
10628380308050437030305070736060646882204070608020234376508368453662354024706880601
10300080007080005080500050007040008000700070308070004000600000000000004050004000501
10605043866067602020276352565065505080455660706023324050406758466856307065345085601
10403000400060005020000020008040003040500000208000300080300000000000303000008000301
10506480203740807085602060205870777040803058706540403850202423732430407528704054401
10400070005000603000506000300060000030006050800050007050300000002040500050003030001
10383070252023206220405747708033248252333040672057623040602532704050228060275720401
10004050300070007000500000807000004000006000300020007000603000200060006060007000201
14502052704464256066723340807466603623202032207460404328535060232456606064638065701
10006000400020005040004000200000500000308000300070800000000030005000003070300080601
15576030534070302070804837264572335850304556638060734864237384208023388040405570701
10007070008000300060200060000040006000700000000020000000300000004000004000800080801
10303242635774244470406060402080705535447426583673672660305725546325838373875080701
10400000000000000000202000703000400000000000000000000000200000000000000000000040001
11111111111111111111111111111111111111111111111111111111111111111111111111111111111
