11111111111111111111111111111111111111111111111111111111111111111111111111111111111
10002000000000000000000000000000003000400020000000000000500000000000000000000000001
13406060603875408577477273464446707077605087477083408550708033203085677367304328301
10004020800000300080000000000060003000005000600060500050003000808050000000400000801
10562520408360648088265648873020807650436350308020357074542678305030854470472320801
10000000700040007000007000008000600050600000604080000080000060008000800000700000701
10577827577025404372404060806845477044704574508084552760808280822788506358607762601
10005000800050203000200080800000002040008000008000000050508000400000700080004000401
10308060708650807060482350868444303620607036735446457060806053886750447040205260201
10207030704000700070200000300050006000805000003000003000208000000000200020207000201
10206024706084785630758843703070242033736238406046307783507070332736408870804080501
10808000004000000050003000005030000030000000508030007000002050000000508000703080301
10707832464543523026606080772076643350507450805064634020887020886554206038365070301
10300000000000003000500030400080000000505000602070000020600030400000003020000040501
10437345626432508270652862304830804882202027808050257557603578208373768080227030301
10000040000000300000200080005000200000205000003000400000006000003000000040004070601
10562070804270335526206020743030644026705025437436753422557055262040824227308730201
10300080400060000080005020000020008050008000600000600000007060003020006000006000201
17304360435076475030627056264227407470376560504040805254607070508050852060887032801
10006000208080000050008000002000800060000030007040403000500030400040600040406000401
10686050605020472686203643508055268065868020566070508030624530835424406840704070501
10000030600030300000805000208000000080000060004060506070006000300000200070004030501
10563750784260807080507026204083334270472636663070708028402087206450254082353630201
10000040000080407020502000002000400020700020000070700070406000007020000080000000701
16782022566070405060805623354080706080584040546230558870406828644040364580738534501
10002040300060605040002000002040003020007020000040000040700040000050008000700040001
10304050705820606083464020603058427087205022538077587080337070507243247030602040801
10700040207000502020002050406000002000700050004000008000206000806000000060606000201
10767450803067703080502020608448826050866250703575207074206556804070774340502262561
10000000204000006060700070200050007020000030400000202080606000005030200050200000001
10886532803043482070802440406060705028462030606868204040307548332030807080742025201
10800030008020006000702000508050706000004000303000207000600030000050004060007080001
10304050555830202083478024683066302363202523665040404020753040826580206058504230551
10503000500060505000500070008000800000600000003060002050700050700050802000700070001
10207546427030303660205622703070357260504453602065728076403020843070338820636067301
10400000000050300080200070004040004000700000306000500080007050000030700000202000701
10536755257544457048567030884074508084555544705520404220403037743530608278308050401
10000000004000002040000070500060007030600000004000606000604060000000200050006020401
10228858602070607020465770406320622060805064674026378060602030283768284040607080601
10500000300020300050800000500060000040002040003020002050407030003000004000404030801
10706060576424683240506035285082226488426070304030804030202052302040555666256080301
10005080000000006020007000007000003000705080300050300030404000500050300000008020501
10267028666588303020437760506745405050502020675280404560606260258778307668404580401
10600080003000200080500030200000400060600050000000400050600060000000600000400070501
10402670805580803650227070532430222250206026354267358450342078624440423780228060401
10300080500000700080000060300080004000202040000070000000200080005050000050008000201
10576050303855645043827060703062638080602880804050572758202240407072677065707076701
10006000200000003000004080003000500020500000706020000000500000300030002000402050001
18604872604853208472607784567524407030263557352072457580306724882240203080708880381
10400000400000300000300080008040002030003000003000000070300000400020808020600020001
10245450607420304360657040802050402053403038703043274020673248306064607050387070201
10700000400070402070004000700050805040800080007000006030000000006000003070300060401
10804022642040304068402068655640803070703240407225803052567046333076284720403355601
10402020006040400030004070006000706000300040400040006030007080005050000040500000201
10304050305070452870746370807067807627207550876060872040804580804240444060836360701
10006000205030000060400000204000604000204000400020400060400040800000207040000050501
10585722887022437060702533204070806370806066274330504870508050243246507042453860201
10000000700080008070305000002070800000605000000040700000705000800000006000008000601
10754660607560507070806622253230406687703762455087783333823627405025734023406065401
10000080402000604050700000002000400000800000002000003000000000004020004000705040001
15758070505083307080647033402020768670208335503445306080465277323080806766307060421
10300050700030007040003000700020202000305000008000600030300000000060202000707030801
10403080273260473057408880275680705078578063268070453037804687262370708060707030601
10503080000080005000200080000030002000400020000070007070005000000020800040004040001
10504678643062504747557053762076267050604840354857504280846024557040507333306022481
10800000003000800070007000008060004060200000600000600020700070006000600000308000001
10737483204635704060204844703020207650528346706530246050807850207726855720675044501
10000000708000202080708000007060400000308000800020000070200000500000000080007000301
10454380405060476030605060726030556474305060204080426363707236752424457073402470701
10700020008030005040600030008060004000200070608060006000700000000000007050007000301
10808045476047408060275354846045707050472430508035834040503423387533805078262033801
10806000700040005040000030003070004030800000302000400040800000000000704000008000501
10505420806280406077202050405640482070805054508460606440205552562870206886708032201
10300050006000807000406000400060000040005040300080002020800000004070200020006040001
10723060622055307330708764803044573723663040755034863080507244405040254070422350301
10006020200050002000700000703000005000005000600080004000303000700060003080008000401
16703076304678368058462340305575703824602077608250407266378060348587307066676084201
10003000500030005020003000500000300000802000500020200000000060003000005030400050201
18282040248050703040605278284635787220802634554030433664376678704068685040207780701
10008030002000200050800080000070004000300000000040000000600000008000004000700070801
10508476338823688830707030704040206555357662348582536530605785233454535665673030601
10300000000000000000703000705000500000000000000000000000300000000000000000000040001
11111111111111111111111111111111111111111111111111111111111111111111111111111111111
