11111111111111111111111111111111111111111111111111111111111111111111111111111111111
10008000000000000000000000000000005000400050000000000000400000000000000000000000001
15706060608452402575277645853787704073203027624076307730605082304056235645507664601
10003050200000400060000000000070006000007000700020400060003000403080000000800000601
10678350708570842058574753468060603670784850608060473057567676705030522670673420401
10000000500080007000006000005000600080800000605020000020000070008000600000600000201
10785372535066604286407050703473363023302863806074257620606540232775706682404523501
10007000400080508000600070200000004050002000005000000060207000300000600020005000401
10602060307270308040242430448264202260308048555852228020602083555530823080707420701
10505060302000300030500000400030008000405000008000005000707000000000500040305000401
10807046807082368620338366203080854028328752505066302723404050733453403630508060801
10508000005000000080004000003060000050000000504070008000003050000000804000408060601
10308473653344337026605030734027786440707580205047758070822020348563207024626070601
10600000000000003000500020700040000000808000503060000030800070700000004080000050201
10473688724364406430773784308850202268808087307050633542502644606275768030435070701
10000020000000600000300060002000600000208000008000200000006000004000000020004020701
10858050307640662523202060553070365083407058734466753876663052466030353772702480201
10300050300030000080004050000050006080002000500000800000002050006060006000007000401
17706680383027232070476043342252505530662240606070408247404040508050553040846086201
10006000307030000040007000004000500020000030002070803000800060300060800050804000501
10454050803060253826504247705055376037444060433040207030528750624323705250504050801
10000050200060300000604000402000000060000020003020606050008000600000500030006020701
10664330445370407060707056805023887570543657487060404087607082704320566057867560401
10000060000040702050402000004000400070200060000060800060707000003030000070000000201
13373023744070707020305748782050303030434030336530774550307827763020776340276543401
10004080200070404070004000007080008080004080000040000050200020000080008000400030001
10208060808620503058358040605083773067507022357064657050532030304584365030505030801
10500040508000308060004040207000005000200080003000003000808000408000000070504000601
10572880307067703020302020408288844050657770703766502083704457302070358770507422831
10000000606000003020700070300070002020000080700000406050802000008080400050600000001
10724743202034758020805370708050703032478040604757703080708534547050307030645074601
10600040003060002000808000704080202000005000506000208000400060000060008040007030001
10408070557330406086342057833024205343605872377080803020838020548450305074806620471
10708000400030407000800030007000800000300000002040003080800030800030704000200030001
10704557232060702820407864407040476620408282507062322077703020386020378470346026701
10600000000040400080200080007020008000800000303000300020002070000030700000708000801
10474323323754438034734030262032803056448483405570708640706048825830708346203030201
10000000006000002080000020700040006020700000002000604000205040000000300030003070601
10883845505060807020336280406730445030304057564074884070602050455653645060408030701
10300000200020400040700000800030000040004030002030004080307080007000002000804070401
10606020778347828260803062722037776834732060602030805050704054704060432567543050501
10005070000000007060004000008000003000804040400040700080302000700040800000005070501
10876087568458708070657860205387203070404020684820205880603620557657706334404440601
10700030006000500070600020300000200070300050000000200070700080000000300000300020801
10302830202250407720688040747280843470808083635667623530658036825880864260744050801
10700030200000600040000020800060006000505020000070000000500030003040000040006000201
10266050503655488043844060308044752030308830706070773857803250302054535078404066301
10008000600000006000004050003000800040500000205060000000200000800080003000307060001
13804332808527608825208238483645806020877676282037757220807747277240407020403620581
10800000600000700000800030004030004030003000003000000060700000700060706020800080001
10745780705470708680836040508070605067304072308057876080653782506088205040564040301
10400000500050406020003000700040207060200030004000008080000000005000005020700070401
10502046544020407025507088626340707020203620305678803062443032864085682260507848401
10408080005040700040007040004000705000700040800020008080008050004040000060600000801
10508050208040763750383660804042406274302250582030452050608670506250775060588620701
10008000808050000050500000503000507000802000300080400080800080200000305040000050501
10738233237022866020204853703080403730708065245760405260204030624467402055488620201
10000000300020007040305000007040400000205000000050500000206000200000002000006000601
10828860705270703050706474535430505578605282622078834743384577704047366054405037401
10000050703000204050400000004000800000300000007000007000000000006040002000607050001
17222030305075306070875062306030654830407422507363406050553847634070707738402020781
10200040200040002070007000400030807000203000007000200070400000000070607000806040201
10804080772350248063505550828570802022533028553020688023308563666470204030406080401
10702060000070002000300030000050008000600020000050004070008000000030200020008030001
10607847677084508664328056437022254080608660668442808530648088762050702527502072561
10300000006000800030003000005060007050600000800000200060300060007000700000204000001
10637646408878804060505426205080504780228543403550683020303280704548348550657056301
10000000702000708040303000004060500000205000300080000050800000600000000030002000201
10788480408030773050704040437080572237803080606080255375205574566663235038608820801
10300080002040004030500080008080004000200060303080006000200000000000008070008000601
10203055648037407080233674824067407020522570205076634050204532737753202064686085601
10204000800040008060000080006030002070700000403000800070600000000000406000006000201
10308850806350802038807080705680485060702087407670806670603247886880304235706066301
10700070008000203000507000200050000070008050700030005070200000002050600060002040001
10564030533077804840708285206022742678384070872046326060806236403030822020735780701
10002030500060008000500000406000004000008000300040002000605000700080005070008000701
13207037804672873027684250406247804422408046806560404455363030246728403047852028801
10003000200020007030004000700000200000205000800060200000000070003000004040600060701
14283030455040706030804743526478363440608453565030444252765535207028457050402540601
10008040005000200080800040000040003000400000000020000000800000005000008000600050201
10503857637866377450605080504020303878624848422723687620606225755646267835527080801
10700000000000000000504000805000500000000000000000000000600000000000000000000020001
11111111111111111111111111111111111111111111111111111111111111111111111111111111111
