11111111111111111111111111111111111111111111111111111111111111111111111111111111111
10008000000000000000000000000000006000500040000000000000300000000000000000000000001
14708060303784502556334725258566204083805082326052606520503027608034735326702538701
10003070500000700050000000000020006000008000500040300070007000404060000000800000201
10554560505630583057832385752040804550322630603030337083838455806030644350232730301
10000000500060005000004000008000200060200000807070000040000060002000400000300000701
10722446328044802782504080703426447067402685507042577520203580866248306623506257601
10003000300070205000300070700000007020005000005000000070507000400000600080002000301
10207040702340707020386820745288404420603045843642422030307028274770475040206240601
10302060208000800030600000400080004000602000008000003000304000000000700030202000801
10703088204024573220458346407080536047638577305044303877703050482676605250305050801
10806000005000000070006000003080000050000000805070002000008080000000602000605080601
10706466432835533062803080584078725580504740502025685030475030248856703075224080801
10600000000000004000800050500050000000604000206050000020300080600000006050000020501
10277453458576708650784827502530402582507065606020438273605223703267678070385080701
10000050000000700000800050005000200000208000002000800000005000004000000030002080701
10586030304360636434702030536020363042802042378464844462876042874040233837807860301
10200030800060000040005080000050002070008000200000600000004080006030002000006000601
12506270675026422030836074544648304820734480705020304587606060506080353040275023701
10004000806060000050005000006000400080000050006040807000200070600060400080304000501
10888060806060583373804548708056638076548070823060802070633640735754208230605050501
10000020300070400000707000405000000020000020008030204050007000500000700080006030401
10356450753620805070705026507066644270726563854060302047708085803760322032382220801
10000040000050207070505000004000600050200050000030600060707000008050000080000000401
16737046845060803030605777776080504070243020226770678280506745384070374320836757601
10002030400080304050003000005060007040003050000070000040800040000070004000500070001
10303080807480402052763040807078484088505043657074828030834030807832624060303040601
10300030703000708070004070308000003000700070005000004000606000602000000020208000701
10654280502067603050806060404376488020488770506436408074606754504050655350608323331
10000000607000003060500050500030006020000080800000704040602000006020200030200000001
10748337804047755030307550707070303044672060405856805040506364544030708070383064601
10700060005060007000204000805060704000002000806000205000400060000040004060006040001
10802040866230206077556036368055203446303767624040508030377070348440408026506480631
10202000500050506000600050002000600000800000003080006050500080500080302000700050001
10504577427020604260807228202050235240703382705085234062704020568080484760677074401
10700000000060600050500020003040004000600000708000500020006050000080600000303000601
10623678257233862062834030373023705088472236207770702430603055835440503472803030801
10000000007000002030000080400060008050700000003000706000703040000000600070002050401
10373777404030705080864270408470886020307073632073564060607060862452438050207070801
10200000700050200050300000400060000050003070006030008070603070006000006000303070201
10808020552635762540802055566056353687445040507030803020205067204050858338228040701
10002020000000008050002000004000006000604060300040700020507000600020600000006030601
10785066787658306070378240808833308060302020427860803740204550585375702744605470601
10400020003000300080300030500000400050600050000000200020700050000000300000800050601
10804340607880708820644020434520635560304058555753487370685047227830473840828060601
10700080600000400050000060200030006000307030000070000000600080003060000020002000801
10368070205867454033727070508062386060406680603020862263807240606025836046203024201
10002000600000007000004050008000800070600000702070000000300000400080008000308050001
13706332802826408745802262563866804050865223848046842680207677846240804020404770461
10600000700000500000500050003060008050003000006000000060500000300060805070600020001
10226830705850806440222070705070704076708084702056258020265654508022603050456050301
10200000700020704070008000400050203040400050003000002040000000008000006040700020801
10605042745040407078805083434620205030203480408525606062722025525022384570505533701
10306050006020400020006030008000507000700080400040002040005080008020000070200000501
10204080404060246850655430206037408872603640343050438050502380808250675080384560501
10004000404040000070400000403000603000807000300030200080500070400000406080000030801
10865832533078644070204332608060202860208082256640704520304060625675402042283220601
10000000400050006070408000004060300000406000000060300000402000500000005000007000801
10568640504870302060502527848340206733204774674027854744247357505045483085705056501
10000020603000408020800000006000400000700000005000002000000000006070005000806070001
12754070206042602080886032507060343380806237608227406030853636688070403655308030221
10500080400070006080008000500070306000505000003000200070600000000040506000508040601
10608040353230466022806430564220708048542027763080578044806346475770407080506040201
10405060000070002000500050000040002000400050000070003020003000000070400040005060001
10806556852025206422742043756075567030504640777827603480466042875080505234304067661
10200000007000500070008000007060002080600000800000200030600070008000400000708000001
10233447802657407060504282305070502440874837204620258080607240708687245350633026701
10000000208000305080805000007020700000602000300080000030700000300000000020002000701
10424280802070653080703060752040234522207050804080836274205375654546484088508630701
10300020008030008070200060005040004000300080407020006000400000000000006050002000601
10607034867063708020882646348047504050728480807046647020506586323883203038452043801
10203000700020007030000050003040006060200000806000500030400000000000708000008000801
10402620502430604037704030803460336060602054305840302250807753375330202387207032701
10200050006000404000604000300030000080008080700070008070600000005030300040006060001
10433020555084803270506374707063473886777080786024468070504633704080727070528750701
10002060400070008000400000306000003000004000400070005000302000600070006050008000501
14508046403676742065633360605375808332405045508350507453656070747363404075233066501
10008000700070005030003000500000600000306000600050500000000070008000004080300030301
13654030325080704050206632777262256680504837838020362527825844807043858060806740401
10007070007000500070600080000060006000600000000070000000700000005000004000200080401
10706757473535734660507040505030408725847463263346735340704427247826375822347070801
10400000000000000000306000305000500000000000000000000000300000000000000000000050001
11111111111111111111111111111111111111111111111111111111111111111111111111111111111
