11111111111111111111111111111111111111111111111111111111111111111111111111111111111
10000000000000600000000000000060000000008000000000000000300000000000000000000000001
17207262873550572860306773275025603063707650407062203460584070706563487548225726501
10004000000080000020400000006000503000500000708000502000500070407000000000000080001
10507458328080532080727873306370602760644635252830307064807570567070362483338070521
10808000400050406000700000200040402000200020007050603000008020002030000080008060001
10705060505050207242805030634040204025804028303020202822855030704058224640207040701
10300060002050005000003050502040008000008000208000800000800030500040000000800070701
10447037642370748040364080405042834840424280807562423420308278648450228253574040701
10003020000070600030003050003000000030000020402000000070300000000000300000006020801
10304540506086707044806028448676835060228070508060474020673722224256306868805760301
10400030306000005000307000000030000030008070007020005020008000800000303000200070601
10377070607758666570206634773420405854205056383073206035706070207780508070868064801
10007000706000000040600000006000200060005030000050403050004070008000604040007000001
16302454706030508028553677762054734070804060806240307040745050485087464070705332401
10006000600050407000004030003040200080502000500030005020003080003000005050700000601
10482660706220343087402070806020207380302742746755548070703030606433702080437240221
10000000800060004000600070400040004000600000000020000070507050800000300080000040001
10822256304024405338858280632560437070645543767030353664807037667870573383256850301
10000000406000200000002000500050300060700020600070000080008000700000600000000050401
10624760655750577432208073882070702562706060508728768030542840602335504562828082401
10000070500060300000002000000040800000006040008000003070000000605000508000700050001
15328860702070805072345476803858306430427058455025222070853333835050203020207560501
10000000307040803000000000708000500060003000005000003050000080002020002060500040701
10227287503040805885307680732080533026523430604363202064867070708046287020543040871
10300070004000800000500030400020003000000040500000606030000070703000000080400070001
15605080204246532760238720808273305043883034807880208068622780607486658867807045501
10003060608000000060000080306000005000007000302000204000000000400040005000005060001
10788040364068235038325085502030272867202630805058305555305265623030402080583040551
10003000400020003060005000606050000080006050302000404000800080007000500060007020001
10406344508030806070638650446034636030664070886670207080775027505038355543505036601
10800050002080300060000060006080000050400070000070002060500040007000000050003050401
10676040543070844575822060404070872620703448844086344750403650305253725040458040201
10803000400060000000000070803020500050003080003000000070400000508000000060007000201
10505473803034726222752730802070608052825050407063875030736663836067847640807856501
10400050404000000000000020600080002000007000802020007030003000000060000050300000801
10506020305076386484743060607044236330504256504050208085407376268330885050878830701
10803050006000008000004040504080000020800080007000303000700000000060700050000060201
10476060378752205024207060204030628026686020723682404670402326732020202083334080601
10000060002000302000300020603000500030000050000000407000700050000030708000003070601
10322336802088208030336360203723242740706728654630306023632440303248707874443050501
10800000602000005040003000200040000000200030000000207040000000803000008000800080301
10305860208534878827373053653080373847873350252286705020207565507034452030706840801
10008000608000800070007040002020700000000030003030004000500070706000007060800050201
10345065307070803020502030276040303037456088603080406680735030208363808057658030501
10004000800020607000600050003020006050002000007000600080302000707000802000006030701
10308230875740603725333867803082523250607567556365874070705080703050504888203040601
10700070700000600000400080005020000060500000200080008040202070702060700000700070601
10472080508764852660605060527020866060504640306050804060506087606060342540283080201
10008040405000700070707060000020003000505000402030700070306000607020000050006080301
18486080203060307060502052526555204087407056807050555720808340207047635086204030501
10007040708070003080602000700000307000203000505080300040006000203000702000407070601
10508040405080336250808450504750806750502570435060675058834757705340803040804330701
10500070606080008000206000602000608040706080008030007000000000500030807060400020801
10276430204053402074506063604087407030607050406025706678532620406080706020466040401
10800080707030005020003000005000007000806020700020200000000000305020202080006000701
10802070202025423020607722305755572778604080255630308657776472702050804074407358201
10505000606000007070500000600030006000004020000000200000004000004050407000600000201
10207852503875402070404730886060204057724056386880404335434058866070204768434030801
10603000407060002030602000600060504030002000400070302000006060400050700000008050601
10806250203040882080406077502530804070602750605030262085402020202440305634206020701
10605000500060000050204050006000807000200000708070400070006060800000700000405020501
10408027538664842470303078358060206867347355606034607460406050384323278650702660801
10400030005000000000408000000040300000000000605000004000506080000000006000200000801
10887470806020643664604688353477323285268640232347884070603053564385406078685225501
10000000800070600000600000800000300080000080000000006080206000000000808020008000801
10274647224420508230502840202640205040657054477320608070507878872480605058808080201
10000000000070507000400070008000503050200060000040700080700000004080005000004070001
10357360226860704022636028586060338050202740775076624670703375302020852443332074661
10000050005000803000006000500070400080200000300040000000200000403030000080000050001
10285024407053704274708266404775508460245730202780565576224440402033635020558440701
10003000806000304000800000200000705000800020707000400060000080700070000080000030701
18306430205280504060258440234620604080404055407085637050588440875430508858623063801
10005000700020605070000040000030803080305000504000004020700040005000600000006000001
10802024373020703066806077646050604037408570405078302030706064705072387650603238701
10802080002050005000607000005020006000300060006000204070206030007050000060400000501
10644068506063782480703574386044523840422086472720805050307020367060346062548030781
10004000706040000000207060000050004000200040008080502050603070200030500050006040001
18802630406030305242704070522540605080204627606050602060403060234780202640503024201
10006000707070700000700070000000804060300000004000500070007030004050600000208070001
10434065707060407370882348862572702050826833632888255884654033307030605252507330201
10003000004000200070000000000000500080000000000000000000005000006000300000200000501
11111111111111111111111111111111111111111111111111111111111111111111111111111111111
