11111111111111111111111111111111111111111111111111111111111111111111111111111111111
10000000000000200000000000000060000000007000000000000000600000000000000000000000001
15303366732340836260507275232054607068707820507022204780774080207262476466485722501
10002000000030000060300000006000206000400000707000706000600060707000000000000060001
10807723784060853050672688607860705780834625588650404037504460854020726384376080221
10308000400080407000300000500030208000600060008020406000004050002060000030007070001
10303060506080307758607060546040307026706042405080206468335070705034862450308060601
10700080004020003000006050404030002000002000202000800000700070700080000000300020301
10485038526530442080525030202088283640455780604787328430407754548770382857572050801
10006060000080200070002070008000000020000030202000000020600000000000700000007070801
10606480307033505048507024665524844060586050608020526050677475565637603538604380401
10300070807000003000305000000030000030004050004020005020007000400000505000300040401
10432020707353832850308675473560507386404038375068302058303080203280707040876048401
10004000505000000020800000007000300060004070000030702080003070005000503030005000001
13405365707060305082633264527057244080403060405530505050677080328036547080603657501
10008000500020507000008030003030800030307000600020008070005020002000005070300000301
10484850808480845026804020806060607880605634742742636020707050705724602020882530861
10000000200060003000200050200080007000400000000070000070605070700000600070000040001
10635484308064305583776260665860835070365348685080775478607044436270633455737570701
10000000502000700000002000600020300050300060600080000030006000700000400000000070201
10652360635670272554308033567030206636505080206823823060563620402486502248626074701
10000080300050400000002000000030400000005070002000003070000000404000706000600020001
16784530507030508046858525608264302730252078627087628070385834757050606060303850801
10000000403050807000000000503000200080004000003000006060000050003070007070500060701
10288677808030406823205850728040486044263260406535708086383060207078284050546060561
10400040008000300000300040400060008000000040700000704020000070404000000050400080001
14706050306443744260634320406835406052554036302720308034352220303328637466602072501
10002040804000000070000040304000008000004000206000307000000000200040002000008060001
10752060426056634077635087607020468248407580802075808337607654785060308050445070371
10003000700050005060006000806020000030006050408000303000300080008000200050006080001
10708723807070508020622860685057542060462050364570305080375074604045483833604023201
10600060003030400050000080007060000070800060000070002060700070008000000050006060201
10335040858080534266747070504050676240708237834043574770403620503265633040768040201
10204000700030000000000080402050600030007050008000000030700000206000000070004000801
10804244805065448853786550608080402042643040302053528050332472324074567230604635501
10200040704000000000000070800020002000008000808020003050005000000070000030800000201
10702030202045548576785020803076785580607772205030506023508832287720664020548530501
10204020003000007000005060804070000060300020007000205000300000000020800070000030401
10662070622874208076803050403030537076576050325665508530308724722050405037657040201
10000080003000407000700050203000800040000030000000307000300080000040605000002050601
10334538207043606020822320307323638430303845445880208054238340404426304685388030501
10400000208000006020007000400070000000800050000000604050000000207000007000700050701
10707870208565822555853035543080782888285370544543608080608736804082888060504830701
10006000707000700080003040004030700000000070008070006000200070302000002080400020801
10277065308050204080407030656060806023534055504050304740742040208844204034787080701
10004000500020508000600060005070008050007000007000200040308000305000603000004020601
10803730424480205438768373305033633340303773684245346020606040305050802355803070301
10600070800000200000200020008040000080200000300050007040506070208030600000800080201
10322030804868434280407050536040586060206640805050305020608053706020322620772030501
10002070805000700020307030000060007000606000807050600050502000607060000040003060501
12486070802030306040804064822568302067807027806040874450505250405043866084702060601
10007080203040006050802000300000203000404000807070400020003000405000206000604050701
10705050204030245280803730307640208880504470558080632057385778408350802070304870301
10500030402040005000403000402000807060202070005060003000000000600070405080400070201
10773760303072406034506074806028404050608070408047405447685760503060606050444080801
10700040602060006040008000003000004000804080300060400000000000806050802060003000501
10403030805086868020604437603353274268507080777580706325367637506050506086606544301
10702000202000006040800000500050007000005060000000200000005000006040503000200000601
10605222606724505060608320777080305048232022345260802674882064565020805582232040201
10703000407070008050802000600040205070004000400020705000006020700030400000004020801
10305240407070624040708055402550802060407770503080277027705030302380808855403050601
10608000500030000060603020002000502000600000608020800020005020500000200000708040601
10707032656746743860808055354050705764623345607086702220806020267452237760802360301
10300060005000000000508000000070500000000000506000008000204020000000007000400000501
10224870806040227776706373427284566535258430685646465040802066652777402064834837301
10000000200040600000700000300000500030000040000000004030605000000000508040003000201
10333783722430206480705840603850204040738057577420804020607243673240604083606050201
10000000000050604000200060008000708060700040000050400060700000006060007000002070001
10666760472880208086543032665080673060705730643023468640202732402030668543448073251
10000050005000505000007000200040800050800000700060000000800000404080000030000040001
10627054207077804883308563507856208730522740403840388448337750608064257080284650701
10008000504000508000700000500000803000600030303000400040000030500070000030000030601
18802660607350706040458560576840604040405062307068557060585550437550608266223038601
10003000800040603070000040000060405050307000207000008030500040006000200000002000001
10504045782050208022306075345070605068703830402047504080408078407085565330307468501
10404080004030006000406000004050002000500030002000805030207080003060000020200000801
10426034407023333660707422328063848570854062365450203070404050567040836022884080721
10008000305050000000207020000060005000800060005070607080705020600020500020007060001
16707730208060708672503040485620602020807633705050504040604030574570603870203024601
10004000604050200000300070000000304020700000005000700020008030005040300000704050001
10278082505050305240825285668622504070772245537352436524666086307060504426505350501
10003000005000300050000000000000700070000000000000000000005000006000600000700000701
11111111111111111111111111111111111111111111111111111111111111111111111111111111111
