11111111111111111111111111111111111111111111111111111111111111111111111111111111111
10005000000000000000000000000000005000700020000000000000600000000000000000000000001
14303050602474503687277646542475402077608084358055405360508036408056233484802883501
10005030400000800060000000000070006000008000400030700080005000502080000000700000501
10776280607280253045735376872020303750824370406080423075337382504060238440746260601
10000000400070007000005000004000600030400000403060000040000070003000700000200000701
10724455258053305345304060407856728026505558707022537440308670252767207323303284701
10003000200080506000500070300000002040003000006000000030808000400000200040005000801
10204030705320703070435350287278608870507025566558385020203033873870274050502530401
10306080605000300020400000600060002000202000007000008000402000000000400060208000801
10804042204022763420755724206050274063883463707057505822302060523768703230706080601
10202000005000000060004000003020000020000000606030002000005050000000305000206070501
10708542422347368023805070228033686230206860804065456050573040765426303085266030701
10400000000000008000500050200060000000702000706020000070400060400000005020000030701
10865643222546205350535247404740702434308087505050346457802837703255526030354040301
10000050000000500000700030004000200000804000005000700000007000006000000080008040201
10486050706270378243403050447030373056707082537624427422486078337060463683405560401
10800030700080000080002050000050006050002000800000400000005060006020007000008000301
16304670278022258070558033577856502560732320705060302426807050607050848070587032401
10005000502070000040005000008000400080000020004060306000600050400080400050202000401
10755050407080884684803763705033642066334030367030406060425760783665307460207030201
10000060200050400000704000408000000020000040007020603070004000600000800060006070501
10725430637430806070205045208063875760737743526020707064407035704860882082487680401
10000030000080203040508000007000600020200060000070400040607000002050000080000000501
17555085742060702020806766334060505060236070744650237880306847564030436830245746501
10006050200060605040007000008060008030002030000080000060400060000060008000200070001
10408040208470402052325070305055266077405024822024432030862020503753878030508080301
10200020202000704020005050203000003000400070006000008000505000307000000060607000801
10876830608052507070707020408448244030583840206334707026507256402070787650206267751
10000000803000008060400050800020002080000040700000202050806000004050500040400000001
10767653708064856080206580708040607058657030808242408020508663748040208060644084501
10600050003060006000706000506030306000007000805000804000800050000060005020003070001
10602080863270602088462032635068606556304755632050802070355030523850808084402740621
10305000800080205000500080003000600000300000003050008040800020500060704000500060001
10607822647060607660303245504060247780408463803032585066208030877050228580682053501
10400000000040400070700020002050003000200000403000500050006040000040300000607000801
10643287786526723037257040645044605056782652607480807380408027754430508787508060701
10000000007000008040000080200060002070200000008000407000505080000000800070007020401
10543726705050603080245330805570232080408037853058425030208030422834283080202040801
10200000300030600040700000800060000060003080005080003070804050008000002000604030701
10706050555878266250205072585058345534766050503020206070506025705080728234638060601
10006080000000003020005000002000005000302020700030500080403000200060700000007070301
10562074773267307020636720706824505060507070624330505230508630653234407746302370201
10300080007000400050400030700000600050400020000000800070700080000000600000500070501
10705620807450202880862070246640824640808075878658373880488032587230642340445080201
10200020600000500020000020600070003000207050000030000000200020003070000080002000501
10746020402642668037237060303076462020804850202030463558305870803024888026403057701
10005000400000007000002060008000200020400000203030000000800000400040008000305030001
16305885303635402552803353472585704050382263487086566850303526738260206080302460341
10300000400000700000300080007060008060005000004000000040300000700020405030400060001
10278740804280207830442020408080803046208037404033636040857533803087705080447030601
10400000700080802070003000200070408070800080006000005020000000007000008060500050201
10203025773060702037703062234870604050406320406666806033726085857076868780805448401
10603050006080300040006020006000506000800050500050007020007080008070000050500000201
10807020208030753520466880403083202388502580534070672030405520605480866030246630501
10008000708060000080200000502000407000808000600020400050400040800000707060000080301
10257373432048754020503866306070707550704036275240806770505080233878608048658820701
10000000400020004080802000002050200000405000000040200000808000300000006000006000401
10354630703380305020702284365730805754605868688088335342884678302082433083303057201
10000060604000508080200000005000600000200000003000005000000000006080007000203080001
16563020607072802080836085407080276370802572807535508030877222834020503432606040561
10300060600050002050006000300030702000702000007000400030500000000050507000806060701
10304050637720437058708220656380506063576074722080327044406455685230407020702020401
10205050000020006000700070000040007000300050000030007070008000000060200050005030001
10704442675057802354448042486025453060504250686536203480688024466050306654303086551
10600000002000500050004000008060002020600000600000400020200030008000200000606000001
10528735602856404020604236506070202260267752606480567030206630206448823580878052601
10000000508000407050305000007050800000208000800030000080500000300000000080008000501
10327750503020587080805030345040283458602060605060272684703444656356235055804730501
10600030008030004070200020005060008000500080208040006000300000000000003060004000401
10403036886082204040556487745083808040627660705075373060408333885633508023273083301
10807000700070006070000020006060006030300000207000600080500000000000608000004000801
10508480703820303024506070506660768080505042207840206250702332322740503658307046401
10700050008000202000405000500060000020008020800030002020700000003040200050006060001
10665030247083203660704678503045273733478030526044423050302272404080233070546450501
10006060200020003000400000506000007000005000600060007000606000400050006070007000601
17304053507585445067283450608563404747308082405370803378468020244757507034486043601
10006000700040003050006000300000400000508000300030200000000020006000008080500070401
16655050688080805030703244463328632580205347374080267746247847504025778020508470401
10007050003000700030600030000030003000400000000020000000200000004000004000400030601
10605467866648628470802020807020306682623337486544787760608468622625488435445030801
10800000000000000000404000502000500000000000000000000000200000000000000000000070001
11111111111111111111111111111111111111111111111111111111111111111111111111111111111
