11111111111111111111111111111111111111111111111111111111111111111111111111111111111
10400000000040000000600000003000000000700000004000004000000030000000000060000000001
10702034222080427068504042605884307530706088506067608562503082237080655080855877801
10007000008070700070005000800000007000203000400080600000008000000030002000700000301
10274852503048407620803230603564573324806730207580607223652372667284805845502068801
10000070505000600000200040606000005000002000202000800000000080000000205000508040001
10247040502830765685303760504030403083267055874026432077347040604660203030704020461
10003000400070000000307000505070600060007000000020002000005000702000400070007050001
10508257587052488650837058727060774520508358773234207060505868373040285056673064601
10200000005000000050004000500030000080400000000000802070500080000040008040000030001
10365454304577643047708380607586287020808044346740206043866080465835403060367230501
10000000300000007000300000600080002000206000400020506000008070007060002060002000301
10606630503428707850422465448060663850402437802080402063808083506030864022807085201
10300020300000504030000000000080000060200000704030707000508080006000400040003020801
10282770326445206020642483784734682020662350808080207780304030855328502050628070801
10007000300030007060000080006000000060000030203000300050502080700040004030300050001
18203087504050403080265070668080848232256040305458283030806070365030345740308237881
10702000404000306080008000300030000030000050600000000040603030002000800000305000001
10507030607638748083306685408038328660208480726475662828307034405756704027605020801
10006030200000002040300000505070006000300070300000200000008050004000803000200030201
10604030223063402050368530707030603076352050506260508848272040602020708060602353501
10405070004000300080000000207070600020000050700080004000600050203040407070805000401
10224048503850478758367353208350264228862640348082302060304840704060706480226080301
10006060006000200000000000200080000000500000208000303030602000704050700040600040001
10402050678738608637836240738078607440805855702070488050633053723074483060402383381
10802050000000205000000060006000800060300000008030600050000050008000000030304020001
10308062567360804050623037503260447020333877475320204763253820605270234280403080701
10504030000060008060002040500000300070200000004000500000000000500030000080308000301
15806050822047542040807070407826402880704075606077386336584587526070547050606286201
10004000508000005030302060500000500070002000502000000000000020004060006040200020001
10526382302050306070606040404862608084757730803347406528675020304024502070408030201
10000000006020400060307040702000607080004000400000700020005060300030002040407000701
10778758252060638770705060625070408080447077368460206080703050207280564070253368351
10000000400070008000708020003020302070000080002000605000704060506080005020000000001
17775845606088503054307040607670304040284820604022642457504030603088282032875352701
10000020004070008000403070703000608070003000204000003080007040302070000040000000801
10455070287480768360803028805084242033837042503547406060275080505030848730264660601
10005000200000600040606070002050000060006000300070006000600080402030000000600000501
10703754586577705040707030783030266830705340358780337574703520807040474438306732701
10300000000000405000607000700060000020600060000020002000005000800030005000805000001
10646575532320502636605657205347502050853086377030536080526060377222327037305057861
10300000200000700000300000008000307000704000000030400060600050300000003000008000001
10302057805066744460628223863740502527704082775450406246808672608366802680826572201
10805080004000500050700000000000504000002000600080200040008000808000500030007000701
10608240705460206040702052322564506060636733502020668080275080672030406034243070701
10300000606000504000708000000000800060600000003040008080000060002030703000800060201
10225475764063208576304638467380803060702772572856707084633365807640507640607377201
10000000005030003000008000400030704080500050000000004000003000600000402000600000601
10452467707260528078638020707440505570423030607267334375405080426468483050276270501
10300000602000200040004040600040500030002000206000000040300050400000000070004000601
10206060502065807360707650802020366038804063636085722080308540708032324070205036801
10003030304000003000800000503000500070706000600030000060400060003000008080606000301
18548720304882822030347638508758303340305620706520383650578648264856806038806020401
10000020307000000040500000602030002000500070500030000030800000200070002080007040001
10633070502080256760408670707050832023254028707050857030408330608080278350707056271
10007040508050003060004000600040000080003000408030504000603060006060300000806000001
10202340606080504070753044373235365770805240788060306084603022675040804447206624601
10800000303070308020003040000000000000500020000040005000405000003020503000008000501
10823235207080506040202070407283543278844054224078533360808783508057203067854030501
10005000008080700040705000800000000070003000002060002000403000004000005000007050301
16562025776030337870304072657563468070808866302050578040707085772035874063703050201
10000020000040800070208000004000500040500070804030000040400040006000008000200040701
10544770506260756070708285406060203480803080706538327630842620502755703338864685501
10600000200020000040700000407080300000808000303000000050200040400000700060006000001
10807076223075843470268230288020204363708587208070486030607040277870807080204024551
10004000807060000060007030007080200030003000300020600050707030003000604000708000001
10838230803030707050307070403860473030357080763460304866605087836022607084203230501
10002020006000204050700030800000400050000050300070800000007000400080003000800020701
10606080626325302024632632804024633330537540703080885587653230502876876020554056401
10707070007000308000000000308000300020500000606070000000000040003000008070006000601
10705023855080206243544360306865206027205387203020338424628054888674307220207260201
10206000002080603000000000200040007000703000407080800060006000700000500030700040601
18404837706075805044528842266040805750447020203044303030807650304260804060743070801
10008000003000005000600000800030600060002050007000807000200060204000707060300070601
10866033707727205720607840673680774037604083356460802045373550605076386037607260701
10007000800000700030200020008000502070003000200050207000500000603000008050007000401
10207720608720426260783086207080502020506530702050707260305352504033502050256038401
10600000200020600020002000400040700040505000606000402000807000402000602030008000401
10456836782520704026808020228560574830707057303088702446708080508734608075437530301
10000080000030705020005080700050002000408020003000800000004070002000007000000000401
14348030335084704024563220503064807068628060847687687546444030568036735478354625301
10000070003000007000000000207000005000000080000000000000000070006000000000000000001
11111111111111111111111111111111111111111111111111111111111111111111111111111111111
