11111111111111111111111111111111111111111111111111111111111111111111111111111111111
10000000000000200000000000000080000000002000000000000000700000000000000000000000001
16802883532230274350707852765072208056203670304076705560286040404585528732738354701
10008000000030000060600000002000404000200000304000302000400050802000000000000070001
10607254382060447060263463307850806270766387447550606058808420427040684467528070471
10404000600040303000300000700050204000800060008030504000006030007060000020007050001
10303040803020707486304050356080302086207086405030506688528050806036232680507080801
10800020002070003000005030706040002000002000808000300000400040200050000000400070801
10283048854440428070378070307058258840277660407635486860402562567350545577853060601
10007040000040800060002070003000000060000060402000000040700000000000500000006080301
10407660206058504074205043254543736080727030704030556080474537384652603645205850801
10800050707000002000704000000070000080003020006070005050007000200000507000400050401
10833050506324252380702543762840503652605033782072603045203040704640807080358027401
10005000603000000050200000002000300030002040000040702060002060007000604070005000001
16605365206070407083622623337063242030403080203380706060322070338084528060403747501
10004000600080804000008030007020400080303000300080003050004080003000006050800000501
10425280605850365022308020402070408350707423727364456050207080404825507040688560771
10000000200050005000400020800040006000700000000040000030804050300000500050000040001
10327736502032302773528240473830862030367553553070427434608042846750445264344270301
10000000408000700000007000300060600060200080300020000080003000600000600000000020401
10662850733870274257607072432050603782406080604663724050825850406364806332655084701
10000080800070400000004000000030200000006070003000004040000000706000408000300080001
13277360406050208032664846502762208580732035753054622070335765468040808050304250801
10000000408020604000000000304000800020003000003000005060000080002050002040200040501
10236568506060702456608780643020585056726480807423306085427030506046338040366060841
10400040005000500000200040600070007000000030800000505030000050605000000040400080001
15602030404525438860776260805443406052838086603530708022425720403482856338506046301
10006020802000000050000070206000004000002000302000208000000000600080003000005080001
10778060548074368058837027606020484283205770504067702534806284286080404030245060521
10003000400080006030002000807020000060003070304000806000500060003000200030006060001
10202658404030405050226480563058776030856020778280208030627046408073634543602054701
10800020007040700070000050003070000040300040000020005080400060007000000030007070401
10385040423040274346237030702040685770405466573023682250706370607424285070535060601
10705000200050000000000080308020600040006030004000000030400000505000000080005000301
10708373804063725258525340702040703035766080302064833020382837633053558260302885201
10300070304000000000000040400030003000004000703040007040004000000030000030400000601
10604040503074224277626030504072287350606624407080308023205338668570647060448280801
10303020008000005000003070206030000080300060002000406000200000000020300030000040401
10826030365363806046808050808070425087237080875488806750504482742080607075573030401
10000050008000302000700040804000400050000050000000204000200050000040502000008060401
10426456703078308050242820606727725870503265885780506055765260708683606657278080801
10400000407000002040002000700060000000300070000000202070000000602000005000300030301
10407860407262758538865022687030775623766340425742303060506386705068773030403240801
10005000808000600030008070006080500000000070005030006000600070502000002020200020701
10374037502040404020405060678050305042342063708080206480283050406574807042538030701
10006000500070606000400040003030004020008000006000700080602000604000804000003050601
10307280325340205545623356805063632560408472243358686030803070205050706746204060601
10200060500000500000500050003030000070300000200070006060503070708050400000400040401
10675050306585434420203070756070384080603240702060602030806027504080784720346070701
10008080404000200020805050000030006000408000407020500030302000405060000030008070301
16278050804060405040205025856867703063304057308050555280203580602068866083807040301
10005040503080003030705000700000206000505000607080400030008000603000405000603030701
10804020404030656450507250303840404580303660762040836064765826303330304040707260201
10500030304040004000208000805000204060303040005030004000000000200040707020700020501
10858720302082807053403042207056404050603030503027303425742260307030407070547070501
10300060502050006070008000004000003000402030700020400000000000608070505050005000701
10805020204077745070507388206535877644408060746270604225542367504070203035206587301
10808000305000004080300000500080008000007060000000800000005000002020803000200000501
10508385806223502070406250666060205025847078832360307465365023464050206883236030201
10803000403060005040605000300080204060002000400020708000002080300080300000002020201
10308840403060855060503043505360306080304620703050468052604060304440205758207050801
10802000300040000040507050004000702000400000302030200020008060300000300000203040801
10507084328365422350807042657030206785223477205085207350504020583362447580603330201
10800040003000000000307000000050400000000000708000005000404030000000008000600000301
10858260205080847366308267236375673858754530677884267040408046736426707043588767501
10000000800080200000600000300000700080000070000000007020408000000000503080003000201
10636338623570306650308280405560804050682043574870608020807425744380805022203030401
10000000000030208000800020007000508050200060000070200070500000005060007000002080001
10754330367850305067557023375050374050804280476062325570508763602030426268538024221
10000080003000304000003000800020800050400000800040000000300000705050000020000040001
10823023706074302382308267208685702720545850405260256235732840605053278070474450601
10005000505000303000600000700000708000300080202000800020000080300060000030000060501
12504340307320504060473320226560306070506073205034668030288570584630802457658028801
10008000200020603030000060000070703030507000402000008030600030007000200000005000001
10508024235050502054606026745030705027504840702044502070605052407078577640208675201
10403020006050002000205000005060008000200070002000808030608060007060000020700000801
10565053507083553280402287564058553550676073244780604030702080827080837053378050471
10003000703080000000403040000060004000800040008030702040408040200040500080004020001
14505540507030503672604070732480407060605628808060807060502030874680308740207028501
10002000708060400000400070000000805080800000002000800060008030005050500000305080001
10647062208060402750677685387322807030823773635652683443448052407040307836206860601
10003000004000200080000000000000800020000000000000000000004000003000800000200000701
11111111111111111111111111111111111111111111111111111111111111111111111111111111111
