11111111111111111111111111111111111111111111111111111111111111111111111111111111111
10700000000020000000800000003000000000200000003000004000000070000000000040000000001
10404077353050526053706026407352302770503084306063204845605047257020774060864867701
10002000004050500070006000500000008000205000800040700000005000000020003000700000701
10485222807076203830507620505628833862405730306560806438426386885425402558406068401
10000030608000800000800030304000003000008000405000200000000080000000502000408040001
10327070806330722575307340603020606042658036357085535053365040804640202020607020241
10007000800060000000307000204070500080004000000070002000002000705000500070007040001
10603374366073728840327033576050355730708832722666607080608527768070855066426043701
10800000003000000040004000800050000020500000000000203020400020000020006040000060001
10858376702863546027403560203426745080806032633330608062775070853274504030345580801
10000000200000008000700000700060003000306000800040705000002040006050002020007000201
10602530803752505840266243638050335660707542803020502023206074206030826054505023301
10400070300000604080000000000060000070800000207040207000402040007000800060004080701
10457530873735804030586672382322747050442660208080202530302080272223305060566080501
10007000800020004020000050006000000080000030203000500030503030700080003040300070001
18208084804080807070626070875050588723552080407584344060606070252040552260602624351
10807000205000208020003000200040000020000070400000000040508050003000500000802000001
10808070803822642022405883602053533460808520862445582867205073308335807028604060501
10005040600000003040700000505050003000700020700000200000008040005000503000500070201
10706040675082307040423360404030505038243080605520804345525060406080405030605284701
10406040007000600040000000404070400030000080400070002000600060402020706030202000501
10265024508370842228288552208720662668856460584047306040406480408030604680648030701
10002070002000200000000000500070000000500000802000206070204000206040200030600050001
10805020527788507757567550544086604270805476607080578030745088355074743070504736781
10803080000000404000000040005000500050300000003060400050000040007000000050207030001
10707068768260507020727054502560652040646385735320306624627250508550633280807070801
10403080000040004060006080700000300080800000003000700000000000700070000080804000401
17604030777055356070306030804448208320404072306076276532882353373080386040602853501
10002000405000004020702060200000300070007000303000000000000070003070008020600050001
10343877203030608080507080804532204057284320408866502385662040804055806040302050801
10000000008040200070606080506000407030003000600000700080007050500050003050703000401
10386684454020266340403060453040308060868043828870404030708050302820324060336554551
10000000700040006000608070003040707080000060003000706000206050202040005070000000001
15248825806064803038804050307740804050227420208084223877203030707054838076524765501
10000080003020008000202060307000807070008000503000006070005030302040000020000000401
10275050845740778860704038807045483024445024405778407040587060306080525560287560701
10004000800000400030208060005030000080007000500060007000400050208070000000500000501
10406867584484703030404050556050737370206620866520356477303380406020487328402287401
10500000000000402000303000600070000020200080000070005000006000600060002000302000001
10434727544370207887307228306838408050736073324040672030788080582683637072502062821
10400000300000300000300000007000702000302000000020500040200080400000006000005000001
10807063803023745280375856676220304663704032265440604268206645708387702760246886801
10404060002000800080600000000000305000004000400020300050008000203000600020003000801
10305480306740604020607078636238204040665852308030377030427040455020407082287080201
10200000208000602000803000000000600060400000006020006060000040006030603000700040301
10837458768058703474808888554420805040702383377843407068246286606220207880502428501
10000000003030006000006000700070707040800080000000006000005000400000704000400000201
10635824704750434064337040206720603530226050306427545472808050674274674080552570401
10500000205000700070005020200030600070007000305000000040400030600000000040006000201
10705020704086406420508830307020624046802057453066855040706680307027588020607028501
10006020207000006000200000808000400070203000200030000040400080003000003060207000201
15454880605323684050654838204682607350505540704670384780552654864424407072506080201
10000070607000000050200000305030007000500080700020000050300000700080008030004030001
10784020604040732350303870305050736042467056805040646070602230602080627630306064471
10004050306030002060006000800030000030004000402030307000803030002060300000802000001
10505680806060206050784045732874673650404420672040307047807064582040205578807575201
10600000204070808040006020000000000000700030000040003000503000008040303000004000501
10742432207040707030705060605884785244354065887066887530708788702064703064847020201
10002000008050300060205000500000000080004000003040007000505000004000003000003060201
17243026224060734230207077632524538040204484808070386030605043432057564068306070601
10000030000030800050507000004000300020800040308060000050700070002000006000400030401
10434340405440572020706554603030404380603070708563446740523460704647403583237256801
10800000400050000070800000405050200000802000406000000030400080800000700020006000001
10607058655032486720263260378020508427208882202050354030806050226370407070303043341
10007000402050000050006070005070300030004000400020300050204070003000304000302000001
10545370206060803050707040804660468040757050688220203778303053227054503026408470401
10004030008000207020200080800000800060000020300020400000003000400030008000300080701
10302080248743402086877587505063428330285820208070635367235240704287576030588024801
10606060004000704000000000305000200080600000606080000000000030007000008080008000501
10304087434040402532383520508372307045505422305040637322273068227232407460703850801
10207000006050708000000000800050005000207000502070600050007000400000300030300080201
16406448608043304048645854677060808250668070703085308030605480302250302040564050301
10005000002000008000200000400030800020005060005000505000500080807000805080400040601
10785068304753607380707360665660762084404032677240406023367420804068268065408820601
10003000500000700060700050007000204080005000800070506000300000208000004020007000801
10202730508350438470675063307030506030408650702060408430507668207076406050823042601
10800000800060700060003000300040700020706000505000308000407000704000308080003000801
10682262542830708028203070632680758530604022303038607544304060706634804087535670601
10000020000070208030006080600060005000708050005000700000002080003000002000000000801
15337030843028704032583260705048407023344030757636767645283060836067742674246486601
10000020003000006000000000507000006000000050000000000000000040004000000000000000001
11111111111111111111111111111111111111111111111111111111111111111111111111111111111
