11111111111111111111111111111111111111111111111111111111111111111111111111111111111
10600000000030000000600000007000000000600000005000003000000050000000000040000000001
10304022584080634026402047502252402270603045406022502678807037624020536030752822801
10007000007030300060008000400000004000707000800080200000007000000080003000500000801
10638578402085703560405880307675658543703480604860408367255364483772808523403045201
10000080407000300000700040206000002000008000408000400000000020000000202000203020001
10286070404830282624204720403070303082258055454025678056774060506430408040406050661
10002000300040000000506000702070600080003000000070003000005000404000400020002080001
10203245276073778320732025478070564720703757364844505060407745322050543057768044501
10600000008000000020004000500030000020500000000000302020400050000060007040000080001
10424374806534636073203860204345563070707082332460603062348080788486302050822520301
10000000400000008000600000200040002000508000800030302000004060008020002050005000301
10208520606347807680257447285040887630204354705030303076305025703060356035702063801
10500030700000402020000000000040000080200000602020306000307050002000700070003050801
10338260485243608020638738626272482080488630607020405560802020825534204050734060701
10003000200060005080000060004000000020000040204000600070503030800020002050300040001
17206068806060207080345070485020883827474040408723344040602080452030687670804382751
10303000603000706070002000800030000020000040600000000060604040004000600000707000001
10304040308543376062205738304083443280806740777462528685507075502473706078607070501
10008030500000004070300000808080008000500020500000500000008050008000208000300070301
10307070742032608030836550506080307073264040708760306458256080605040708050703432501
10508050002000500080000000704080500050000030300030004000300030202040307030404000801
10548053807260445383676777208880558837463740886056603080707630504050705370375050301
10007020003000800000000000600030000000800000404000203060607000302040200040300080001
10202040588683703675574320587083305250704632606030686030568052682065722040408453721
10807050000000304000000040003000800030800000008070700030000030007000000030604030001
10604053845260702070885072306360585080525668745720607386722620708760448660805050301
10304080000020002070002060300000800030600000002000500000000000300040000080808000401
14607050485067823080507070605828207520607088202074235385634858848040623030404486301
10003000705000007040504020700000700040007000607000000000000050004080006040300060001
10452667303040503020205020704742507038638450202774808834847050605084703050304040501
10000000007060600060407080304000708030005000200000300020007060500060008070304000201
10447356837040322380608040284070808040747026577680402030404070507640564020663573461
10000000200030004000504030005040307030000080006000807000507040302040002060000000001
17673828606062405033704020405760406040673320802054856846307080703047378025524452201
10000080003080004000606060302000602080007000503000007030005030202060000080000000701
10756020572560266730306038603082858035862082608758808050367050304050275450467650301
10006000400000400080607020004050000050004000400030007000400030802050000000800000201
10804376832852604020405030587030523360402730888830432648203750804030343728605663301
10800000000000304000707000700050000070300050000080005000002000600080002000205000001
10577282585280206833204226205825308020523055233030284040844030455873643065305025531
10400000200000800000300000002000505000407000000080500040700030300000004000004000001
10402065704028885370246543547650704375508074326240408753404582803686405830765374801
10306060005000600060200000000000306000002000500070200060002000202000200050002000201
10602280307660502070806023474254608050366565806080644080257030778020504024642080601
10500000704000602000302000000000800080600000008050006020000020007050402000500020601
10465385662057808323705445828270304050208264533223608086424486206360706450508567201
10000000004020008000002000200070805050800080000000005000002000800000802000500000201
10846272702530566085738080803740205740377030504443472328306060768566735050456480601
10600000705000200070007020400040600020006000405000000080300020800000000030008000801
10706060708033403350504470404060833072203047276047436030605340803073647080608063701
10002080704000003000200000303000200040608000800050000050400070004000007050202000201
16787770507456868020425423306424508520206870504720332880863538664752404086303060601
10000050302000000040700000507050008000400030300020000040700000200070002020003080001
10748020405050547770302870606020357034566038403040238060707630507060775820204062531
10003070608020007020006000800070000070002000508040303000408040007020500000605000001
10703480808020207070864034652588822460207520864070408065602054643060305763202758501
10800000303040606080005040000000000000400020000050002000207000005020708000003000801
10736372505050205040708070506254283277864058484085383570302266406052507075352020301
10005000002030200020306000200000000040005000002040005000808000006000008000006020301
17826036467070857530706078262528575050603575806050245050603042375038868044807040501
10000060000070600060608000005000800070600030205050000060800020007000007000200030201
10564330506340657080503327505070507380802070304663566260725570706366208554654386401
10500000400080000070300000202080700000705000302000000020400050700000700080008000001
10305072637056726370222680588030502464607632308050768040504080484640507050206073771
10003000304030000060006030003080500040006000400020700070406020008000807000807000001
10734330407070606070704040408880768050752040536440608378307073333084506078206520501
10008070007000303030600020400000500070000070300020800000007000400030003000500030201
10202060566585402023856473704027626640455420703040552833775750304883573030472055401
10605070006000206000000000307000500060200000607070000000000060002000008070002000401
10807065572040703363866460808587805066605643307060743635572084343444508420204340201
10204000002030308000000000200080003000805000504050200040003000600000500050500070501
12302862206086508086787753466020507250378040707084304050204640804450606060734030701
10008000008000008000200000400060400080002060007000708000400050704000502070800030201
10454066704237507280203520534560864066703045524230704088742420302027362035405470401
10002000800000400060200030002000704070002000200080204000400000808000006040005000801
10804460605350233760825073404020806030202770202070206640508473307033703060285036301
10800000500080300050007000200070400020405000504000603000406000504000403060004000401
10847348582680504037806050688630485470306024607045603633406080608532608042288570201
10000050000020606070005060200080005000607020004000400000003040007000004000000000601
13622050722025806047776780703022202052376070688638465664458070833034732535363626501
10000070005000004000000000702000007000000050000000000000000050005000000000000000001
11111111111111111111111111111111111111111111111111111111111111111111111111111111111
