11111111111111111111111111111111111111111111111111111111111111111111111111111111111
10400000000070000000600000003000000000400000008000004000000070000000000070000000001
10704038644070672023302084703343805740306046303022208776805063527040878040673888601
10006000005050500030004000700000002000205000700040400000005000000070006000500000401
10564636802035705450804320303838262666306440206650604834575356532885705678204065601
10000060603000700000200040403000005000007000506000400000000070000000502000507080001
10688030408450286567808380506070606023855025346048588054523020208740802080704030471
10006000600080000000403000506080700030007000000040007000004000806000400020005020001
10408287443056584440764026752060364830707445367674402020202467427020428062773037701
10200000003000000030002000800030000050500000000000508020700080000030008040000040001
10355632705555875086606760705766467050204023882230406025578030723557402070652880801
10000000400000005000400000500070004000603000500040705000004050007060004020005000301
10207220703437605640528566255080272370806544304070207028508063403020578074608052701
10400040800000202080000000000080000060400000208050803000605060005000500050008050501
10487670885628503020362758784383278060453280508040406640702030376852502080767070701
10004000600050003080000060007000000040000030805000700050602070600080003070400030001
16302043703020502040382040545030252788383060606255227030807020476060588450804585821
10806000407000403080007000200040000050000080700000000040307040005000600000703000001
10303030702257668026604428604025455420303770257855423882604086305725708064707080601
10007040800000005080800000508050004000200030600000400000007030003000605000800040301
10405020284067504070576760207060603063535050206520802468625070508060604030802572801
10208050005000500020000000404020300060000050800030004000800040604040407070807000501
10777033506330275732577758507250253727488380857045307070808450507060403350424080301
10006070004000200000000000300080000000300000307000405030307000602030600040600030001
10607040447488405446885230568067407870607766405080684030645082872025637030406248741
10308030000000604000000050003000800050500000004050600020000040008000000030302060001
10407022866840703050474063506750257020456278537560806532824720402320836760306060401
10304020000060006060005080500000700070800000004000400000000000800080000030207000501
17302060676074655020807070306686705260307057202072828734454665453070788050305823701
10007000702000005030807040500000400070007000403000000000000060006020005060700060001
10582753705050407020203070207523508026277860205468503555437030406068506020604030301
10000000002040500050306040806000408040006000600000500050008080200080003050206000201
10764327734020266320207030526050306050337066288360507020306020503320625050767235851
10000000600050003000302030004060407070000060007000203000604040204040006020000000001
15357227302025507053404050706780303020748860608063272246206060503072435046786883501
10000070007060002000303020304000406030007000706000003060008040607040000050000000301
10258020428250347340807053704088585052677086304264208040566060505050277770747560701
10008000800000600030304080003060000060004000700060007000500080308020000000800000501
10402684778643304030803070634070542230808840286720687754405560206030777477804735401
10300000000000502000704000200020000020700050000050004000004000500020007000206000001
10637724336350405562607537606286807080456067353040845050335040735826538023405058441
10300000200000600000300000008000208000503000000060600060800040300000006000006000001
10405083403045634820373628542370608353303065585380203232207743508722402420653235801
10307060005000300060600000000000605000006000700060500050002000806000300050006000501
10303830206780307050704086228582706080335344807070877040646020665070702063438030701
10300000406000504000807000000000700080300000007050005070000020002070403000800040401
10452754252066603866602786258520802020803243323864206083823363405270803360702236601
10000000002080005000005000200040406030300070000000007000002000700000705000800000301
10243633205620862084227060806660205430826030503448567883203060546782638060442440401
10500000808000600020005060800040600040007000202000000070700050700000000030004000701
10307050403066205820402820604070853028208086782085524020506670505067475040704043701
10007020206000008000400000804000700060405000300070000030300050005000003030205000501
17763360302337762080323777506773204870803620706360263480366587543545808065403080601
10000040402000000050400000205050005000300020800060000040700000800020005070008060001
10428050604030246370506370502070634087748074304030556040302340703020254520202086571
10008040806080003040007000800070000050003000204030607000205050006080700000208000001
10504880206030602050747065628785532550705580383030503044302084247050608454702446801
10800000505050702050006050000000000000300050000020008000503000006080708000008000801
10866245308030803030806070408282268543584027372046367580206265806074705066787020401
10005000007060700080803000600000000030008000002020007000505000005000006000008050801
15563052885030242340704028238834653040507426202070668070606068326085423052206020701
10000070000050500070802000007000500050600070205060000060300030004000005000800020301
10477570308230776030604623304040503660402080807624363740533450306475802667655338501
10800000300080000080700000703060600000404000406000000020200080200000800060008000001
10204025467046486660535840823020307266705836505060466020208040787330505070507078751
10003000706040000070002070006020500060008000300020500050204050007000606000603000001
10672370205030808030303040603450574060864080665330203442403028883085602047707850501
10008030002000607020400020300000500070000080700080600000004000700030007000300050701
10808050437674207056267664702087387570485830308040828423377340807667256040585036701
10804020008000406000000000702000600050500000508060000000000020008000002020002000401
10602075683050704633265840406682407048602552507050876443542083467578705850604430301
10203000004050203000000000500060002000603000205020600020006000200000500020400040501
16606638503072207056875548452030305720653030703026304070505450303230804080385070601
10006000006000006000300000600040600080008020003000607000200070605000207020800080501
10843033405272706860502840347420668063303084723880506078848330308035646053407280401
10005000600000300060300030006000502020006000300080405000500000402000003020003000401
10206640808440255270276083704060304060406530802080804620408478607055505060538054201
10600000300060300080005000800070400050708000305000407000306000607000508020002000601
10283447526630707077402070327520664830304027707032407455205040602347203076234450801
10000020000070708060002070200080007000202070005000400000004060008000006000000000601
18432060387044708077688330808026504046766080384547278783434030427023756543373477801
10000070007000003000000000406000004000000030000000000000000080006000000000000000001
11111111111111111111111111111111111111111111111111111111111111111111111111111111111
