11111111111111111111111111111111111111111111111111111111111111111111111111111111111
10400000000040000000800000002000000000400000003000006000000060000000000070000000001
10704068385070885024202058605326205650407076805035803645205056388070573050688365401
10007000008080300050007000700000007000207000300080800000006000000030003000200000601
10537538602043608840405760805525258784804850804530404667452764264283406722502072301
10000030405000800000300020604000006000005000502000800000000070000000703000408070001
10468040207230846888205580702030608088778048572073553088424020605820308020305050441
10008000300030000000803000402070800030004000000020004000007000302000500040005070001
10206384363022676250772072444030328640702275474246508070803773628050234068833048201
10200000002000000040008000700050000040800000000000404070800030000030007050000070001
10467557705685535068707850702658772040306075482720802062584070356284308070542550701
10000000200000006000400000500080005000306000300030705000006020004070007030006000801
10807850303854806680743757663070425250303367802070304023205046808050275065806045701
10400050400000602050000000000020000020800000605030207000308080007000400030006020801
10766630527756308020835466686676843080467680506050707630505040233558708020453070601
10004000800040005050000070004000000030000020602000800050408040600020006070200050001
18503022705020504050262030667050765238856050605237472060608050746030522780408287641
10407000608000602080004000600070000060000040200000000050204050006000600000506000001
10302060704446833065408552408042565330305620525655753752202064603382403068305050601
10008040600000003040800000202080007000300030600000300000002030006000303000800080601
10706020326044802040456250302040706033845050805540307637325030204040602070706655401
10704080003000600080000000802050500020000070800020006000800060605020403020506000701
10532046608520254568344387602250555856242840445057704030507360606030404470827060401
10007080002000800000000000300060000000600000408000207030203000807020700060500040001
10503050474228405568436580282035606620406734404040856080485068234025753060606633431
10304070000000207000000060003000300080800000003060400070000020008000000030402050001
10404026844880502030824032304770635020664677883820808424763420205480484640307030201
10402020000080002080005060500000700060500000004000300000000000300080000040202000701
16304040334044243040506040404856806450703063707083726287642464348060275050506823201
10003000308000008050308030800000600080004000803000000000000060005080004070600070001
10627744206040708060202070205636303034273680502765408544448050202052203070408060501
10000000005040600020303060307000505060008000700000600040005080300020007060202000401
10338668733050742750606080253020808040248063278260808030302030405560224040428446441
10000000600040008000804020005020706080000070007000706000804040804060004050000000001
18854473807086206065405040207450406080376420203058728532706030408074242033773833401
10000040004050008000302030208000505020006000304000007050002060306040000080000000601
10568040843650237730602053508073623042345077705855307050335050308030872660673660701
10006000700000800070605080006040000040002000400080007000800080203070000000800000401
10204762666826205060203050423080744860407770285450866853804330607030834224807242701
10500000000000704000707000700080000030700080000060005000006000600080006000304000001
10487748835360406563303842407276202080878045445050827030684080442827746048504088621
10500000800000800000800000008000707000202000000060700030400070300000005000006000001
10603075707033867530545267782560406473602072534840802734605565203377506270436325401
10706020004000700070800000000000408000002000300030400050008000308000700040007000301
10202280207420705030805043484784208040738373205050462020428050536070808076455050701
10500000807000806000703000000000600080200000007030005040000050005050204000800080501
10732336634078705748708256382350806040505366455854305083342772705650805370208436301
10000000008020006000005000300080407060800070000000007000002000500000305000500000701
10625765603340423046646030806370808340265050306348523777605040233427787050828840801
10400000707000400020003060700070500030002000703000000020700020600000000020002000401
10806080402048304350203380502030536065408056333045737030404570703084342060307085801
10008020703000002000600000807000200050507000700060000070200080005000007070506000701
15872250505665237050266755306834404480808540405630447220223734352328805066304040401
10000030808000000030400000502030004000700070200040000070200000400060006060008060001
10673030505030247220604530407020564053668086308080687070404740304050665770807038371
10005020704060002040003000800050000040002000405040802000403030002050700000502000001
10806830202060304040873036884537722630407430822050707066406024828080305476306762301
10300000504020505060005040000000000000400020000070007000407000002050808000004000301
10874786603020604060604080403267665264385085238025742270803488708028804044246070401
10008000004060500070608000300000000080004000006020006000704000002000004000007080601
12247067532040756870708082848733364040704665603040874070704022646022343074602070301
10000040000050600080703000003000700060200030404030000040200020008000008000600040801
10525820608760835080808642504080403620705030507638586260264730406683508476243842401
10700000300040000080300000308070300000306000206000000050300040500000800070008000001
10205058422067856750246520648060208568702422806070448080506020772470603040404022841
10006000202020000040006030008070600080006000300070200050603050008000302000207000001
10482830804050303070502050405670673020754020325270406658802075565088704037406460301
10003050004000207040400030400000800060000030500080500000003000500070008000500030201
10304020278254504084638824507047278330388620602070828328684770504367457020622034801
10605020002000405000000000302000300080300000606060000000000060008000006080003000401
10703056733080204634788380802277707072502734206070356342867037534752506440805860501
10208000007020405000000000300020002000503000605040700060003000300000300050500070801
18703585508033208087238323238060602770234040504038506080304260204470602020267070701
10005000003000004000700000800050300050003020003000608000500020607000406050600080801
10425077702882303220304880646380672045603027666450302048455650702033264028303480601
10005000300000300080500050007000808030007000300070403000500000804000004060002000801
10203640802640426350373062507040303080705370807060307280507877508024803070253078601
10700000300070500070002000200080200060508000805000803000308000505000707080003000401
10562746356320204084606050288260256280206062602063707865205050803656204053438450601
10000030000030602030006080300030007000806030004000500000007050003000005000000000301
16675050422024807043677340706055706082385070487857654484678020843037322884438387501
10000060004000006000000000205000007000000020000000000000000040006000000000000000001
11111111111111111111111111111111111111111111111111111111111111111111111111111111111
