11111111111111111111111111111111111111111111111111111111111111111111111111111111111
10500000000060000000200000002000000000300000002000008000000040000000000020000000001
10204082736020478045402072207332708450203078702085802783407057524050463030232522201
10007000008080400020006000200000004000608000200020400000003000000030007000800000201
10463424208062805370504230304437755533607370502620205326658673236526404352605075801
10000050306000200000500080503000004000005000805000800000000020000000804000702030001
10374040203650374357208620208060708077557054387044378046566070602480203020207040841
10006000200070000000204000306050200030002000000040004000006000302000600030002070001
10402745457023547350384084772020824750808842467223505030206787253080423066785082701
10500000007000000030006000800060000050600000000000704060200080000020007020000030001
10753882702542756083302260606382677040405043876640307085564050532763406030686240501
10000000800000002000300000800030003000606000600070402000006040008080008070003000201
10605250506368705440838326574030823840706485604040803037202067504060823062808045601
10800080500000305070000000000020000070300000507060803000403050002000700060005070201
10728650433655403070546372874832734050626260307040503570708030785473708040356020701
10007000200030002020000080003000000020000080807000700050607050500070002080600060001
15706067306060705040725040633070477766626070305547275040203040757020837220802838771
10506000503000604080003000200030000080000060200000000040308030004000300000307000001
10607070207568626063403567607038868540807270464436772537606063504576203087508080801
10008070700000007030800000806040007000300020400000300000007050003000505000200060201
10204040277087302070277680705060302038545050805730703848228020207050807080606235301
10802050006000800060000000405040400080000060800060008000400020708050408060504000801
10456026804440354856863264307840654245887880855066608040404880705040304620534060401
10006020003000700000000000500040000000300000704000708080306000803070200030500080001
10302020726582606573235460547055704450703672707070737020622028756048767070207786261
10502070000000703000000030006000400020200000008050200060000050006000000060805080001
10407083472460706020474074305770476060347556445840502247464220706280833870807050401
10307050000080007050007070300000600030300000005000200000000000700040000020703000601
15504050878027637030204080707438607830206084606087446225738466782070377080206874401
10004000403000007060203050600000300080003000803000000000000050006070003030200020001
10477386507070404060407050403445303043845320202737505558353040802022205030704020501
10000000005030700020803070708000207030005000300000400030004020300060008040604000601
10485763347060564850205070844020808020553068223420304050204080506870526080762643471
10000000800080003000606070008040502070000040002000205000806070605060004020000000001
14483485203025707045404060707340808060563240304047458564704040705054756087258427801
10000040005020003000506040204000807060007000405000004050008080405050000050000000601
10865060546880482780703066705054474068487062405554402050224040303040666640333870801
10006000400000700070505040002030000070007000300080006000400070803020000000700000301
10608224843887508080507020227050855220208640763430848332405830803020626838202575801
10300000000000503000408000800020000070600080000080002000004000700070002000203000001
10863772374760305838608535804262308070326044484020463040885020656774586042403078261
10700000300000800000400000008000207000808000000070500040300070300000002000007000001
10604086802032877670344445728560605477707087488630306365702838804774502440752385801
10302020007000400020400000000000405000006000500070700060005000805000700060008000401
10705670607440203070802086435828408040766445805030344030832070366060202066562080701
10200000307000504000605000000000500080800000006030006080000020006080304000500030401
10456347738075608738806727353650502040705284726664602082223344704350808640606265401
10000000005080004000005000600040802080800070000000007000002000400000306000500000201
10323745607750822074474020403250807580365070308756523788508020674463683030427530801
10500000304000700020008080800030400060006000807000000020200040800000000080008000601
10207020807025405360207480206070452084504048886034527020507470207028725030707058501
10007080502000007000800000206000300070205000700050000030700050007000005060403000701
12372620403837548080658324405487606370304360506330443470858683668287304054807070501
10000030303000000040800000806070003000500070200080000080300000600040007060004040001
10783050303030563870503250508020764065488028506040324020503260707020665830206086441
10003030203020002050004000500040000060003000804080604000503060002030700000507000001
10505620505050805030857072462656633840604550656050504064303087283060302378603754801
10600000706020505060006050000000000000300060000060007000808000004080503000004000201
10845837507070303030806050402388743386785044284088837670507827704035604048783080201
10002000004070800050706000300000000060005000005040007000803000006000007000004040301
18532045544060373630505078233734882030806557705040437050203075388032577026408040301
10000040000080500070302000002000500050500080405060000040200020002000007000800020701
10686720207680453030507488302050702450807030804826422350762460408834207585353244301
10700000200070000040700000706050600000207000505000000030200020700000500080006000001
10806084633084838330735260356080506722306356307030367080705060588340207020607075721
10004000505050000040004070003030200060006000800040600030204050007000506000206000001
10688480708070802060406030403420724040834040348520702286607033488073802057202660401
10006050003000502080500080200000700030000040500030400000002000300040005000800020401
10602060275686605054727638506072468260447840706030472844558880205366345030336086301
10503030007000208000000000308000300020200000604030000000000030007000004060003000401
10804028863020802558387540402337307028505254707060648782456027732754304870304240501
10308000007080402000000000700060003000205000802040300070005000400000500030600080401
17306434206042202056847828746070702870856080807034803070803830707280508040447050501
10003000002000005000500000800080400030007060008000402000800030305000203050800040301
10557047207425502780805530782670326076803024775780503027474650205027843055303320201
10005000700000800050300040004000205070006000300080202000800000306000007020007000301
10807460402830466370874033304020408060204470502040702780808426505035808070744085401
10300000500020300040003000500080300060306000708000707000303000608000302060008000301
10558552788260608032703060474750635730308042306068303772702050508633806026866280701
10000040000030307060002030600020006000205030005000200000005080007000003000000000701
14674060535072507027345470608045603056774040672272648274732040446072747552465244801
10000040003000004000000000602000003000000030000000000000000070007000000000000000001
11111111111111111111111111111111111111111111111111111111111111111111111111111111111
