11111111111111111111111111111111111111111111111111111111111111111111111111111111111
10400000000080000000500000005000000000200000006000008000000040000000000080000000001
10507038325060884078406083703535207430502053406028602486705057562030527080845283501
10003000007050400050003000400000008000306000700070700000008000000070007000300000401
10583623806033706380807770407755635258508630706820807232525634738478205867808048401
10000020807000800000700070603000002000006000708000700000000050000000305000805070001
10827050205750845278304360505030708035788042423072825044325030408770803070706060661
10002000300030000000703000407070600070002000000030003000002000203000700020006040001
10507376425058868750764024456020776580707555736542502030407682858070748042752047401
10200000002000000020006000200070000060600000000000502080200050000040007060000050001
10684356505252873082607660602644857080707028335540608073758050424753203050838620801
10000000400000004000200000600040006000706000800050605000005070006080004070006000301
10607330803644806770428537622050582350703323805030207076702047808050835065406073601
10200070700000202070000000000060000080600000802050605000507040008000300080007060601
10436320582862308040585244527436873060754620807050802430802060677535305080236050201
10008000200060004040000050008000000060000060508000300050802020200020008070800060001
15807087405070503070358080886040633483377020605582286020304040223020646380207875551
10306000306000503070003000200060000060000080700000000030208020007000500000505000001
10808080704546435023403877205023333360502830242883755547303065404365502024204030201
10004030700000005050500000808040007000700020400000300000006030004000507000200070601
10602040328086608060455220603060505025247040204620807677385020708050802080306478801
10803030003000700050000000705020400030000070300080003000500020806040403020705000501
10822023306630463628466277502730878327228860238025302040607240803050202420482020301
10004060002000200000000000200020000000800000504000804020703000203070300080200050001
10207040383287705726648660642036308850508766602080425030875035846087386040806348361
10205030000000504000000080004000500070200000006040700050000060006000000060303060001
10203023436850607080432046803750474070263327336380706474483350402840877330402030701
10308020000070006060004070200000600030600000004000500000000000700080000020402000601
15603080226072466020806050805563205770408022408046462455667485838030553060702625401
10002000406000007080305060300000200070006000808000000000000020006020007050400070001
10685844707080202060506040705226503033438820406233603244352020703043404040308060701
10000000004030500030206030604000502030006000200000600080008070600020006060207000601
10674823274060778420806060465030603060756037458450602020605060704780378060653386341
10000000300020006000804020005070606070000040007000606000302020508080006070000000001
15367757402073304082206040305870704050622480804055382232406050603073427074774442601
10000070007070007000204030502000403040006000804000007060007080202020000030000000801
10346020736630657330402062504075437064352044606784605030367060405030828220844580301
10003000200000600060606040006080000080003000500020007000400060804050000000400000401
10606587883844706080305040324080278380603420324640655475504870304080465488508378801
10800000000000402000203000300080000050600050000020008000004000300050004000302000001
10656623384250808435402684702323706070438058687080384040828070647533727056807044531
10600000800000600000800000007000408000602000000050200060600070300000006000008000001
10504028402028765360232543785660607773802086558230408754402742602688405630836522801
10207040008000200020200000000000604000004000300060400030007000604000200070008000201
10808360303620602050605036347638506020476546807030626050568020486030206066732040701
10200000404000706000302000000000800020400000006050002070000040008020707000200020601
10333324834025805275208473655820702020504332846374605084322657706780404770604782601
10000000002070002000006000800030807070500030000000004000005000700000607000800000301
10537737407470744087223060603340608720232060708334585284804020776576864070625520201
10800000606000500070006080200030700080007000804000000040200050600000000030002000501
10706030203077504380608630403040453057604038877027877040305640603055647060806085201
10003050407000008000600000504000300080508000800070000020700070008000005060402000401
16874240405248682020578844706278603880307650506840626520672538843822405048406070201
10000030305000000040500000207060005000600040200060000040800000300020003020002070001
10588040408030873850205760706040486082585046805080674070202530202040585560807085751
10004030205070003050003000800020000070006000804020403000802080007060400000505000001
10808840803040407070265072828548837470602570734080802038205086473070602578405373401
10500000308020405050006030000000000000200030000050004000505000006020808000006000301
10783775606070802060305030604346728476656036638084687570405634202043704078542050701
10002000005050700030608000200000000070005000002020003000708000007000004000004050201
12227066475050688670603062656677265030304736404050787060402082727067223068705060801
10000080000020400060402000004000300080500050706060000080700050006000008000300050401
10273870804760277030308653803050703380306070506786465770426460303874503836783678301
10400000300040000050400000507040600000307000305000000060500030300000500020008000001
10208047754036338350343360285020807352202555703020628060606050367340605020207064531
10008000708030000050007060003060400040005000300040700080302040003000408000204000001
10522360205020305040806040502480486080473060635240308333504084478055704055605770601
10007080006000205080300020700000800030000040300050500000006000500050002000700060801
10802040767745606027855375608054475540648530402040548638726880805485427040355035501
10504080006000804000000000807000800040300000702030000000000070004000006040004000601
10204085323070307772428440705654404083206778808020255842554055724357603270806640301
10205000008070605000000000800070002000803000803050500050006000400000700050600060401
12505468805024302045454844642060407320762080408037302050808230707540306050555050401
10007000004000005000200000200050400070004060003000602000200070306000307020800050301
10262088605446202640307650463540442033805045237870508084838520403082733084704350801
10006000600000600050700040006000608030004000600030304000500000504000008060003000601
10602740206580723840373027802050702040305450504020304420803827504022203040372082401
10500000700050800030003000300080400030408000604000504000504000708000603060008000601
10433375532250407043404050274850545320403027502046206824204080405855308058783670201
10000070000050706060008070200080002000706060002000800000005050008000007000000000701
14255040423088305032882240404067805066632080462247223474872080738024458336688254701
10000070005000004000000000306000006000000050000000000000000070002000000000000000001
11111111111111111111111111111111111111111111111111111111111111111111111111111111111
