11111111111111111111111111111111111111111111111111111111111111111111111111111111111
10600000000070000000600000004000000000600000006000008000000060000000000020000000001
10604065468020268074606086305786305780807052707086608336703022265030646040657643501
10008000005070500060003000200000006000505000700040500000007000000070008000300000701
10678785705085708840606620402782852336404860707820404273624577768667303754403083601
10000060407000200000300050308000003000007000707000800000000030000000606000602080001
10635080706370844366808550402040202044788063668028722024544060604570302080608040841
10008000500060000000508000807080300060008000000040003000005000402000300050006060001
10503742842027765530487088366060786670403778556444608020703726472060856063374067701
10600000005000000060008000800080000020800000000000302050300060000030002060000060001
10676542507238366037208350206656624080203064482250308088483020825753308060724220801
10000000700000006000300000500070006000808000700020306000007070002050003040003000301
10505320802346205850328646442020663630307257808050803025407086405050223042704043301
10400020200000703080000000000080000080300000808020704000302030004000600050003050501
10663720767682603070227765742484655050524520802080204560604080423644807050846070201
10008000200030003080000050006000000070000050507000400040703070400050005070600080001
18508068602030702030634080646050853764657030806442628080705040236060338580205426551
10406000504000502030007000400080000060000040300000000030804080006000800000502000001
10204080805457364038202637704032248680404280766546586565702028407452205058803030701
10008070300000004080500000706050004000700050500000500000008020002000505000400060801
10702070872053202060263280207020804074237070305570607556463060505040203080406628601
10207060005000700060000000808060800040000050400040003000200040303070705050802000501
10468066404280582354575365503220847463477880857073802040708520503020406250772070401
10004060007000200000000000200040000000500000603000403060202000705080200080200040001
10804040237786703282744450674056405860403455802050855070354028225047586020607365281
10607080000000603000000050004000200060800000005040400030000050004000000020605070001
10807066884640508030234058806580286050528474355750305272288770706660555550304060301
10703050000030003050007060200000800080500000003000800000000000200060000080803000801
16204020483073346070605040507868805770803035405047688758636388247070333030808787701
10005000807000003020502070400000800070005000802000000000000050002040004040700080001
10456485406070303070402040803877805084462550807758508436683030204044205040202080301
10000000006040500050602080406000607040007000500000400080005070200070004030505000501
10285635645050468820503020542020602060357086766620302020506050606750356040574842861
10000000800050002000304050005080405060000080003000508000602070502060005060000000001
14825656205086605083203070505340503050642760403054784233407020603037576025545552701
10000070005050003000308020705000703060008000608000005060008080407080000060000000601
10557080875620537230706042704073758083846023406665505070358040403040234240625250601
10007000700000700070402030003020000060003000400020002000400060804020000000300000201
10202785282358506080705080837070334440808830653330386358206240807050872358202638501
10300000000000802000604000400050000070500060000020006000005000300040006000305000001
10634668787840505563303767204285605070445066256030322060224070475886568072506026341
10300000500000600000700000002000506000204000000030500040200080300000007000008000001
10407056403084666440838682588640202357606086442770205358204575504555507720447253701
10405080007000800080700000000000702000005000200020800060004000308000800030007000401
10707330808660406050402055372574804050782245204040586020526030452020306053358040301
10300000206000707000507000000000600060300000003040008050000080008040408000600040201
10552452235068406266207226873820302080504263778674608045768464505760203340705774301
10000000003030002000005000800050808050800060000000002000005000600000705000700000401
10682443304420748025787020707640502830842050503275843652708060382328856040773730501
10700000506000600020002050400050300060003000804000000070200030800000000080004000401
10204030307024505530705360302060456024503032526036344080303530607022523050205068201
10006020803000006000500000304000600070208000300080000030200020008000006070406000501
12734380203457375060678454702838308860202550208320466270638263257627608026707030301
10000030807000000060500000404030004000300030800030000060400000300020008030008020001
10753050303040325830708430803050677043352032504030245030805240607060374540704048781
10007070606050006030002000800020000050003000504050408000806050004070200000207000001
10805550208070308050685022875823746680506440544030406027804083845050707627706575401
10700000704060803060008020000000000000400080000020002000703000006030508000007000501
10278333803030704030608020508722435433357053746042742360803778807065607036226030601
10005000005070300070206000200000000020004000007050005000304000002000007000007050401
17523058556060442550503022527443386040802364406030438040304047652022322025605040801
10000020000080200050305000002000300070700030702060000070700070003000006000600080401
10552430405380468050403874305080804230704020503223288840438220204736407243834435501
10500000700050000020700000304020300000603000605000000050300020400000800060007000001
10304082745086256880667370262030505447603222507060652060502020483230705060503084221
10006000308060000080008020004030400030004000800070500020305050005000404000608000001
10363630304050504070403080707350335080362060757840603872408076252073704043204830201
10002020003000708080700030600000600040000060700050800000008000300030004000400060301
10507080664784202054568745302032553440737520508080573334632780302387352060765082301
10307040006000205000000000802000800020300000406060000000000040008000008020007000801
10804068847060303567865780202624607077202328305020288777623056626364605750302570401
10206000005020506000000000300060004000407000305050600030008000600000500040200050401
15403467305037304078725645842040304370875070206052306040204230306430404060328030601
10005000004000008000600000400040200030004070006000503000300050208000305060400060701
10744088708773405540306670272740572083408072755570604028648660608035537077202340201
10003000600000800050400040007000602050003000800050304000200000405000006050007000401
10207630207330578670846055806030404070406580303040205860805867507052802080836054801
10700000700020800070004000300030400070707000604000505000605000605000806070005000401
10687252536320207056206030443770576420203065206083504322803080402223402028568450701
10000050000060602050003060500020004000404080006000600000004070002000005000000000601
15633080577048305084273540402085204024722040843235536643287030575075544432724835801
10000060007000003000000000705000004000000060000000000000000060007000000000000000001
11111111111111111111111111111111111111111111111111111111111111111111111111111111111
