11111111111111111111111111111111111111111111111111111111111111111111111111111111111
10800000000020000000700000002000000000700000002000006000000040000000000080000000001
10305037422030263048802038204784603460202057203056702332505053845020264070687572501
10003000008020700040003000600000007000806000800070600000006000000040007000800000601
10473856805035407880702220204828288436203320607780802336872457673826804888205067801
10000020405000500000700060307000002000007000803000400000000070000000204000502080001
10787020408570487657305760802050306057348027544026852075727060207560808020703050241
10006000400030000000305000402070400030005000000020007000007000207000600070006050001
10703524838075848650662052552070484630503542464254807070707764362060562053584083701
10800000002000000060004000600040000030500000000000403080300080000050002060000040001
10448276202378825068706750405366732070207065872260704087525020288658307040836360301
10000000700000003000400000600030003000207000500070202000003020002080008060003000301
10608560606446608340688827548080563270806244604070206022407057603020686054404052301
10400080200000407080000000000030000040800000207020202000507050005000400040003070201
10565330228446404020327475253244564080626520303030203470608060774677605020768060501
10004000400050003030000070006000000070000020707000400020206080700020006060800040001
13406026406050306080322020448020568437776050804442272030505040224030252540608763871
10804000507000206080006000500050000020000050200000000050704020006000400000805000001
10205040203223786082205474202034222680808250558454877278408023506432407034805080801
10004070200000007030600000304040007000800050300000200000003040003000304000400050401
10505050687043302020574850806050306055743070703460603545656050704080802040702864401
10208040003000500070000000405030200040000050600060004000600060707050307030606000501
10437045302280755826252354603480573237835830373057703040702840807050505420524060801
10005050005000600000000000500080000000600000407000608070404000604080200040600070001
10408030345554305276286540237022303870604464208040367030777087572074742070703888441
10803030000000603000000060005000300080700000007070700080000070008000000060407060001
10502072227580708060882068202580446020255664667750405648224560405240675660306050201
10204070000030004050006020800000800050700000004000600000000000500060000050305000301
12205030846026684070804060606244803460604082506047464534785733242060656070704755601
10004000204000005050303030600000400050007000507000000000000020003050008070300080001
10823376203040603080208070607566408028728830202475206433253050804035802030205040701
10000000006060800070406030707000803030006000200000600080004080400030005070608000501
10457774643030446530307060844040403020787044357540508080506050808840627050478744741
10000000200070004000304040008060608070000060007000607000302070502030006080000000001
18543436803056703033606060505350307080875330203053482445707060602047285052675637501
10000040006060002000606040308000203020007000407000002060006040605060000040000000201
10277020858450327670406073305084425024883043306873708020826050806080547570884880801
10003000500000500030507040003060000080008000500050007000700060802070000000600000501
10505442338836303060202020445050447580807220655270835727308430303040524453604552601
10300000000000804000408000200050000070200030000020008000006000300050002000305000001
10832236758850304786505648503344805050253042742050544050825070457667386053803078461
10600000700000500000400000003000306000507000000070700050600040400000006000008000001
10503074406052864530376732772580803835407052377750804334408273406838408480283578301
10403060006000200030200000000000404000005000800070200070003000302000500020005000401
10307620407820702030202045267823406040723345207060354020468060487040303038224070201
10800000508000704000602000000000600060200000003050008080000030002060204000400060201
10366646484032203333503888226560606080305522472883802077487654308750802680508233801
10000000008060005000006000300070606060200080000000007000006000700000706000300000201
10323264707250222025586050403840708320533040405627433532302080576437677050576370601
10500000705000500020006060600020400060008000302000000030600050800000000040003000601
10305050505078205660508270305040246067408028683065738050705220402035788070807076701
10002030708000003000600000708000800070804000500080000040600040004000008080604000801
13487770205324287030276535707286206580508640605660556370458654633632304054606040801
10000050507000000040600000403060003000200020300050000030700000400040006050004030001
10632070508080487420202780806020227045462055802020864020708840607080486670605022371
10003030604030004030004000300080000050004000605060807000308070002050500000606000001
10406830606060303050724033254333674760604580634070307087606047567030605774302324701
10600000703080803050006030000000000000700030000050007000606000007080206000007000301
10528643207020707070705030207372543735376043247074325360308877302062404075355040801
10007000008080700030805000600000000080008000006030007000602000006000005000002020501
18684063745020256450204083772825484060207432408050776040203052852056668076608060701
10000070000040400050402000002000700060800080707020000030800040006000007000400070401
10658240208350765050604587207050204540304080703826528870738340203873707244255533801
10600000500020000050400000407070500000308000808000000040600080500000800060008000001
10502046432044423260322770437050702342202652603080236030703050346480407050202086771
10002000508040000070005050005080200080004000500040700050306040003000303000706000001
10232450408050704060305030303850685030788040572320707545704076373058702044608340401
10004060003000708020400070600000500070000050200050600000002000500080005000800060501
10702030532668305023285678707046355230588750508030575425734530705583523050682036301
10502050008000605000000000808000600070700000308040000000000050004000005060003000301
10808033852040402536867660603256606052404857706020286845873068624348305340408260601
10804000008050304000000000200020002000202000508060700060003000200000400040800040301
18506274503028706067482268244030507550684070402062808070605770202650503040357050801
10004000002000002000500000500060300060003060003000507000300030604000602030700030801
10533063308872502550702750468260323056306075557520703025638520305076287044802830301
10008000400000300080800020004000602080004000600040403000700000303000005070005000501
10608530302860485240476047202080806030808470505070607720202483506068303070326054801
10800000700050400020008000200020400020702000404000506000207000308000707050004000801
10274837552840802036407050547830477760504054506078408466403020406385702084568520501
10000050000030403040003040800030003000404050007000600000003040007000006000000000501
18728050328082403032335850202057305085786070387368574574436050285055555758437348301
10000080007000005000000000804000002000000070000000000000000080004000000000000000001
11111111111111111111111111111111111111111111111111111111111111111111111111111111111
