11111111111111111111111111111111111111111111111111111111111111111111111111111111111
10300000000020000000300000002000000000800000006000008000000080000000000060000000001
10308023722020224038207046706437503620406065206026507422508025366080323080844325701
10004000008020600020005000200000007000207000500050300000006000000060008000600000701
10262566202072608360603230803744465526503530705580205736373465884644308587303068601
10000070308000800000500030405000003000002000805000200000000040000000708000803040001
10633060703280668843603820806030306043344023436052637035255070705250305040802080651
10005000400040000000608000303060500030007000000060006000006000406000600050005030001
10808284854084835750546044627040642240706266275233503020505465424020383053587026801
10600000006000000070005000500080000030300000000000705030800030000060008060000080001
10242762405774834054704350607482844060306025222520606052652030853676206060272670801
10000000600000008000500000400030006000206000400080404000007050005040003050008000801
10608230804855704420655788337080272420704786606070502073503045405080242046402073801
10200080500000705050000000000040000070400000604030804000303070007000200080007020401
10773370836856703030737682342586583060726540508060207440602050565636807050746070301
10006000600080006020000070007000000040000060702000700020708050800080006080200080001
12405068702080403070222060733070282464657060303458636030808040288040336850406865761
10707000605000206070008000700060000070000070300000000070307030004000400000304000001
10602060802682373032404822607088342460206840862432788288405078205666703048208030501
10002030600000008050800000702050008000300050500000400000007070007000403000700060801
10805070644057206060656440804060207053843050402320605556225040306060704020304726601
10805050005000700060000000505070800030000050300030008000200070207030207050504000201
10587075206420332746874564305720327234364720283067304030507880306040407460545020301
10002060004000500000000000500030000000500000208000302050505000407050600070200040001
10705050257665407655287870732036302350206528407020457070753032736024566040308772851
10203070000000407000000030004000200070800000003080700070000080007000000030706070001
10305075643760208020747025407640872070876275575370506383637340508660873780202020301
10208070000030002030002050300000800020400000004000600000000000400080000030305000801
17806080364037433060404080302432303350206048505028438726855268536040425030202254301
10003000602000003060306080700000300020002000304000000000000050008050006030200080001
10284355702030602030506040402488407025227360203886808257635040605084708080405070301
10000000004080700060607080606000205070007000200000700020007070500050003070705000601
10374746738030534320704040487030802080323083446730503030704060606250835070766727431
10000000300040005000203050004020707070000070002000702000202020804080005040000000001
16834326606074403073403050307370505030665830407067763356708070406035328088387467601
10000070005030004000403050603000704080003000308000008030006050805080000060000000301
10884040358840673880608066505028852058335044505882506030857020407020737550768540801
10005000200000800030504040002070000050002000300060004000600050503050000000200000501
10604464336877703060207050258030788640406820352260364733807560704050485366404524801
10300000000000504000803000800040000070300050000060005000007000200080006000202000001
10573332448750804725702774202767404020332036365060285080843070245354562033708088851
10600000700000800000800000007000703000308000000070500030600030500000006000008000001
10205054803075857470874324584260404757308033466480404534504278204275308870645872601
10605020004000300050300000000000704000006000500070600080002000204000200040005000201
10307740508320207060402077284323707040255732802050426080487020437030205065543030701
10500000705000508000802000000000500020200000003050006020000020008030202000700040301
10374862447052806436806623563220506040404572684282203076745477602270207750603422301
10000000004030003000006000400050502020800050000000004000005000800000407000400000401
10557343204470886078546030808280806730242060407426424777405040364523248080387750301
10300000807000600080005020600070800030005000707000000060700070600000000080008000801
10306020807057605470305760406080832044808077477047383020803450205074365030205087201
10004050702000007000600000408000400050508000400070000070800040008000004030203000201
17767250504422384050462532706833204470307780407550673780256473774568804044702030701
10000040606000000070600000307040002000400070400020000020500000600040005020008020001
10662070606030846550802470508020326028748072603020425060503450608030647880303057881
10005060802030005040003000700070000040006000305020306000403070005080200000802000001
10805240403060208080284082755863867220808780323040203027502025365030506385607452801
10500000203020208080008060000000000000800040000050003000208000005070405000003000501
10372755806020707040804030808476235626476024874044377870205523604058303032855030301
10005000004060800060607000200000000060004000004070005000508000008000004000002040301
15534054742020547480302042878735327080803487502050248060603027528085682087304050401
10000080000080800060507000002000200020800060306030000080200070007000003000400030201
10563440703320358080508888703030804720605070507834827470456870703382407868564775801
10200000200060000060500000402080800000303000402000000040700080500000400080003000001
10507084555072834430464620453030708225605474502060534070608030484630402030306073461
10006000207060000050007050002070800030003000800080600030703060003000605000205000001
10553640608020503030304050804560635030827040348780303756807032577074802028202520801
10003060008000206070800020200000200060000070300070700000002000800030006000500080701
10502070755354606086527783507035454440637280403020486678246430702564247020447074501
10606070006000204000000000805000500070600000303040000000000070005000008020004000701
10803052654080706625744670408574806083602783706030345637682082372845608370204440501
10204000008020403000000000500080003000203000702050600050007000500000500040400070301
16308476704088206052527842862060706770382030804067404050506450707430202030286040801
10005000005000008000700000300060800040004060007000802000700070508000406040600050201
10787077604478803840802370258340555032506053458720403036872720202052547046703450701
10004000700000400050300060005000203050006000800060406000500000403000006040003000701
10307440406630686360675088204080307020802440507030805720503682406042406030273075201
10200000300040200050006000600020200050707000308000502000204000504000502080004000201
10752734285770508035408040482640458230705058203072506332506030403385702034544720301
10000080000030803070003020700020003000302050005000500000006040006000005000000000301
18847040286072403067822270307045606022836080346673632477453040334053873366766688401
10000060004000007000000000802000006000000030000000000000000040007000000000000000001
11111111111111111111111111111111111111111111111111111111111111111111111111111111111
