11111111111111111111111111111111111111111111111111111111111111111111111111111111111
10000000000000700000000000000040000000004000000000000000600000000000000000000000001
17602553622340585520802242358026703068302350204047603450326060205244427354675873301
10004000000050000040800000003000206000400000402000508000300080506000000000000080001
10507368838020275020725372608880705650882737827560705028606760722080487653226030821
10804000300020204000200000200050402000500020004050204000005020007060000060003040001
10207060504070205422808070587020607052505068802060208332626030505067665870503040701
10600060006030008000008080703030003000007000805000200000500080500020000000300060601
10332085222320638070542030504043866620555480205752488620805462782440824432548040601
10004030000050300050007020002000000050000080403000000020800000000000200000007070601
10304280202082505053802037343278256020373070305020822080755442887522804584806630201
10800080202000003000502000000030000040003030006060007060002000400000803000700040301
10626070303478546880304268322470606454404082823043608058502060402770202050323066301
10008000402000000070600000002000300030004030000030505070002060002000403070003000001
14708322508030302025287257876033536070806080202770407040647040654063366020805374601
10003000700050807000007080003050300060808000800060007070008030002000005040300000601
10638760304880262075302060805030602650305657575886678050207080503472706080635660251
10000000600030002000500020400050008000200000000080000080205040400000500030000050001
10275553304047604472683280486470365050363484864050268733703045457630437774364350201
10000000407000600000006000300070200040500060200030000020006000200000300000000040701
10376530637530857552607085874040808736603050304646443070578240502584302842547065301
10000030200060300000003000000040600000005040003000008030000000405000704000500060001
15238640508070407074585337404267504730822022766034433050663788886080703030806430701
10000000302070406000000000807000400040006000002000008050000050007080002060300050801
10328233203080307387502630535070364027636870702225308083275030706048827060623020841
10200030008000400000600070400040003000000060500000504050000040807000000070500040001
16806050505883863650633340705637408055478046707770506055624350308545337725602063801
10005070307000000050000030207000002000007000402000602000000000500060003000003030001
10733080545072246058222074507040648286605380807072306626607428827020303050763080741
10004000300070007080006000804070000080007030304000507000400080004000500020008080001
10405667203020302050544560574028682080236030842640805060865035503062872735808062201
10200030008060500020000040004040000040800070000020004020700020003000000050008060601
10887030567070347477323050708030434870802654248036758630402480808468685020276060801
10707000700060000000000050302020600040002020002000000020500000608000000080002000801
10403882802088666328837320602040803066448020508065443070446862682066572330704384501
10200070202000000000000080200020002000005000207070006040003000000070000020400000501
10603080506072634384366040803032856540306744204070308087806232578770863050322320501
10504040008000002000007050504060000040800040002000504000300000000060700060000070301
10544080556447703073506020703040572073763050582862205760306233422050503052546030401
10000070005000608000200020702000300070000070000000503000200070000040604000008030601
10883475802066308040747450303332735850507272388730305033247820208244405853254060601
10400000304000004080004000700050000000300070000000305050000000303000006000600020301
10607680205464847826875057347020887755487660657562707020808882807056388060803720201
10003000607000300040008070004050800000000060006050006000300060406000005060300060301
10633034806040408060304020642030602053756057803040207780345050402286607088758020701
10002000800040702000200060002030003020004000005000400020804000703000208000007040601
10503370427460607452246462806088356420608584555444345060503080206030205843204080301
10600060400000400000700070004040000040600000500030006070702050802020300000700080601
10845060307754775640805020542060885050504740206040208040208074305070566450223050201
10003070707000300040305020000040007000806000803040500030404000604070000080003030401
12345030405050405050202026346845807036607048308020854350307830208046823048604040601
10004060806080007060307000400000808000305000302060500070006000403000804000503060601
10302080402060426580302270703470607560206450376060647063285358207440303020704420701
10800070705050004000303000504000704070707060006070004000000000600050206050700050601
10636240605027603036402074404074403060604020607086806363538830705050806070352060801
10500060807020008060006000006000003000607030500060700000000000308020506080007000401
10404050404026635060306686303485763633503060754730808846367825307050403085806246801
10705000807000007040200000400080005000002080000000600000005000002070407000200000501
10607627406844202030806760848020707086353032763730405552743066585030805642854030801
10203000204030007070803000400050705050004000200030804000003030300040500000008040801
10603220803030853060705085208550608060702720605020236057506060603860703346308070201
10307000300030000080805080007000707000700000505070500030008030200000500000606070401
10605078387883747280302076283030702335453438207086403550402060284346223480206620601
10300020005000000000805000000060200000000000703000003000606050000000008000300000701
10362560206030584443504355378477263538224460545787648050408043253283304056257366501
10000000400030400000200000200000300040000030000000008040408000000000408080004000401
10442442234760708520808680706430404040343024274670803030204832462530504067407020701
10000000000060405000200070003000203060800040000050700070300000007060008000008040001
10554840654370303078732023852070388040203880454034327650203678707080625425646044281
10000030007000804000003000300040700070700000700030000000200000707060000020000030001
10845082603055203462304545608257205760734680603340723874728530203063652080833450701
10008000204000508000700000600000808000300020605000700020000030300030000040000020701
18402280707480508060635830486830206050505067705068538020647230375230207428774027601
10006000800050407050000020000060207030304000408000006080600020005000300000004000001
10308048732050608045403048232030803076808240502063205020302048408037756320603736801
10802050004080005000802000006040006000200070008000202050802060007040000080800000501
10274042704087872340604847434022223880826062384680608030808040724020422066243050871
10007000202020000000705030000040005000200020004040705060304050200030600030002040001
13807870408020606586504050833740203080603867307040806050303030578240804230705027201
10007000807020600000200030000000602080400000007000500060008040008020200000805080001
10665057605020803520774628846725607040468586454482627357385088403040305446302450201
10007000004000800040000000000000700050000000000000000000004000007000700000200000201
11111111111111111111111111111111111111111111111111111111111111111111111111111111111
