11111111111111111111111111111111111111111111111111111111111111111111111111111111111
10700000000070000000600000007000000000300000002000007000000060000000000070000000001
10702044783040344035202066305557505760407083503083808376504054485030227050568844201
10007000006050700070005000700000005000807000200020400000003000000030006000300000301
10365333805052605480605220507878488765704640606260606484258454224487504537804084401
10000040506000800000200020507000008000008000603000200000000030000000405000807080001
10676050602620376563704760407050207042826034483073588046823030505750208060203020251
10003000300060000000402000202080800050004000000070006000002000208000600040007030001
10203674862082886830534087854060557770703546233728403070504525472080473028337052701
10200000002000000050006000400060000050600000000000608030500050000030005080000060001
10346682604845664066708870802375662080705074638570806045324070784368707080874370201
10000000800000007000400000300030004000802000400040205000002040002080002080007000301
10406570804755605450248373556070788460503228204030405083505023304020265052804082701
10700080500000505070000000000060000040800000405070505000304040007000600020007020401
10483420744672702080458425485875762080274450806040702760203020326743706040867080801
10008000200060007050000060008000000030000040804000400070504070700030008050700040001
17408056507040306060375040687050733778235070207822528030304030253030877220303827631
10703000502000402080002000600060000060000030800000000070505070003000700000702000001
10507070404226377082606333404032363760702750285655482377806062402653508074504060301
10005080800000006080300000202080006000300040400000800000007060008000608000700050501
10802030425028202020285550702050508038844020408720802538644040603060502030705254301
10705070004000300070000000805060200040000020800050007000200040403050206030702000401
10346048604720434872382725703220436385853460334067507050507360508050408750374060501
10008060008000200000000000300050000000800000604000707030306000507050800040200050001
10203020282454705525385820635052508820708523804060286020757065568035256040205247661
10307060000000805000000040003000500080400000003020200080000050005000000030802060001
10807028863630806070737086405630445030646342878620504883344550502660273550308070701
10604040000080003020006060500000500020300000002000600000000000800070000040403000701
16202060383034634060808070506728805320405065703056422678672467684070345030508633601
10007000508000004030706030300000500020008000604000000000000070005040003070400080001
10362443707050806030508050407536604048665550403236607475663060402033407040404020301
10000000004030700060604030208000806020006000500000400050002070700040006050803000701
10585223346040456720808080675080208020262076545520203080508060303660442020285688371
10000000200040006000703070004030502020000030003000208000205070505020005040000000001
17764644204075203066608040306580205020423330507058642748305050508055637035342228601
10000060006040007000307060504000308060006000808000008070004070403020000080000000201
10675030586630584670705062503078377048446078405467703040252080203070573540633630201
10004000400000400040408030005080000030002000200050006000600020306050000000400000601
10304662876778803020406060227020466650305530352570546735404430707020565285604442501
10600000000000705000206000500040000060700040000060003000004000500030003000605000001
10385538824270308763302536602675802070626028444050636050558020473765356037806072881
10700000200000500000300000003000805000606000000040300040400060500000005000002000001
10503032503028468450583577385780807822704063274260304734507373307585505450434633801
10606040008000800050200000000000308000005000400050200050003000207000300020003000301
10708250303570602020507022268336502070846533403080545070263080476050605054647040501
10700000306000202000204000000000400030300000005030006020000030007030707000700060301
10325437442066804836506525285720604020608728626776204078427744307480608780704488801
10000000008030004000004000400070508040700070000000006000005000200000203000800000301
10844824404780882085445070502850803340787080708425563383806060563575887070334230801
10800000408000400050007030300070200030004000508000000030200040600000000070003000801
10606060703078506480708530604060648056807042757076772020606560307073754070806043601
10004020805000007000800000604000200030606000300030000040500040002000008050807000401
15586330207588577040257256303487204860707670508230526460323286687523505054702080801
10000030204000000070300000205030003000800070500080000050600000500050007030003040001
10844080806020536530204280204030448064553037204060434030804660404060562460504077381
10004030304040007040005000200050000040002000706040805000608070003060300000805000001
10208380608080807040874053752864484260207840666070704083506084467070504363407282501
10300000407040207080008070000000000000700030000060003000508000006040806000007000301
10757738506080604030505070804437864885854045572057243680704387706054608045443080401
10008000003030200080604000700000000040005000006060006000404000005000005000008070701
16724076648040886260807036574664886050503544205050827030403062743034582058403060801
10000040000060500060404000004000500020500030406030000080400060003000004000500030401
10852530408480367040304727705070407230307070302284888680423530403555403727577626501
10300000800070000030600000708020600000705000205000000070200040500000500060005000001
10203032828037878230562420652060804835207757507080527040602080737430206040803077731
10002000808080000020004020006020700060007000500080800030602030008000408000606000001
10376520504080404030703080606240663080867070236870403632404044575022807055805820401
10002030006000202050800050400000600060000050800060500000005000200080004000700080701
10304060622462202056623355506082275770886770406070247853343640407678746080628084301
10707020003000703000000000207000300080800000803020000000000050006000005030002000201
10605032462030202844222670305353402025707376802060724872332057657762503770804670801
10306000006070604000000000400020005000804000705030600080002000400000200020700080201
18803662807046606076225824483060707740632030306032205020802570206650704080746070501
10006000004000006000400000200080700080005030006000607000600020707000802070300050401
10823022204526802680305640448540336043808038555240406088554570203033322044808380501
10003000400000500070600060002000603020005000500040704000500000304000006040002000401
10507840308670348850376076602030504040807750408070608220804273203047202060357023801
10800000300080200070005000800030300080504000807000703000303000202000407040004000301
10633835328720506027806030885340625360607023603042308465707020504437202048367330401
10000060000020204060004040300060007000205050004000300000003030007000002000000000501
18266030856064603058473640208022408073678030827748422222444050857065868557535734601
10000020004000003000000000702000005000000070000000000000000060004000000000000000001
11111111111111111111111111111111111111111111111111111111111111111111111111111111111
