11111111111111111111111111111111111111111111111111111111111111111111111111111111111
10500000000020000000400000007000000000600000005000008000000060000000000050000000001
10406074552020683057505024206685603870307078405032808584603056857070454030452522401
10007000007070600080007000700000008000605000500050800000004000000050007000400000801
10474576807028808650308430404325424282203380507450407233458345385488203657602035401
10000040403000700000300020204000004000003000403000200000000080000000405000602070001
10532060308420454647607440303030503053763033232076528037764070304480407020407080821
10002000700070000000608000705080500050002000000070008000008000603000300060003060001
10404852676044386420333052424050826320406885756464602080307277526030758063778022801
10500000007000000080006000500020000070400000000000807020600040000020002080000030001
10877623204257626088605820303685443040205024336770402064537050825254307070635520701
10000000600000003000400000600040002000503000800050507000002080002060004020006000701
10502720203648504540655373432080734520202834304050606053402067806070627022403056401
10600030300000307050000000000020000040200000608040205000408050002000700060008070601
10832480583426706060875478262827467060488340307070205250702050225824307020774070701
10007000400050005030000050008000000070000030306000700020702060400030007080600080001
18607068706070505070846060827020553556754060503524648070203050234030447280705735641
10502000203000505070005000400060000020000050300000000060504050007000200000607000001
10605050404577543038502235207032677380708360248253248453808022405562502033706080701
10007080200000005070700000504030006000800020300000600000003060005000504000700080201
10804080287077702070784220305080405056752030205560805557372020807050704070807766401
10505080002000500080000000207080800070000040700060008000200080306070808020208000801
10428043703860337244735225603240744685558560677068402060606880303040506250457050301
10003040003000600000000000200080000000500000304000406050302000706060500040400020001
10708040764836207225725360828075408250306278604080647060282045238077446030703377661
10708080000000204000000080002000400060300000005080400040000060004000000050205020001
10204084887730803070554062808680566050828626334260803267565340707560327220804050401
10807080000040007060006080500000300060500000006000700000000000200080000060305000501
18603070587083528050706060502536504660807036407073748657482628643020387020606243501
10004000804000002050604080200000300080003000607000000000000060004080008040200060001
10432776808050607080402020504427504057866220402522603823887070503033406050806050601
10000000004080400020208030604000606080003000600000800060003080300020003080604000501
10658232356050475380606020447030606070877067232360602040404030807860357080846857561
10000000400080007000305030003050504060000080002000605000608040408050008080000000001
13384758302057804072404020407260502080844560204087782583402080407053842064667726601
10000080002030006000408040308000707020007000808000006060004030304060000040000000501
10833040674470438880705054402082837067676062202854805080772060405070852620472620401
10006000200000800050406040008040000020003000800050002000800040203060000000300000301
10408435344276602040806030768020853230503580228420535326607820202030787258804488401
10400000000000605000408000600060000030400060000060007000007000500070002000506000001
10888438335480202544507474204345807050322045758070562020732080383268532087507078751
10700000400000500000300000006000602000708000000060500030500030300000005000004000001
10802068608022464630644627626370308273304033275280603272607426502547402550638255801
10705070008000400080600000000000206000003000600020600060006000802000500030002000201
10406320604480406030403033664785205030244537705080633050328050357030208027572050201
10600000604000608000206000000000500020700000006040002050000030005030208000400040301
10523423747056403227507468858840703080606588666685308045324553404770304250706775401
10000000008050007000002000600070708070300070000000002000002000800000408000300000501
10334372406860763037758030504220208870847080304383854277304020453684864030672350601
10300000604000200080007080600050200060007000208000000060600070800000000020006000301
10805080208087808630703230403030345063406036624036376080406450202026572040403048601
10007060404000002000400000607000300020408000300080000080600050004000007020604000501
14258320504483426040744358705355807830503830305830642370424484582763207042204050601
10000020305000000060700000608080007000300040200070000050300000600020003070003020001
10242020704020642380505850602050377035878085805060265050204660502030684580707036481
10008020502050004040008000400050000060006000303030406000502020007030500000402000001
10408380707050404070638054347246766270604530554060207038708037848070606272607532301
10200000608030203020005080000000000000500030000060003000605000003030704000006000501
10528833308080502030702020305874677877326085483022545570303478802044505073483050801
10006000002060400050307000800000000070002000008020008000702000006000007000003060501
17383087637060564540603083754543787080507768208040745050502026756036364037704020301
10000030000060600070507000002000600040700050402040000030600020007000007000600020601
10268320402460876020802772305040303780608080202875843670228380806328504256223644301
10400000500080000040500000203020800000805000308000000060200080400000700060002000001
10308067763063858780734270823070602842508862404040287070702080365640603030605066771
10008000504020000080004080004080500060003000700050600020603020005000707000505000001
10527350706070407060807030803430663030757020844470705563507054833045702088704460301
10008050002000203040600060800000700030000070300050700000006000500040004000700020301
10608060378375602085746342503047482740725330408020288258877660502565887060784082401
10702020004000804000000000303000800030300000403060000000000080003000007070005000701
10605027368060406888557330205735304043302366802080825538536043846726306770202840301
10708000008020703000000000200060008000405000307020700070003000800000200020800040201
13608635403083406058455526433060603560433030804058502040805640402550508070546060801
10007000005000002000700000400020700080007060004000805000400050707000308030300030801
10552085504887808420707520635660632072504026342740403066867780303078566082505380601
10003000200000800070500040006000502020007000200040408000300000406000008030003000801
10206470306370448520748077207080405020603830805080305670204626205046205040364036701
10200000400030800030004000800050300060407000507000706000207000808000802020006000301
10576665474350308024407020843480437380804085506052306532707040303633202057443850401
10000040000020205050004040700080004000706060006000200000006080003000003000000000501
12276050232077803078227840502052507044736020243523857778453020322036562358683556701
10000080007000003000000000704000007000000030000000000000000060002000000000000000001
11111111111111111111111111111111111111111111111111111111111111111111111111111111111
