11111111111111111111111111111111111111111111111111111111111111111111111111111111111
10000000000000600000000000000070000000008000000000000000500000000000000000000000001
12406627753630328280805776588034705026806730303052608360585040706635223823678862701
10008000000060000040400000006000403000800000705000706000600080605000000000000060001
10808775458080375070432273802570303360757737654350504063704260683050587323743040631
10405000200040607000500000200050705000400020003060206000003020002040000060005080001
10503040507070505365603030342080702052202066206050505747878080604034642760805040201
10800060006030006000004020808070003000004000205000200000500080700030000000800060401
10837043656630845060534040607085284670287270503358462680208676826880225827242050201
10007040000050800020004020002000000020000050502000000040300000000000300000003020401
10602850703062404057307024867834383030344020608050384060432657825667505746505550201
10600070608000007000202000000040000060002070005040004050003000400000404000800060701
10747030505846447780803687552260605637202087326068508073206030507650807080233074201
10002000805000000040300000008000200080007080000030607020006070005000705080007000001
14807725804040803072738265424056327040804050306350604020684050765042442030404635801
10004000200050503000004050008080500050508000700060005050002020003000006070500000401
10755780205440532043806060207050602380402564644735684040408040607288606050433770881
10000000700060005000300030500020007000600000000070000020406030200000300050000040001
10887243502047304236877740742750345080654664554050353634807057643830286448267350301
10000000703000300000008000500040200060600020200080000030004000800000800000000070801
10325480454330652248202066435060704757207060207357657060335760208762403254236052801
10000080600030500000008000000060200000005070004000004020000000404000603000600080001
18434670602080706064688242303375802730533083487055367020445243362030607020707770201
10000000605070407000000000203000300070007000006000003060000070002050003030800030601
10652278206050507643404520648020754066883450308682403068732050802066373050253040521
10400030003000400000700020800080008000000070600000202080000030804000000070500040001
12303050707487248440527540605732806035663084505470707028626750607736368527502042501
10003060502000000040000020602000007000003000305000208000000000500070002000008080001
10275070564046466037454084707040877727302670708024402857503832872060504040744060841
10002000200050003020007000808020000070003050807000202000400080007000700020007080001
10403676507050202060288650482075488020866040858340508040262055804028764455202076501
10600060008020800080000040008070000050400050000040007030400070007000000060004060201
10647040538080235533553080505040483350706562678028566650605560704744623060754020501
10807000400050000000000040206020600040007070006000000050300000302000000070002000801
10307558506034384287353580308070406088848030403037322030528742552066854360807687301
10200060708000000000000020200050005000005000408050007050002000000040000020800000801
10604080707044677272622060206022778640607476502030202032702545276550262060755250501
10205050003000002000002030302020000020400080007000802000800000000070200070000060401
10457040876765804086308040802080367042328030855552404650607527272030704088322020801
10000030007000203000700070204000700050000050000000704000600060000050503000005080301
10638287805066706030654470202757568680303846865470202074632840406454802458566080201
10200000804000004060007000500020000000600040000000606040000000302000004000200030701
10802570505725367522785065548050483575782450458434608050704865708053458050208630601
10003000805000800030005040008060400000000030002060006000800060407000007070700060801
10822047805070303040705080546050606033483047304050605260333020406734607037827050401
10008000500050702000500060006020005050006000008000700020603000502000802000003060401
10506720865650505846722335407033672650805272536728286070406020702060702872207080701
10300020600000500000500040006030000030700000400020007080704060806030800000300030501
10358030603454482480606060445040452060506220703080704080705052802040566470254070601
10002020205000800030804020000060005000603000205040500050402000408040000030008070701
14533050303080306020306073277857702067402065602030387880708270508026338025708030701
10002050403050003080208000400000208000804000603060300050004000407000203000205080601
10303070505040678340607570703250603420706450336080528033652852403760207070607850701
10700080402050002000704000604000502030505020008050004000000000500070704060600060201
10458450802045403037706044203056302040604060303024604746348560506060204060738080801
10400050703020007040004000002000002000705050600060800000000000208060702070002000201
10403020705074755050503587207486726646204020228760306437882372203070703027205227601
10405000607000005050800000500030008000004020000000700000002000006080207000200000701
10204652302566805020806520787040206052264034754370508453286042763060408733522080801
10405000504060006080504000700070304030006000300020202000007050300080600000003040701
10205260708060373060804084503280405060603840806050828042504030205350702757503040301
10508000700060000060507030008000505000700000507080400060008050600000800000802060401
10306035567838544420305035568020703544624648402035506880505030383256473680802220401
10200040007000000000204000000050300000000000205000002000705020000000003000400000301
10428230805020327726602226867744288323333820428276755060308028466428203073782238601
10000000600020200000400000200000500070000060000000006040306000000000807040002000501
10475245777330503340308450806260602060237078747580603040202587346870508085503030701
10000000000050204000300080002000507070500070000080400020500000008060003000006080001
10374360236650403052566038423080673050607740374038737780607774708070532526735053341
10000040008000706000005000500070500070200000200050000000300000408080000080000070001
10435025602087804752803665503673402650827250802550222344763670608066364060388740301
10006000302000306000800000700000307000300050302000300020000050700040000030000020501
16807240208320705030884520374620202040603037704044286020268540535580206825344086701
10004000300080403080000050000080304020606000702000004030700030004000300000008000001
10407088364060605036505087355080603087402640802035806070707083708037457740306273701
10505050008070003000204000007020003000200050004000406040602020007040000020200000601
10437035608028658480402733554055745780575046386630406020506070245030386073534040451
10007000706060000000706070000030002000800070002060704070506060200060300070003030001
16403740604070403345606020285670406070807427604060206030303030838750604370406052301
10005000807020300000600020000000402060200000002000600040003040003040400000706080001
10762073603070803380733452565273407030336657366275854874565085702020307247302680501
10002000002000400070000000000000200050000000000000000000004000006000200000400000601
11111111111111111111111111111111111111111111111111111111111111111111111111111111111
