11111111111111111111111111111111111111111111111111111111111111111111111111111111111
10500000000030000000800000004000000000600000004000006000000060000000000050000000001
10707027473040462065703028404282206760302082304022508867507062735040542060334478401
10005000007030800080004000400000008000302000200040400000004000000040005000700000201
10254588602073303280506230605585482762208730208520803266538866665754304784606087301
10000080602000700000800020607000004000008000508000400000000050000000302000205080001
10263030703830285863705330603070605037522022868083527042368070205850708030704080561
10003000700080000000606000304040600020008000000070005000008000304000700050007020001
10504865563086866420428065884050637370808624288274805080608744884020273062287063701
10600000003000000040002000700050000030600000000000506030600050000080004040000080001
10685387807288748023708830304547256080306056383380803078326020283732405040638730401
10000000200000003000700000600080002000204000200020702000004030002080003030008000601
10202840607645702830483253234070236880207276208040504073707058505020734023208078501
10500040400000704060000000000070000020200000504080804000807030003000500040007030301
10563840334236507030487857343472542030646230603060804720602060426846404020443040201
10002000700020007020000080008000000070000060707000800060406040600050008030700030001
13308086603030407020228080872040264335475080602847866050408070876070833860208858531
10207000306000804020006000400030000040000080800000000020606030004000400000804000001
10406040508277447082606384604047544850405880553826852862804063306258508076303050801
10006030700000008020200000806070005000800050300000200000004030005000702000600070401
10603030427073206040445480605040704074234080207820307848386030507060204040308357801
10305050008000800070000000208060300030000020800050008000400070303030508020203000801
10834082608550248637825588802870226553533680333077607070803620802020703580352020501
10008070002000800000000000600020000000200000702000303030408000603040600070600080001
10208070482463204358263580256046502720503263207030627030428063884065844060202332831
10304070000000205000000030002000500030600000003080500070000040008000000030804080001
10508036277680304030534054706370352030374577254630803838852630308560862870706030701
10203060000030008060004040800000600040300000005000400000000000200080000030802000601
14706050224076547080506060405623808520502076703055845643788348762050335020808732501
10007000604000005050307020400000300080005000602000000000000030006070005080200020001
10834446508070402020302080602744306023623670507525705342768040302044708030603060201
10000000004080200070208020307000705030006000500000800080004080400060007060206000501
10333556366060435460806080682060406020544062746720807070603020206280373040235634551
10000000800020005000205030002030702070000060006000402000804030603070008020000000001
14348635803052204028702040708730302050565220507067875363503070602038837052553725401
10000050005050003000404050406000805030008000202000008080002050305080000080000000501
10745030822420327870303025603082757054842026704344802080674050804070833640883560201
10002000200000800020307080002020000050004000700040005000400080503060000000800000501
10606565383244305070207070634080534870806230524380386727405460203060778232607626201
10600000000000802000807000500050000030800070000080005000008000500020003000302000001
10247782556430303486404524305863602060482084755050553020423070777754854034204078231
10800000200000500000300000005000805000403000000020800030700060300000004000008000001
10502072804077463220852765288340705337207035245680708452506885205642805330452624601
10804030003000200070300000000000203000003000800030300080004000703000700080003000301
10605370704250302070402066283386505060454432208080828030736080623030806077427040301
10400000803000305000808000000000600070200000004070004080000040008060207000200030701
10348287557052406267207382822660803030602842635537508028443273604280705380402628801
10000000002070003000004000200070207030300030000000002000004000600000604000700000801
10654763703780366053722030207720503820423060708536453678808060852262882030852650701
10400000603000500050008050200080200040004000707000000020400070800000000040004000601
10406050807027402450202540406070278022405027878085265040707260606048745060307077401
10008080702000007000300000508000800040706000300020000040800050003000006040407000401
12638430708472553060438226808223703530605670306470744270385862535623206074505050601
10000080507000000080600000405040003000500070200070000060700000400030006040005080001
10378020603020636340406520303030832022225088806070242080204280708040363220608072541
10004070207040004080004000300030000050007000207070205000505080004030300000504000001
10208670502050706020865023877676357320202880823080605077606084766030802584708226401
10600000804040608050006070000000000000700070000080007000508000006060603000008000201
10455272402080404050602020602847455774623034336068524760406576504043808058436050801
10003000008040600060305000800000000040008000003070006000506000002000007000003070701
16743042874020768650703066828685522030203833602030745070508074762024626076807030601
10000070000050700080404000005000400070200060405050000080200020005000002000800070501
10346580202850723040806786403060204460705050406586548740826730806527404382258566301
10800000200050000070800000708080300000308000404000000020300070400000600020004000001
10606038484035428630263860562080605282705567707050754080704060676450707040806072761
10005000208050000070006070005030700070004000700050500080805020006000306000805000001
10645570807070405080302050802750873070323080564680508666308033655084302065204850401
10003030005000203080700080200000500070000080200030200000005000300080005000300030501
10408080722247207056866864504048582260326350508050532585588530602688656040852074701
10803050004000408000000000706000200020300000803050000000000050006000005030005000601
10505088783030702245852830307322808056402874507040337882378022282464403780303780701
10708000007030704000000000800080006000805000605020400020004000800000600030300020301
13306324206036202086863824232020502820278030706084606080604230504820407020527030501
10002000004000008000200000800020200080005060005000402000300080606000307050200050401
10256028407822703320503240856280457075404023324440403054537230603044858035802430701
10006000500000400030300050006000503020008000300050304000700000207000003080006000201
10303580204570464340776038402050704040306270703050408730308248404048506040726023701
10600000200050600060002000400020200050804000507000306000203000207000506080002000501
10765826742750506036805050777480653370307035308073403854502070303658604073737630701
10000040000030407060002020500040007000205040008000800000003080007000004000000000301
13667020658082808052668780202055502053722030287846843472224070346053337684252275201
10000060002000002000000000406000006000000080000000000000000070005000000000000000001
11111111111111111111111111111111111111111111111111111111111111111111111111111111111
