11111111111111111111111111111111111111111111111111111111111111111111111111111111111
10200000000040000000700000003000000000500000002000005000000020000000000030000000001
10707025354060233058207082305237605730507026705082203268302083633060634070724885301
10005000006070400080002000800000006000405000300050800000006000000080006000500000501
10524287305065405360708670702366577764203450708450708865736745342826606384202038501
10000030304000200000800060203000007000004000707000600000000050000000602000508070001
10843040608260838754508620506050307042334056875035226044242060706850802080406080751
10003000700070000000702000702050600020005000000080004000005000608000700050002040001
10302487682054338270645035283080484770403835254747603070507627585040763065745048801
10700000003000000070004000700070000080700000000000705040500080000050002040000080001
10864573306472466024303270603277542080305066875270506075523020658252305080427320401
10000000500000004000500000200080006000203000300060605000007070005080007070006000401
10503770204243606650283583275030778240806566403060204053204075405060682024807073201
10500060200000204070000000000020000060400000307030305000304040005000500030004030501
10785570856277507050443482358322277020385280806030708670303070572567406040288070601
10004000500020003020000020003000000050000060202000500060703070200030002040300020001
13202075504040504050365050285080445826446050504632658070703080448020743340606342381
10402000503000705050006000400050000080000050600000000080506060007000700000605000001
10807050507865732082504253503045728580402740863836758882606067203278708048303070501
10004080700000007030700000507060004000700070200000200000004030008000706000300050701
10403040458035403040733850606070307037225070806430707757235080307040306070706247301
10303020008000800040000000605020200060000060600040004000500060805020502080402000301
10476076306270554367888658208760667672578280632075404050203570708070607720755080201
10007060002000200000000000600020000000200000703000807070603000804080500040500050001
10302040222757403345722840358056206320203333305070437070674062444075526020505654231
10202070000000702000000060002000700020200000003020200040000080006000000030206020001
10703082833830503080525052607320732070354377535870608446857750502630647570802030301
10403060000070002070002030700000300020500000008000400000000000700060000080408000201
12308020522088878040505070808686602360308067605037424283332344788070433030806456601
10008000207000003030804080700000600050008000805000000000000080008050002040600030001
10735228608070605060505030508547308057658530203346505787634020507058405020708060801
10000000008020500060705030702000306080002000500000300070002070300050005040303000601
10223428265030554870702030242030708030326037886560603080602040505240753050247658561
10000000800040006000405020003040602060000080002000404000404050406080008060000000001
17488444505053706073803080206670408030438520208058443573804020206065787084745387201
10000030002050003000406060806000406030006000602000007020005050704030000060000000301
10537080553340443520605076805032833086885033302775806070756040308040548350284570801
10007000700000700070306020002080000070004000600060002000400060203060000000400000201
10706636625383504040308050463060268740408850653660374372403870207040585275702757401
10400000000000408000403000200060000070500080000070003000004000500040008000308000001
10776453372350307252408824807665503060264073662030762050738020527663227023504073531
10600000600000400000500000007000605000707000000070600080200060500000008000008000001
10208083206053622250852774528460207842405064822370807528404424807782502880725775801
10203050005000800020700000000000307000006000500080200050005000508000600080004000301
10707640505850303020302082846264606080363577604080664040884030352070208036853060801
10700000406000505000303000000000500030800000003080004050000080003020707000800080801
10548887773052603282208774745840202030208376263883408054783448308270204760708458501
10000000004060007000003000200020202030700020000000002000008000800000208000500000401
10343856603840583038887070304330606450754080704763378635308070587557573020442430501
10300000202000300040004080500040500050005000804000000070800050800000000030002000501
10405060502085804450303880307040854026707028822046787060802830207032826020708032501
10005080305000005000700000707000700030507000700020000030300060003000007020303000801
17725830508275836020544742602437602820202760704780754630244684356767202063305030501
10000070802000000060600000504020003000300040800020000050600000600070003040004020001
10824040806050345670302540806060274068626065306080322070606230305060654530507038431
10004020507040005060003000600020000080007000304070203000803080002040500000204000001
10606280503070804030477053866828528880805360582070504073703085347020407648707532801
10400000308020303040007060000000000000300070000030007000804000007040604000007000301
10778868606080808070207060808537582683537064785042355260203234405082206053774070201
10002000005020200060408000300000000030006000003050008000402000002000002000007030601
15773035226030233540807074588727685030503434505020536040206038468035284054707050501
10000030000060300040307000006000800040200020204070000030700030005000006000800050601
10832350403440523080608434606080502540808050402247328550227730202374807386845584701
10300000200040000080400000303080500000705000603000000060200080200000600020005000001
10603055728078666760665850726070707252402877606070472080604040576630608020408037751
10008000603070000030003040006080400070006000400070800070705080008000302000608000001
10448260603080607020704080404360347040778070366840307626502067843085802036404380601
10002080007000708030600070200000300020000040500050200000004000500080002000700030301
10305030757642505062486738202053874550543650202070277275772260308573823060735073601
10505080007000808000000000703000700030700000203040000000000080007000008050003000201
10807052724030608265628780207656303037508348505080246666733043666285607250405240501
10803000003070203000000000700020004000404000604060300040008000700000800030700060201
12504256407025503064643423888020303440348070204056604060307820302760604080648050401
10005000002000006000700000500070400050004020002000303000400050405000407080700020501
10282062505836607880506320856220744027205022764440707032274370308046222058507540601
10006000500000500070800070008000602020004000600050607000600000603000006080002000401
10705820303750763550765065807070507070208430803070307540707728308075206060225046601
10600000200080400070002000500040500050603000404000604000802000803000603060003000701
10365483236730703072708040457470373240303088808043304548306070405587406075834760801
10000060000060706020002020500070004000807020008000400000004070007000007000000000701
18374070477024504082334240302038604025628030683282553688456060455066434358636453401
10000080006000003000000000504000005000000080000000000000000020002000000000000000001
11111111111111111111111111111111111111111111111111111111111111111111111111111111111
