11111111111111111111111111111111111111111111111111111111111111111111111111111111111
10700000000060000000700000006000000000300000002000003000000040000000000040000000001
10602027572080323033803072204253405730205035508084506562602077767070262070337224501
10005000007020400040003000500000005000506000200060400000004000000020003000600000701
10338456702075806830507650407563574343303750403350502664452686728845204854208084401
10000070404000700000600030303000002000004000508000500000000050000000403000403030001
10782050402230476488307240807030808044848065257055767084727060706340208060808060431
10005000200060000000307000305020400050005000000080003000004000704000600050003050001
10507323364088488820368047576030282640405488327333405030306645567020672052462058201
10600000006000000050008000600080000030300000000000308080800060000060002070000020001
10775767306354778074805430503667768070607067577220205065654080338348202060327550501
10000000800000006000700000700060007000406000700020402000008080007020008040008000301
10803620606862406560756843534030824750308762304020507027502073404070387044305047201
10600050700000303060000000000080000060200000203080402000406080005000500050005080601
10837460836632305070782644674733385070568880404060502740305080645527206040448040301
10004000300020002020000060008000000030000070807000400060506020400060003060500030001
14802085705060608030347080352050288258685030502843652060704020887070477330403244731
10602000503000303020002000200070000030000030500000000040207060004000600000603000001
10607050402773752038208286403053626370607270336274757645205038506573306048507070501
10002020400000003030200000602070004000400070400000400000006020006000506000600050501
10403080625078306040636270204030202052262040408330703628734070602020804030602555501
10706050005000200070000000602070600020000050200050004000800030805040305040402000801
10222034708820623222826375802260887448623480824086806080207220705030602460346060601
10006080008000400000000000200070000000500000303000602070303000704020600040600020001
10502050244574803752745250557044703340304363408060667020246046227054264040702462251
10704070000000205000000060004000700030700000007050600050000030008000000070503050001
10403062443820805050744067603660533020636865343770303622282760402450533350505050401
10806050000060005060003080500000700040200000006000600000000000400040000030808000401
14604060777052478030402020404577203780805065207088383672543784837080776030504358301
10005000507000002080206050800000500030005000405000000000000080007060003060400060001
10745244807030807040707060605787808073225580302362606683327070607084204050603030801
10000000004080600070207030304000606020002000500000400080006030700070002020607000401
10642476687040242450406070752040208030527074353770406060603030404420277060376474221
10000000200070008000707030005020504050000030003000203000807020307020007030000000001
16256852305064406036207070607340206050385720405072777577402020805084726074244757201
10000070004070006000802020605000202060008000305000004040006030507060000080000000601
10888020487570262850308028303074845047536063808835705050554030708020436560676880601
10002000200000300030604070007040000060007000300060003000700050204040000000200000301
10506766873244707030703070825060836640304420855860456286404240507020726856406784201
10700000000000705000704000300080000060600060000070007000005000500040007000303000001
10353545463330804487306875402365207020756066866070665080238040524645276075802073381
10700000600000200000800000004000606000205000000070700040500070700000005000003000001
10407075703022564330344248465770803867802057567750704572203642307656403460688435801
10804080005000300050200000000000408000008000600070800020006000502000800040004000601
10204330407760707020702025352657202020455332407040834020776050354030802023455060701
10300000704000407000207000000000400080300000007040007080000060006030408000700030401
10874672434033404476208444352280305030405672862787508045536734808730804860802836601
10000000004020006000006000400060304060800030000000002000004000800000206000700000301
10327627706440842062333080208560202530845020407237855242704080545674552080888250801
10600000808000800060005060400020700040008000707000000040600070500000000050006000601
10705070704037203480203240807080473044204037358038578030304280602055288070704087801
10008030704000006000600000508000400020807000400030000020200080004000008070407000401
16324660804544252070264638707422205250806750404670783780286332788478202067704020401
10000050405000000070800000806080005000200070400040000060700000400060007080008020001
10533020304080346280302470706030248067384073402060627060608680408030435860305068851
10006060303080002070004000600080000070002000508040602000303060007040300000204000001
10608440208050408050647024855872775760708430245030403022208052547060203234808288601
10300000805020804080004030000000000000300030000050003000505000002040202000008000801
10377785403050604030605020205848682253485032737082442550702347608073804052767040401
10007000002030400060307000600000000060007000005060007000402000007000008000004070301
16524085258070326680703057755428763080606358804020348070502068237087854045706050701
10000080000030300080304000004000200040600020605080000070400030002000008000500070501
10625720508830224040206782406070805720706030208486532640686540506374602856326453501
10500000800070000080800000708060200000302000305000000020200080700000300050005000001
10202042663073672760382770876020606748306425304060465050607030868550702040403088351
10007000806080000050006040006020300040004000400070600070407030005000506000402000001
10282440202020504060702070606440465070644060342630808668706066834048806053208680501
10005070005000208020400020200000300070000060300080800000002000200040006000500020701
10307060756765803024655236408067826680668540605020752657776340305474465020734056201
10706070002000307000000000303000500020500000407020000000000070008000008020002000601
10508056823060503754827230708858303065405272403060786285387045523832503370706620401
10503000004040603000000000800080005000403000307070300050003000800000700080200040801
14605756405066707054553757436070807580863030302078203040707520702730807050262040601
10004000007000006000500000600080600040004040004000606000300030608000408070300050401
10265063708557205740605450745260587048203087488880603042438380503046663058606260501
10003000500000600080700070002000402060006000600070605000700000706000002050003000801
10706480808250242670832074202030502040207320702040308740607724202053605020727024301
10300000200030500080006000800060700060405000206000504000404000708000603020004000601
10855677686430808056708030462750654850607026208046804547208060302875605065764470801
10000070000070507020008060300020004000808020005000400000005020007000003000000000801
14635060845077203047356420305063307044685060636684875376574020684053444482382662201
10000070004000007000000000803000002000000070000000000000000030002000000000000000001
11111111111111111111111111111111111111111111111111111111111111111111111111111111111
