11111111111111111111111111111111111111111111111111111111111111111111111111111111111
10600000000020000000800000002000000000500000003000003000000030000000000070000000001
10702072547030862077202084205444602630206043404064406587208058688070876070847585501
10003000004060300020003000400000006000806000700070200000007000000060006000300000201
10462382703072703340305750706343787428204240302360307858338373577464702688207052301
10000070503000300000300050702000004000002000208000700000000070000000605000604070001
10455030702560283632604230206050507083522056425046858072432070206370506060806020261
10002000200060000000503000605070600050005000000070008000004000607000600020004020001
10602422356072826850684024855070348830404377754846604070504576447030682064858035301
10400000008000000020005000600080000050800000000000202040300030000080005020000060001
10356737302372658027706740608374244050203043428740705033543070586358608040268880801
10000000300000005000400000300060007000505000200070806000003080006080006040003000701
10602660604264604520276867876030443550706444404080707046307045805040322078603022601
10500020700000502030000000000060000070800000408070304000607030008000300020008030401
10365430742236804050746426886227553040674780302070508260306030833573807040625070301
10006000700070006070000030002000000070000050206000700080606020400050007020700040001
13304036407020302020423070535040572665543070603458858060705040662030553720302782321
10205000202000603050005000800030000050000050200000000020703050005000500000304000001
10607040804687786074806447404043623360402630442365233444506086208552207084607060801
10006030400000008030300000605030005000200070600000500000006030005000608000400040501
10706020553056608020482350203030704047556080805670304434778070503070805020302734601
10202040004000400040000000508040800030000040600070002000400030804020205020803000501
10628073203850467724845788506370544284465530443072403040706350203060408650583080701
10004050003000400000000000300070000000700000504000807040805000303040700020800070001
10208030378424405656344230864066404760607768602080883070686064858036523040702752571
10705060000000307000000060002000300040300000008050200030000050006000000060403050001
10806023585850403050645032807220873050873678275480805284364240302660886820203060801
10404070000080006040004040400000800030400000003000800000000000600080000020307000401
18806050423047364070808040707572407520307064406046455563345458257080436030802285201
10007000605000006070806020500000700020002000406000000000000020002060008040800020001
10744445703070606080602070805687507042667450503273506233368070306057205040205080501
10000000007030200060407080808000202030008000600000700030002020600080007050302000601
10748527782020326260203060378060608050478074463350406050308050407860348050852425481
10000000400050002000407020003050807080000020005000502000402070702070002050000000001
16635366305057303088204050708250206040324450404056626835405040804032452052673277201
10000050003030005000407060203000307040008000306000006060003050706040000040000000501
10852060384360444560804023708063357032683046402538804020883060203040388220724760201
10007000700000600080206020005030000050006000400070008000500040207030000000300000801
10703347327755803050404060632060888830702820745450384374302720202040464572304525701
10600000000000805000608000700050000050300060000020004000008000600050008000606000001
10773276344570808286304846703363405020823047568030742070583080455376488087604053421
10700000800000500000500000007000302000802000000040500070600070200000005000003000001
10805066305056337680324645633550705652806034223530606832503326705242805870246254501
10708070006000300030800000000000608000008000300020800030003000208000500070004000401
10202420808260404080302027375264703030435355408020667020873080882080502045286040701
10200000307000503000308000000000500050800000008080006060000030002020307000500030201
10253733688058704622605886435760703040608244752264802062836274303880708270505238201
10000000002020007000003000500040308020800080000000007000004000800000302000300000301
10634735506870586048853060806880503840622020607342436857408030466438368060466220501
10400000808000300040006020200040500060002000506000000030200020700000000080007000301
10603030203036507380807550802030344078305063588045775060704330203024438030203054601
10008050207000006000700000507000500040803000800040000080600060005000002070504000801
12445770606357246080884234507733704560305850605840675320267843352723503038608070501
10000070406000000070200000608060006000500040500040000080400000200040007040004070001
10726050303040783680603720707070636075436054805050657030305550803050524830304023841
10006040607050003080004000500050000040002000202040306000604060007040800000306000001
10304220604030403050567048467536343640605550762070307055504042253040706422207835701
10500000803030208030008060000000000000500030000030008000707000008050607000005000501
10234685706080306030208050506858724563777043365082437740307582205086704038566080501
10003000003080800030606000200000000060007000005070006000402000006000007000005060701
16755042753060233270408077222577633080408467702070626020308055532035446035503070801
10000070000020700050802000007000200060200050403030000020600050005000003000700070401
10537570402340343070302784808030604660607050603638463740242720808577403372643554301
10700000600060000060800000708030200000306000502000000060300080800000500070002000001
10706086456027737720442630382050608648605854802030787020207060645660204040208034871
10004000708050000080002030003060400020006000500040200060604070003000803000807000001
10763450402050606050504030608580878030864080888570303448504027564083702054306650201
10007030003000408050700050200000300030000020500070300000006000500060004000800060401
10404020674767806048773724803072287480467570706060656648823240404534766060682053601
10802050005000302000000000302000600020200000604040000000000080008000008030002000401
10603025687070804373652380208576505086504553307040683276784078648233308550706870401
10508000004070206000000000700070002000306000708080600040005000800000800060200050501
12806688807054403045243636284080305230723050607082704050705530308520404020367080701
10002000003000005000300000700020200050005080005000407000400050706000808060300020501
10755075408566406580702850633820658024206083736420506037663620504052344067405670201
10003000200000500060300020008000304030008000300080402000300000506000006020006000801
10606480306760835450837038804060305080606530403050806870207757802044507040747035201
10200000600080400050003000700080600030206000702000202000507000303000402080006000701
10555322353550504087305030456320345470605044506033504432208030207677505042427820601
10000080000040405070005040400020006000502040006000500000005080008000002000000000701
12345040543026202046437240302057606074456020274235646223644050648083225486224345401
10000030006000008000000000306000005000000040000000000000000040004000000000000000001
11111111111111111111111111111111111111111111111111111111111111111111111111111111111
