11111111111111111111111111111111111111111111111111111111111111111111111111111111111
10500000000040000000800000008000000000800000002000003000000050000000000020000000001
10806024364030762083503067804473707370202083505053706785205047764050346020786337701
10002000003020700060008000700000004000508000600080200000004000000020007000200000701
10243662502033704730607250208727575363202760705220605274483332773265604333203078201
10000030204000600000800070502000008000002000202000500000000030000000506000402080001
10873070404320324344605450603050804067526088442042236035865030505870505040304070871
10004000500050000000407000504040300020002000000020002000007000605000500050003030001
10408585764058337240744066753040276360808684435764704080203324374080467078473037201
10700000004000000040004000600020000040300000000000505040300040000020006080000060001
10774443608748855033506870404847543060706064685830502073544050855378507030752780201
10000000600000006000700000600070006000605000600020407000004050004070002070007000201
10508580504385206260764582526080674320608838204050808035807033607050348036708027201
10700070500000508070000000000080000030400000808050307000308080002000400020002040201
10545470868578505050436528436656754020235870602020606680705020424548505080857020201
10004000300040004060000080002000000030000040804000200070804050200050008050700030001
17506052606060504020627070232040586748782040807328787020808080286080268220706786241
10707000502000508030008000500050000080000020600000000080502040003000600000804000001
10505040808748585063204577608063375540308480244444467244406077607842206053508050201
10002030800000005080500000407030004000200040300000200000007020008000604000600080801
10506030564076207040283780802060807087438030508870303246235020407050808020403377301
10703060006000600060000000403030400040000030300070002000800020806020205070207000701
10268078508760556753865642305250367473472760858085405020203620208020407350855030601
10008080008000500000000000200030000000200000204000808060502000502080300020800040001
10507040682737504834267530336055403870607333202020582080868056266047852050308376231
10607030000000703000000030003000300030200000003040500020000020006000000040407040001
10806047374880507030672042603640755030237487277240705422878770603320564620605040301
10504060000020008080004040700000400080600000005000300000000000300080000050305000801
13402040478033882070407050506643207560203064507065627662545854563020356030305364501
10003000506000005050406060500000300080003000603000000000000030003080005060500040001
10355257703030408020303060604647703058856460806375702246582020608072403030407070701
10000000002020400070408030804000504080004000400000200030005050600060002070202000801
10547845637060544470406020377050803040533022586720303060206050407420372040337256741
10000000400050007000807050008040808080000060005000607000405070305060005040000000001
14675776508084808075703060206840603030333320605054676857304060708076886056568847501
10000060006030003000205030604000408040002000705000003050008080608070000080000000501
10575060883630448270403034308064738043454035405753805050534030702030887660342580201
10004000400000700040502060005040000060006000500020003000400020806080000000400000501
10405378575336602050203050267020578750702260456680724573307350808060382883608855601
10600000000000207000403000400020000020800060000080004000003000800020008000705000001
10342557288240808652803652505368702040678035746050263080368060353785576028405064861
10600000700000700000500000007000705000208000000020300070500080300000003000003000001
10808082805025742530784675658730303673303052822350808456507562507564403350384328301
10202040004000400080300000000000708000005000800060500040003000305000400080008000801
10606540304360405070802035623552508080583688807080472050765040585060808026462080801
10600000802000503000606000000000500020200000008050004080000080003020507000600060201
10326267634024205446203225227440204070302525384466406027833432802750404360608477201
10000000006030006000002000800040703070600040000000007000002000700000802000700000801
10846888507670227075255030504380308480458020705577275835208070365843222050637860601
10500000307000300080006060800060800050005000302000000070600040600000000030003000401
10804020608046705550502750506050453074305057562057787060408570705025522060308038801
10003050603000008000200000602000700030704000200030000070500040005000004030302000801
16644880606845877070256536705428205740603270404380426840877873444284204072804080601
10000070405000000070800000702040005000400070300040000060800000800050005060003080001
10684060503080587270207730606040448062333088308050666050502830308070337840706065231
10005070703070003020007000400020000030004000505050802000507040004050400000408000001
10308330602050506050445073327278646620302660684030207075407047336050404387405822301
10400000605080502070006080000000000000600030000040003000802000008050708000006000201
10448364507070304040708050806573344543763073263073853850206778302078706027642060501
10008000005040200030502000200000000060005000005020003000706000004000003000007080201
17357064374020465520804067775656736070708534806060487030806028556056875025705040301
10000030000040200030307000002000800080300050408020000040200070005000008000400040501
10427240403640224020405746406060503650304030702832284520664830704253606282355224301
10800000400030000060300000508050700000205000508000000070200080300000200040006000001
10504054862066276670742620723040602783802355704060762060807040626820308050205052631
10005000403080000070007070007080300070004000500040200030802040003000803000505000001
10464430708070604040204030802520838020554020666280204235608055374057807078202840201
10002040007000806030400020300000600050000070700070700000005000500020005000200020801
10505030336728406038848626803055462760232380604060477383524850207583744070444065401
10808040008000805000000000602000400020200000208040000000000070004000005020008000401
10306034736020504633734670604545402044708382804070663383583086428883803850805650801
10303000004050804000000000700030003000505000507020600030007000500000500060200060801
15806552403065406064522887545050605230648070208035504030707750205450207030375070201
10006000008000008000300000400020400080007040007000704000400030403000407020700080201
10363035203562508860202780328450637083803024873470205087362560306077387083605430201
10008000400000700030700060008000207030008000700070508000700000308000008030005000201
10607520303420675250583074603050708040204550703080605230608784806055507050473028401
10300000500020400030005000400050400050607000806000806000604000207000507020004000301
10485565237670407073302040354240226730808026207048406688407060508235306052835220801
10000030000070606080003080700040007000805040004000400000003040004000008000000000601
12427060686052303033532540303054203023745080635784742335727080643085444332888846701
10000030003000002000000000505000003000000070000000000000000080008000000000000000001
11111111111111111111111111111111111111111111111111111111111111111111111111111111111
