11111111111111111111111111111111111111111111111111111111111111111111111111111111111
10000000000000300000000000000060000000002000000000000000400000000000000000000000001
14402642748580528550307846486028206064406660503084205720786040302474258326328436601
10008000000020000070300000006000303000400000807000204000600070802000000000000040001
10608655632050268050624786506320805380255545367540603087303250778030372422466040481
10808000500050704000700000700030502000200030007080505000003040003030000050008020001
10205040307080804684502030836080505064205066604080404544544020502024678620606070801
10700080005040005000007020708050003000005000608000800000600060200050000000600080701
10284073783860447030772020506037274670277650607523687340303272225640885586488070301
10007080000080500070003050007000000020000060708000000040700000000000400000007020501
10203320207047204075307045373427228040735070202060255020423733334662208763808620201
10300080804000004000404000000040000050002050006080003040006000300000506000400080601
10384020208827867640608486265440502646303088556075205063503030707480403040268073601
10002000605000000070600000007000700060003040000080307070004040008000607040007000001
17606543207060304023888667657088468070804070603440807070685040223082375050405786301
10005000500070606000008080002030300020404000200060004080005050004000005050700000401
10737530708780787058808020408020604320707432753585884030703080405473205080584820761
10000000800030006000400020400050002000800000000030000060602060600000200030000060001
10836844603044504665577330744280336040665222686050587776608027723240226453557780401
10000000604000800000008000800060600030500040500080000080003000200000700000000060301
10475840736470747356406065836030506287208040305744776080458730704482507448877048501
10000080800060600000002000000080600000006040002000004030000000703000407000500040001
15732850505070508038476633303755808740862067638063755040435267254020405040608650801
10000000203020305000000000802000400060008000007000005040000080002080002030200040501
10776372307060408544408750753020278085742530203385307045763040807036852060463030631
10500040008000500000200060800040007000000040700000503080000020408000000020300060001
15808030602237275450842260507272708077742056304460703046667570804552524766603026301
10003050705000000030000040808000004000005000508000403000000000700030006000002020001
10585030424055358084788028805020747323505250203077603268308262485040508050323030451
10008000500070006070002000606030000070008030406000508000700020008000700020006070001
10202584802040708050673430236048247070322030377860307030277055302048485388303022201
10800070005060800070000060003030000020500050000070007030200080005000000060007030401
10558080255060477778422070204040654730607235287068332870507540404387826070525050401
10402000700020000000000020504040400020006080005000000080700000205000000060004000801
10304247607034536567853640506020804025234070602023363020356365724043357430607838701
10800060406000000000000030800020004000002000704040004020005000000020000070400000201
10308040305043588663836040507028838570204735503020506066303238763220227070824680301
10702070006000005000005020304070000060800060007000205000600000000080800050000080401
10756060656722408053703070602050277064332040856442203250206447533050602073263040501
10000030007000707000400050208000700060000020000000704000400020000050708000002050801
10783546205063807040227330302276644740602742774860806046536760707628402236365060601
10300000307000008080004000400030000000800030000000608030000000508000005000700050701
10708560804223367578455025543040528387843550575565702070608754704028574040403840801
10004000704000300060008050007050300000000020004060008000200030605000005020200070301
10246073606040805080802080755060506072722047803070207230842040803425504032472050801
10007000300030805000800020004070003060007000007000200030603000508000208000005050501
10408430625260308345465225706066836860203222757663588030306020607070505324404060701
10500050500000300000600060004020000060800000300080002040207030604060600000500080401
10687030207875264650207070237050664050808250607070605080703035308020452340758020401
10003070602000400060705080000050002000806000707060800050305000402040000070006030401
18457070408020204070607057638722306023306082406080737550603240306034682083804020501
10004060205030004020407000600000204000604000208050800030007000603000607000607040501
10707030808030745260205660406350706370805850832060873058347278207570206080702480401
10200050404060007000405000405000806020302060005050007000000000700060307080400020601
10545650806085507072706086508025504070808080302036808277472880804050204050663080701
10400040603080002020007000007000005000307030200030700000000000402080703070004000701
10504060305085627060604375807222357466708040532430506472345743302030807028506456201
10502000306000005040800000800070008000008050000000400000002000003070605000400000501
10708326402838206030407380756070502036732064752430305253642076253060606675585060601
10704000806060002030308000500040706020003000200060206000007050500080200000007080801
10606230405080424020306056807460603070207420408080356028607070502780704223605080201
10806000600030000060207060003000206000500000804060600020008050500000800000204040701
10803076555782648670505083335050507726256275804072404420204070448652848530704570601
10400050008000000000208000000030300000000000602000008000308070000000007000500000501
10273740408080336824602758582863247472824350357728263080608083855758706023485446701
10000000700080200000300000500000500020000060000000004040704000000000606050007000501
10564668775730704540203380308320605080823025826430502070504755577360406066202070201
10000000000070508000300040004000508050800070000050600080700000004020006000006040001
10587380767560706045726043782020778020406440258082732230203328707030673622433038371
10000060006000208000002000300070800020700000300070000000300000304040000030000080001
10746067405036704587803523503225306560745550608740745542282470405063725040884430501
10002000702000805000500000700000806000500080602000300050000030800040000030000060601
16504680203440305080338320342850408040206087202042575080248870246440604366884054301
10007000500030703060000080000020402050406000505000005080700080002000200000003000001
10603075323020306042403063437060705028304660508057407060603045703023858850303545601
10406070003040003000204000007040006000700050006000402070605020005030000070600000801
10584032805036882870407575237025582840456042333380606070803050785020282057365070661
10005000504080000000602080000050002000700030005070308030303070400030500070006030001
15508270403080708572308040335260506030405858203080208070705020566840805420505043801
10007000405040800000300080000000604080700000007000700030006060004020700000505080001
10256088506040307560543443387665304030628624856846253745338077206020307387704630501
10002000005000600060000000000000500060000000000000000000005000008000300000600000701
11111111111111111111111111111111111111111111111111111111111111111111111111111111111
