11111111111111111111111111111111111111111111111111111111111111111111111111111111111
10500000000050000000800000008000000000500000004000008000000020000000000020000000001
10805023227070677066708023802333202730304024407053403838407085626020354030435483201
10002000006050200020007000400000007000704000600040400000006000000020006000200000501
10625544705028706880605630703254323272508480306830406222274438746633704443305033801
10000070302000700000600040602000004000007000603000600000000030000000702000402050001
10753080604530358656306840703060706036823043667043245056543020507520702060706070781
10007000400020000000707000502060500060005000000030002000008000205000300040007040001
10304536768054778550386056552060348450202874838772305040608826264060667068746024301
10500000003000000060005000300040000070800000000000604060200030000080007080000080001
10843352505755433032703260705227437020408064758840502046262050746735403070586260601
10000000300000007000300000400050007000305000800070607000003070005030008080005000401
10302420805677806220666534422070644350407555203070202025808084808020738064303064801
10500040500000606020000000000060000080500000307060306000602040005000700020005050701
10362670767372302070552246536787356080423720407040202260806070454444505050886040301
10004000400020005040000060005000000070000080407000200050506030300070003020800060001
16807082507040504040886030472020466782765030808644632050606070788070225580806533651
10406000405000704070002000200030000070000040600000000080706070002000600000402000001
10408050507645524043702743308026648320402750464682475785208032802535605077404020501
10004030600000002040300000207040005000600020600000700000004050007000304000200040301
10603060678082304060767860705070807052483040205570304674552060707030204060605776401
10706060006000600020000000306080400050000070500080003000200080703060302060208000801
10367057702260778563553438704720387224237580332077303050606470606060605750635030401
10004080007000200000000000300030000000500000303000708040705000505040700020200020001
10207040547483808582827360727076304680303564404040248030765038644082554040706252681
10705080000000806000000050004000600050500000002080400080000030004000000030702020001
10407036825220708070363046706670632040362754567360807238264720305320773780805020401
10308050000080004040005030200000400080200000008000500000000000200060000070205000201
14308060752052333050303020206865305840606084707076746558856268656070674030607526301
10003000707000003070502070200000800050004000302000000000000080004080002060800030001
10454643608050707040704080406572505034743380606577607388868070205048608020807080601
10000000006020800040307050402000508030004000800000400040008080800060006020705000501
10326777485020534480608050733030606070574074883350404080508070307270332040258828341
10000000200020008000704040004020702030000060007000803000603060203070003020000000001
17482278807053604075304030507840408020643830403087753672405060305082432087577682201
10000060008080007000304060504000508050007000405000006080005040202080000080000000501
10775030756420745520503042205023773027225068203352306020333020304030586670687350301
10007000500000400020505080008060000070006000800070005000500020503020000000600000201
10603246623566507070706080436020366820206430283770442783603580606020352666206825501
10700000000000505000203000300050000030700080000050007000005000400020006000502000001
10367863655320703653503242803565802070668073266060648060855020668372667058404088431
10600000500000600000400000004000605000705000000050300070500070700000007000006000001
10707042607045582670423435253470402368505046238840803883803722307447305870353275201
10407050006000600070700000000000602000002000800020200080006000304000500060004000301
10207450805320206060807045842726407040432263608030263050323080857050607078488080301
10300000407000606000208000000000400070800000008070004080000060006050707000200050501
10388667275026604374605877456260307060404485666835304037742625604280606460804265701
10000000006050003000003000700020607050200060000000005000003000400000303000600000801
10565566603680537074727080504430505240527030606273836288702070864748758050788730601
10700000404000600040004060800070600040008000404000000040600040200000000060006000201
10403080808032207760407650606070665078804034844023784040205320307025563080307078701
10005040502000002000800000703000700020503000500040000040800060005000004020607000201
12577870302267475070648784503628203630608240204270772870553375345557205028304040501
10000020407000000040600000704050008000300080500020000050600000700070002050005040001
10238040408060375860208630405080225084347066605070682050802640608040636660708066271
10007040805020005040002000300040000060005000203060607000402030006070300000706000001
10807250707060303040588058743854858640303230363050307057303067772050704264708326201
10200000402020506080005080000000000000700040000020002000306000006060305000007000601
10237758408080206030207080707827257475375082344025526540704884303066608062238080401
10002000008040600060403000500000000060005000006050004000508000005000008000002050701
15262028744070427580807024374684775040204675803070567040308073653037788048606080701
10000020000030300070708000003000500020800060305080000060200070006000005000700020401
10824860602860462050605784703080306750806070306345884220824450402427805526787623201
10300000700070000020500000507080700000505000304000000060300040400000400030008000001
10502055654086886840646620886020307768605574804040676070703030253320604070307067451
10005000504070000050003020006060300080005000500080800020304050008000608000202000001
10553470203050708040308030504380328080522080527630804755605026355058507025402540701
10007040006000805030700060800000200050000030600080200000008000800050005000600040601
10306060238328304062253575305088424370532360704070744668477850306486272050646074401
10703020002000602000000000503000700040500000805040000000000080005000004040005000501
10404038638020305566533880303822507086805264802060782378227057488672808740504650501
10408000004040202000000000200050007000305000304030300020002000300000700060200080401
17802568202028807052572778525070803880472020803053404030706370408440706050526060401
10004000004000005000500000200030400040003040003000705000800020205000205030600080401
10454085703585403860304330856860858057502066532270504074778620504037247066503580701
10005000400000400070300030005000504080008000300060607000700000207000005060005000201
10302360305620438250788038404070408040506430507050305660805542204088703080548082701
10400000700080700050004000300080800070408000505000507000308000605000508030004000701
10276883766220307067708030727750527480208083605043802752406080303632408078483880301
10000050000020607040004080700040003000402040004000500000006070003000005000000000201
12456020885055608037868730807054304057844070227352864383448020635033352443473646601
10000050006000002000000000206000007000000060000000000000000020006000000000000000001
11111111111111111111111111111111111111111111111111111111111111111111111111111111111
