11111111111111111111111111111111111111111111111111111111111111111111111111111111111
10500000000080000000200000008000000000200000004000006000000060000000000030000000001
10805054868060423033508066205657306420205036702022206763407057844040667040386285501
10008000005080500030003000400000008000503000200040200000002000000030007000500000401
10556637602054808840206360803324478267703570807260802436374467485844402826406074401
10000040508000200000400070303000008000002000203000600000000080000000705000208030001
10863020305260866276803760705070803072432032538055764084856020405850405040502020661
10008000800080000000804000503040800040004000000020006000003000704000700070003050001
10802637582064678450737076652060548380306626474664505080503236728030662045672033801
10600000002000000060006000800040000060700000000000706080500060000030008030000080001
10778243504626284056507640407685447030608058747630403084344070242762606050477840201
10000000500000006000200000700030004000408000300040304000006040002080007040006000801
10506330205448202660626652626040248380204472202060602026404045503080248035403056401
10200080600000508040000000000070000060700000508070607000704060008000400040003060601
10224540835282204070843485682467436060574620508040602830504040286568303050432080701
10007000400070002030000080004000000050000050805000200020602030800070003070300020001
14804055407060302030552060254030483465248080406876842020606050572070648330402528541
10707000803000402050003000200070000020000020700000000020703020004000600000802000001
10603080408358388074703534707032544320402550338625786653302084207782803084504030601
10003060300000008040800000305060006000200020300000500000007070003000504000300080601
10308050887074408080553270403050208087434080608470608842247030706060406080802436501
10607040002000800070000000407040400020000080400060006000700080303030407070608000801
10588048204680846874484584508280834682227680863033807050402450805070503380343030801
10008040007000800000000000400080000000700000706000704030306000208040500020400080001
10405050333667505368442780848033205670604386804040327020273056563035853080207462761
10404070000000203000000040005000300070700000006030800070000070007000000070306060001
10505023354540304080646067603280246080653777745570807382237730504460653270706020501
10806030000030007080008040200000700020200000004000300000000000300030000040708000801
14602020668073333030405040806788204340506022808037386544653665325060457050207478201
10008000602000007080602040800000200060005000403000000000000080008040008070600080001
10673454403030803030504080504746305042823740208745805745345050403088202070506030501
10000000004050500060402050502000203030003000600000400020003060200050008020808000701
10844742287020575250804020663060807030635053772460308020702050206240558060578733331
10000000500080005000702030006030406080000030006000603000207020305020006030000000001
16545578605028207024506060404740504060677340405074738472206060607038566076473566501
10000070002020005000202030505000204080004000805000008080006020606050000030000000401
10478020767250733850707063708042235056777076805382602040744040203030345570465680401
10006000200000800020706060007030000040004000300060007000400020803020000000200000301
10506253386544706080407070244050872740302240866680844645402780608060332826206657401
10800000000000204000804000600080000030300050000020008000007000600020006000402000001
10527445883750706483804653403578806050866065773050442070748030482532626077406038221
10600000700000800000200000006000403000503000000040700060500050200000002000004000001
10504083206073376520546363438630804226504077278740606855407578708632703380336853601
10802030007000700070800000000000407000004000200020400050004000502000800020004000301
10802280402530505060302034687424603080524784404030757030777050725040406033583040701
10600000208000704000403000000000200050500000003060002050000060006050407000800020301
10484273663085705567402546474250808040203228446586703076883325605860207520706443601
10000000006020006000002000300030806030500070000000004000004000800000207000300000301
10736734405850677087868040408520802880652030307566637678304030326335482060572550401
10300000608000200050006070700070300020004000206000000070300060300000000030004000801
10303040205047707630308440205020883035608062272087488030407560503028667050705067601
10003050408000005000200000702000400060602000500080000060500070005000008020206000401
14366480303334628020423476504734606350207470502660775880877262626854705027407040601
10000020306000000060500000504070002000500030300020000050500000500080005070007030001
10262030307060756240203870707020637078563036607080524080205370704070822860302065821
10003020502080008030004000200060000080005000602050407000603030007030800000204000001
10406820704040703060575037542577648720605760524050308063603066235050507542802857701
10200000603040407020003050000000000000200050000020004000707000006080504000008000201
10744857506030506040403060506373754583335028427072554530802332504043504054266070301
10004000003060800020804000300000000060005000004080005000807000003000006000005070601
15322077532080842670406058388636772030707835507040877020604047683082786088206030801
10000070000080200030502000002000700020400050304070000040400070004000003000400050401
10222450503440726080302252707020302320502030308355864670867870407277708275868635601
10400000600040000030700000807040500000504000602000000070300060400000600020007000001
10504028565042265660735260347070403878402556603080646050403060456250402050304078531
10006000303040000050004050007060700070002000600080800030607060008000504000705000001
10672740403050203080703040205640752030763040733250807826304063432057305046406740201
10002040002000204080800080400000600030000030300030500000005000800060005000200080301
10607080688226208084387625706058327420763620704070426752372660508228625030542063201
10603050008000407000000000805000200030300000806050000000000080007000008080007000601
10803037663050604577726540603823306033503688503030427573662072724225502320705280601
10307000002070207000000000300040005000706000507060300080002000600000200040500030801
12704482403046703034463687226080505870262020507026602030308770305480205050846060401
10003000004000007000800000300070200070008060008000804000400020304000508040400020801
10545024403685707250408470727660644048508055658760305023585430503027868028405550801
10005000500000400020500050004000603020006000600060607000500000605000004070004000601
10306580807260854620353042207070802070706680803080302530207734203025705020688023301
10700000700030200070006000200030600060502000407000205000305000208000607080004000201
10563484645720508048505020488280885580707046706065304852303040702553508063866560301
10000060000060408040005050500070002000708070005000700000004070006000005000000000301
15438060665077407023234350407036802086776060723338887675484030363034563674838287301
10000040006000005000000000205000006000000040000000000000000040004000000000000000001
11111111111111111111111111111111111111111111111111111111111111111111111111111111111
