11111111111111111111111111111111111111111111111111111111111111111111111111111111111
10700000000060000000700000002000000000600000004000003000000070000000000020000000001
10404026634030835025508023802562506720407044208074406535503072558070263070865625401
10005000007030400070005000200000007000704000500080700000006000000060003000200000801
10733462208076403580308330208228825486303640805360408443254552272477403644706055801
10000080603000300000400060607000004000002000203000200000000080000000607000704030001
10475060203520734524407650204050507057474056465082645024525020502470705070403070581
10005000600080000000604000206020200080002000000060005000005000405000500080004080001
10208827427048476620684055343040775850602236838567807080703275523060646026454078201
10200000003000000030004000500080000070200000000000703070400060000060004040000040001
10452225502377457072605340806628242040603025225240704084846050552652708020268320501
10000000600000004000800000800060002000708000800070607000004060002080005030006000401
10604560202635706650325257428060227220702476607040603037704036605040383032805043201
10700040400000803030000000000030000050300000707050705000405070008000600060005040601
10674760538836404070752756332264225030242760802050608540702050387867705050525070401
10008000500080007080000070007000000080000030208000700040706050800070003030500050001
18802077707040506040527070655080526534266080305735426040806040863040482280306526781
10404000508000703040007000700040000070000070600000000060603030005000800000304000001
10607040208887365035804835707027326450808650475586585772802054304358805072706030501
10005040200000008030300000202020002000700050200000700000004050006000706000200070501
10304070754057506030378320804020306068387050808670706332858020803070608030206854201
10502070008000600020000000602060200030000080200020008000800080208080405030502000801
10778045507730348844243748605250252247575240757086807070307870306060203780877050701
10005020003000700000000000700020000000400000805000405020705000703050400080800020001
10502070435475604528855270652037405370606373605060525040673088884076573080708343351
10705050000000804000000020006000500050200000002030200020000040006000000080804070001
10406078674230305080235073606580276020887735432540603526526530308420558520304040701
10305080000080004080006080400000800040800000007000800000000000200030000040803000501
18705080345075688080705030503777402740602083302088776856453787885020435080207562701
10004000704000003070202070600000800020005000208000000000000070007080004030600070001
10335578704060202080403080308366805038777860303474504636726080704036706080303080701
10000000004020300070207040508000607040002000400000800070008020200030004050502000401
10858723746030563240703020875020502040638047875560405020707080308720684070447842281
10000000600040004000506030003070304060000050003000808000603040603030005030000000001
14442344203087203028708070708730403020888550305086887246806040206032663072625735701
10000080007060008000704070503000407060007000403000006030006050806070000080000000401
10783050254560526370802078203085562065466037503745303040382070302040263630547640601
10004000200000600050503060003020000070002000400070006000200050207040000000400000501
10404285525782602080202050372080847720703850533880865376408680608040246357406388801
10800000000000705000404000500070000040300030000080007000002000500050002000305000001
10547643276470302735605263204663705040366034525020652020477020547664282056804083631
10200000800000300000200000004000203000504000000080200080800060600000008000004000001
10803053706086858480728568553260305776408027238420503283305533603828202450742532301
10807050004000600050600000000000805000006000700040700080008000604000600020002000801
10407320206870407030306037838844802050782382502050322060547080647050207052482020301
10400000602000204000508000000000300080600000008080008020000030008020207000300040701
10724644673047805582702865444850608080803344586788202028738434402270806430403285201
10000000002020002000005000300060303050200060000000004000004000600000606000800000601
10532753206750285087784080802680702230633030307488257463306050262745533040442280701
10300000203000200040008020300070700030004000703000000060800080600000000030008000801
10704070804065607560503840803030673048307087376067368050806330207036878040808054801
10006070405000003000300000504000200020206000600030000020400030006000003050206000201
12784860703266434030675276708457505450602520204520757820832528655766608082607050301
10000070705000000060500000402030007000500030400060000040600000200080004070002020001
10457040406040887650205370504060536046536074308070334030804450805080225440302038681
10004080308030002060004000500040000060004000506080604000404050003050400000605000001
10502340705060503060743057743524364570806650836050302048508028773030405288205847301
10600000604050707020006040000000000000500050000020002000307000005040607000003000401
10747523407080606020403080307434737635527068548054682780807562807066302038527030701
10002000007080800060603000500000000020002000007070002000205000003000006000005050301
17485067224060557780807058373876326040806266806050337040708068424052872084202070601
10000050000030400020502000002000800080600040605040000050600050005000005000400070401
10667550402420777070506536802070606330508040406323484680622820604555307285555478501
10600000500030000080800000608070600000204000203000000020600050600000500040006000001
10408044284022263350455760373030604428604283303020286070506050445360505040406078351
10002000806060000040008060004040200070002000800030300030708050003000202000404000001
10265220308050203040307020603270662060357020435740702634802022764033307072303380701
10006080007000606070400030500000600050000050400020600000007000400070005000300080401
10507030772223706057732565402028485560858820703020552282384480607753268080248077501
10803080005000204000000000207000700040600000505030000000000060002000008020007000801
10508074723050802285382650203655307044803562408060858655726028236847704280405240501
10204000003070405000000000500020006000303000704040400040004000500000400030700040401
17804564702023206075732458447080504370884040807068808040604420206470306040878080701
10005000007000008000700000400080300080006070006000502000700020607000704030500040201
10446046402775404770808340368820642028402044688230306075423830703068347045206780301
10008000600000600020400040002000506070004000300030208000300000808000004050007000301
10708760706630875250284047706070302070306430308030508540504678807046603030555027801
10500000700070600040004000800020500060708000207000308000206000807000404050008000301
10427575687670205048402040272470874840308082308036205252708040503554806062473580401
10000050000080302020005050700060005000506070002000500000006080004000003000000000601
16572060685074303086253460406053503025836080477634526625352050574046836674677433501
10000080006000003000000000707000003000000060000000000000000070005000000000000000001
11111111111111111111111111111111111111111111111111111111111111111111111111111111111
