11111111111111111111111111111111111111111111111111111111111111111111111111111111111
10800000000040000000400000002000000000200000008000003000000070000000000030000000001
10404035264030653053703043408635206850207032702086406885704077783070252020683453801
10003000005030300040005000200000003000302000400020400000002000000030008000800000301
10374372502085708680507530707866837334604280506320802658375232484352508776407086701
10000060205000700000300070307000004000002000703000500000000020000000408000508040001
10548060708670854482208240807020202036477043622054887052728020503880808080804030761
10003000200030000000703000706040800070003000000070008000006000302000300070007040001
10308463682054726230526068533030462760303838263568306020305788242070737023767053401
10200000003000000020002000300020000020400000000000504050700060000070008050000020001
10347546605573687066205850803332472030404046473650606042887030686242705060628760401
10000000600000007000400000800060008000703000200040805000005020002070002080004000801
10408280705332806680823328786030878730707437804030408052206025208040626075707085601
10700080700000302020000000000030000030300000307030607000206020003000400030004060801
10228580822227506020632687238673487060743770306020805550404070522265703040537050801
10002000500040006060000070008000000070000040502000200030708080500020006020400020001
16802077404070807040488070487030872827833050402486445050402040463060823880402572621
10203000404000603020005000600060000040000030500000000080405060008000700000202000001
10805030503765347065207457407072444860708530336647254686204087607862607064305070601
10004060600000008020400000506060005000700020700000800000008050002000507000500080701
10608020283078406060757740205080506024384070705640804878858020305020204070706367301
10803070006000700030000000708050800050000020500020006000500070808060202070307000801
10326064803570853332882866302540632258642450386036305060707280508030808350825040201
10005060004000400000000000200080000000800000806000804020602000608080800020700050001
10604050877753706653825480256038805350407732702070278070324026754075867060206855561
10705020000000805000000020003000600050500000006080400040000080006000000030402070001
10207026483250503040332056705750623020666683522650806687484880608430676260706080201
10804060000080006060004030800000300020600000002000300000000000700080000030503000601
15404040752083722060707020407268208630408038505033853886325753645050852030504782401
10005000303000004060707040600000400020008000702000000000000020002050005020200030001
10326276605040404070707030805836306034224340306478805675367070407033606080203040401
10000000004060700030708040406000802020008000400000300020006020400060003060706000801
10323684754080528720208050856070508060533066835750704060203070402760684050757536661
10000000600020008000402080005030608070000030007000503000207020508020007080000000001
15625626706023706042303070502760506040736850505075447862207080703045274057638268201
10000030004080003000504040702000308080008000705000002050005060407050000070000000601
10754060745380458340208043602033632063246058407554308020554080405040853320264750201
10003000600000300020808060008030000050002000500030006000800050403020000000800000401
10607662237387805080302040476050234540205640572750522238707550408060545647604578201
10600000000000805000204000500040000080500040000080006000008000700050007000306000001
10468786684380708733308663306273304070554055725020388060754020365862486037502056321
10800000500000500000700000004000708000605000000030400030400020400000003000008000001
10804057506047638430422373664840403727304054525450503343707488806535703230635842201
10406020002000400040300000000000602000008000400060500020004000308000700060006000401
10702580307540403020802074763782408060642572603060268060554020437040302043368070801
10500000808000207000302000000000400050600000004080002030000080002040406000300060201
10343364374047707875206832783320504040706767355846807082347468702480407360702848201
10000000003060006000003000400070504080700020000000005000008000200000603000200000201
10824563605840624053836030808860502430274030708285832477508030736542276060856370201
10800000503000400070005020500070600040006000408000000040400020600000000040004000501
10307020502076402760305340504080452056403024586046325020408320207067843050803065601
10002080406000007000300000604000600030307000700030000050700070003000002050303000301
16434870804842784030653266806226204530503520504480347680843427325646507053708040501
10000040304000000060300000405030005000500040300070000080200000200050007040008020001
10528080703040653240708440303070762063553067307070735070703880304070346280806068551
10004070607020006080006000400040000020008000705020603000504080005080800000305000001
10703620403040204080246042665578682260308470557070505064504083825030806566808844701
10600000602040404020002040000000000000300080000020008000202000003060506000006000801
10727438506070304070204060305652785443773064536066274730203822305072806026637030301
10004000008030200050305000600000000080005000004030005000303000006000003000003060701
16528053557080754650608024625832476030805466707070775040604085767068884067607020701
10000060000080700020605000005000700060300030702030000070500040004000008000200050501
10353340302740236050602262508070503680303020408544577570725880406684402645276522201
10300000800050000050200000703040400000802000608000000020200070500000400050004000001
10408044345035223480346550342040204835208882305060253060304030633680307050505057671
10004000605040000020006070007020700080002000400040500020507060006000703000508000001
10855370808050608060807060506340252030477030556540207523506057642065208045803530301
10003070002000702050800060600000200020000040600020500000005000200060006000500060501
10408030377263604088644276703086243760342370204040826467223540702447755020835052501
10303020003000803000000000306000800050800000304020000000000050002000007080004000501
10606074583020706736667770807378207052404673302070685628842055238278806670502420501
10408000006030307000000000500070007000408000602020300080007000800000300070800060801
12204882403057607052676275525020708840725050305053206060705760406780704040258080601
10002000007000004000600000200050300020007080005000304000500040604000508070800060701
10436032203356403720805430756480778076302055787770408084375440806033552058207250601
10002000500000600050500030004000407030006000700060808000700000406000002020005000201
10205250407280347770645046608080204040308420503040205670506436503053302020728077801
10800000400040300030006000200040800080203000603000408000708000807000805080006000301
10437875644520808084202040647720262450503056806043706653803020507523508024868640601
10000070000030505050004070700020003000706030002000500000007060006000003000000000501
15354030226023306072322460205063703088272030832232782886868030737066232542226268801
10000040007000005000000000305000005000000050000000000000000070008000000000000000001
11111111111111111111111111111111111111111111111111111111111111111111111111111111111
