11111111111111111111111111111111111111111111111111111111111111111111111111111111111
10200000000020000000200000003000000000300000008000003000000050000000000050000000001
10707036254080257066407063407772307650503037706063806363304045667040235040468655201
10005000007060800060005000500000008000807000600020300000004000000040005000200000601
10522532806042502570608850502728447233808460602480803768337567735886408567205022701
10000030302000400000500040706000002000004000608000200000000030000000206000305030001
10228020304720334475204370508040705034427066857064736046484070803770208050505060641
10006000800060000000808000307080800060004000000080002000002000504000600030003060001
10708448738064367380686068748080474230407334568366405070808836635050865058332047301
10500000008000000080002000200040000030300000000000302080500070000060008020000060001
10546255605226264032702450804647888070803083373730803088334030233462502040536580801
10000000700000003000500000700040003000606000500020402000007040005020008040005000401
10805380507447403250662766367040378580802272303020607076806027805080866034508067701
10400080500000406020000000000050000040200000505040502000302020005000800050002040801
10833760334633705040583635444775323030282680808020504880807070827536406080438040401
10008000300070003050000050004000000040000060405000200030507080500020003020700080001
12206062504070207060645060582020835867684060502654874020808080548070242740602537531
10304000706000802080007000400070000040000030400000000020705060006000800000404000001
10206050206368344037503372404077783650607260544574623433707054406227708088503030501
10008080200000002050200000604060007000400050400000400000008050004000502000800080501
10606040456028702050866720805030205065688080804450505282337040405020704070605682601
10504060004000700060000000205040300040000040200050006000500020304080504060403000701
10528087606340227553668553308570848628248730224087705070407480808080703570272080601
10006070002000600000000000300020000000800000206000805020704000408080700080800020001
10703020258628505834874260442047405450204844708050783060343028336064782050203847871
10408020000000306000000030004000300060600000006050400020000070007000000040708060001
10808044788220205020335063608660328040242787452740404582663750504680585620807030601
10505050000020007050003040300000700080200000005000800000000000500030000040307000501
13704050562083862080807030403763704280503084207043857682232783683050422030503683801
10003000402000008050306030300000500080006000202000000000000020005060003040600070001
10353548402030407040402050807438503046468270608363406558637030807028607020308080401
10000000004040600060507080604000202030006000600000800030003020200080005020206000601
10387763456030462870408030656060603080855073377580308050504050505270732050475375451
10000000300080006000807050002050803050000040003000504000405020207030005070000000001
14577586604026707062804080203770205020682560703024262536404040302026776084432484201
10000060002030003000602060208000407020005000807000003040003050507070000030000000801
10582030885630235250708046406062423026767035508585805070768070407020347280855470401
10002000300000600070408080008020000040003000700050006000500070503080000000600000601
10807627268335604070606040276080626450607780272230754685203370302080224253703847301
10800000000000804000502000400060000080500070000060008000004000400020006000208000001
10737656486880607724502765706223305040523068756060548040583040877265386063604053731
10200000400000500000300000005000703000703000000080800040800040500000005000008000001
10205062403038578580587227685330607273803077275740408636403856205225604380355448801
10304030004000500080700000000000302000006000600030200030002000304000300030007000501
10807320807820504050206033323362803080336844402050352040782080455060603023624070201
10800000806000507000605000000000200080500000006070003050000030007040203000600060801
10864643544036403552404778685230505030707353367227506076525377507840608760603474701
10000000008050008000008000600060404050300080000000006000006000800000703000500000801
10666642605730256083835050503520202220682080608222228625703020476778875050522580701
10700000607000200080002070300040200060007000407000000070500040200000000080007000201
10708070205083303850208880604070628083405066537022674050707660804063284080604076801
10004050406000005000800000202000500060807000200050000040300080002000003080303000701
16632630402336554020522223604376507430204780608620858570245573483248603033602040601
10000040202000000020600000203070007000400040700030000050800000600080002030003070001
10565020503080648840404320707050464053724082207050244040806730402050623650804057231
10004030508060003070008000700040000020005000508030207000704020006020600000506000001
10308540605080805020454085437726483220604350427020603068308033636070805766202685201
10700000607060503040006050000000000000700070000070007000802000004080202000005000801
10283772603030302020208020705585222254245073627022526470308387407064207088643020501
10008000002020600050202000300000000070004000005060008000208000002000003000008020701
15468024733040432780304062263654767040606865807050338080403044548025326073208040301
10000060000080800060406000004000700070800040205060000060500040007000008000600030701
10283740202280674040407647308020507450502060306443754650662760608277505528732584201
10700000300080000070800000308080300000204000305000000070300020300000500070007000001
10702035628067577620322380242070406283603464306030733070303040425860206030302066431
10004000205020000040005030002040300040008000400070700070805040004000607000507000001
10642580704070807020502070805460855030437030355270303478308055445068302025208380701
10007020002000202070200060200000700030000080500050600000002000500050006000800020701
10508020274728406037272653502023365570865870802070624573643840603477473060667034401
10302080006000608000000000703000700070300000502080000000000040002000002050002000301
10805066578080308385377740207772203057307533202060844422833035523737606330508870501
10307000002070207000000000700020006000506000504060500030002000200000700070600060401
14307572505077706026555637457060603260222070502063705070506850406580205070322080501
10005000006000005000700000300030700030006050003000408000200060804000802030700070801
10865056204652602220808270247420727054306088664250507044263840202064725064805460501
10003000700000200030200080006000806060003000200070505000700000403000008050004000201
10508660703320224860438086508070407060303360402020206750502336503086207080828037601
10500000400040300040003000800020200060607000602000703000807000208000203020006000501
10273647364740703045202060628640257240306028502022605832804030806352704042578850701
10000030000040302030003060700030002000502020007000500000002030003000004000000000801
13842020637035303054234230706077403025233030538463454662845020738024672774245563401
10000020004000006000000000208000004000000080000000000000000070002000000000000000001
11111111111111111111111111111111111111111111111111111111111111111111111111111111111
