11111111111111111111111111111111111111111111111111111111111111111111111111111111111
10800000000020000000400000006000000000700000003000006000000080000000000080000000001
10305058877040725036204084806232707220207077202044205347602082245070864080574643301
10007000003030200070008000800000003000807000200080500000008000000020002000300000301
10352434308078605750507860605664665856702670402780807376877788227657407757605044601
10000060706000700000200030402000005000005000806000600000000040000000606000505020001
10236030805480374838504670706070802023543082878053243045755040206260507030702040351
10002000300060000000306000707030400060005000000070004000008000802000700040006030001
10604548778084635220782084788020377840402356767555803020608456672060824027623038601
10700000005000000040005000400020000080300000000000403040300070000070008020000040001
10862482803672347072403650808885586020202086632240302085356080677525307050367680801
10000000400000004000500000600080002000802000200040602000005030003080003030007000301
10604770806654605860855724378070264420504274503020805023206067204040666063703036401
10800040200000602060000000000020000040700000607070703000203050003000400080006050201
10744250537473204070324837538857766030886320506040603470707050333845607060527070301
10007000800060003030000060007000000030000080407000400050708080700070005040500040001
16406064603040402020676050287060853724762070206764286030805070832030258560406386471
10705000208000202030007000500080000050000040700000000040506070006000800000402000001
10807030208638288037607764808023335840403270664488433548405056207486202086703080301
10005070200000004030300000808050002000600080500000200000008040006000604000500050501
10805040286084407040534270702040205084886020302230806875682080502030702040507678601
10302070006000800070000000605020600080000080700080007000600050702040205070302000701
10575036807880388244753348708280773787586560626055204030506620506080708860783070401
10004030007000800000000000300030000000200000507000807050704000708030700020400050001
10503080283473705655745430585084808830503373403060656060458054325086255050208333521
10707040000000702000000020008000800070400000005080700020000040003000000050407020001
10608068277450205020344035703330478070837644342560507867282580206850877550308030701
10608070000020002040006040600000600060700000004000500000000000400060000070307000401
12508050564033244060202020206357805470408035402072684226456277367060458070705648301
10008000607000006060305080400000300080002000302000000000000070006030003050300080001
10883426207060407050506080405662802067742870206235803847254030604078508040403060801
10000000002060500070306050306000807060006000500000500040002040400080002030604000401
10778875783020283570707070442050506070326067325670707030204040506740672060824348631
10000000500040002000307020004040305020000060004000306000402040304020008020000000001
15557367402023306072306060404870206050563870203045336843305040703057558086427284201
10000030003030005000803080402000804020007000704000003080004030807030000030000000801
10765030656470424270402074505028688087326035402644606080678080306060625440835330201
10003000800000800060704030004050000020008000800080008000200050408040000000700000301
10706347283355808080304070546080743840702740755230735234608230302050224362602683601
10800000000000402000202000300080000070700070000030002000005000200080006000504000001
10572544285350207657304377408528804040287085477080587040667040452275737057705022531
10400000400000300000600000005000708000208000000060800060700040500000005000005000001
10507048807024836670546545786750503875606046774250602823707785608342505270632384801
10703080005000500080800000000000203000003000200050800070005000803000600030002000601
10608240502840408030503068658886604060542673207040475080538020772080202063447080301
10800000308000608000204000000000200080300000003060002080000050004060202000300040201
10274437732067508362807522587820404020405652326643308023747238605330702450202433301
10000000002070004000002000300070405080800060000000005000005000400000705000600000501
10886543807850657042866040603440708230766030506785546744806070643373785080272530401
10700000404000300020008050400050200040006000708000000050500050200000000060002000601
10802080803076704480408750407060425032405078365044883060707230304078733080402038301
10003050502000003000400000202000700030402000600030000020600070006000004020308000501
15843270608786252030578256204835706320303660703850345830677557363322506046207070501
10000050707000000020500000207060002000300020300060000040500000300040008020004030001
10564020603070672850306630502080674034323032703080524070808440404030584860307075341
10007050206030008060006000700040000020005000406030407000504050002070400000806000001
10206380307080207060375077468583232720408860722030702054806067685070802826407458801
10200000406080702050005080000000000000300020000050002000605000002020707000005000301
10737553603070507040507060303254385844286072242088683580407355307056307063358070301
10003000007040800070403000400000000020005000004070007000203000004000006000008040501
12234085746070446260304076256386683040607477308050875080608073375037328042404050701
10000050000050300040406000003000700080800060207070000030500060005000004000300070601
10424420404230367040405637304060305730204060507452742320426430308525307458763345401
10200000700040000080200000706060200000308000305000000060400050500000300070005000001
10804044626037682670576880557060203288303767804020372050507060723220507070702033461
10007000304070000020006020008030400020002000400050800070205030006000506000804000001
10278640703060208060606050503470872020483080378520506774404085835067707025304660801
10003040005000806080600070600000200020000040500040700000008000300040003000800050301
10402040427453803022528325208043787770387660207030443665557830508434782080355043501
10303080006000504000000000307000400060300000204070000000000020004000003070003000701
10807068728070204726864880805833703076804382706040663857785026248246206560603560401
10305000007060208000000000600080008000507000806020800070005000300000700020300030501
12702635307028302026265645826080403840246050405074306030707250502280407040357060201
10006000004000005000700000200020300040006020002000304000600030708000603020800080801
10262087206725204240205260725280233047602056637230504038338220804055367045603530801
10005000400000400030700070002000402060004000800070306000600000507000007030002000401
10708370204380854350385065504060602020402520802060502830504267502046606070377022201
10200000800020300050005000700030600060404000507000206000804000306000206020005000601
10764586348320502043808040788850864880303037605068503468403040503683508026253640801
10000030000040603050008020400070002000605070002000200000007030008000007000000000801
17552080448082607035326270206078505076644060546425535858683040474072226456546846801
10000060003000003000000000804000004000000070000000000000000020006000000000000000001
11111111111111111111111111111111111111111111111111111111111111111111111111111111111
