11111111111111111111111111111111111111111111111111111111111111111111111111111111111
10300000000070000000200000004000000000500000006000008000000050000000000020000000001
10408065625060864025605048706276203520606063705078502626304035278040863040486277201
10006000004070200070007000200000005000802000300060500000008000000040002000700000801
10324734403033606570602540805265274775307440505820804763547727825378606276603036301
10000040206000700000800060603000007000005000303000700000000070000000308000805050001
10233070803430538652703440606040306036645043543083264046225060304220707080802070421
10005000800050000000202000206020400070006000000060006000003000702000200050004040001
10804763246023472550878027865060626680603868426274502060402653728040457074853048401
10800000005000000060005000700080000060400000000000202020200040000080006080000050001
10648655508278577047808440305835335080205035655780308022257030586868805030488270301
10000000200000003000700000400050003000806000800030207000005060008020007080006000201
10205820706872307430557853686040337340804666205030405035608078606080283036802085501
10700070800000707050000000000070000080200000404070805000602040008000800060008060501
10455560833247704040755574385784666060733880203080504280605080345438505070727060501
10004000700050005060000080005000000020000070504000800080203030400080008080500080001
14602038405030807030688080684020868842376070806263787040803050637060873320604746841
10805000803000408040004000200050000040000030800000000030602080004000300000807000001
10606030307446245074302563805073678280806330238783564887204058306562606078708040701
10003030700000007030500000603020004000600060800000600000004030002000402000200020301
10608030576046404030474720607070608028582050307730604846524070806060205070806333201
10608020006000300060000000505030400040000030700070008000700080306050305030707000401
10837067707850768825625572507840622353365880474022707070607860505040707770484060301
10003060006000200000000000200020000000300000603000408070608000306070200020500020001
10403050832782803638333550754078605250804553403070875060652087538078344030408527331
10206050000000407000000080007000500020300000008070500060000030006000000080708060001
10205038234750608060255076504330728060622546235470606556738540806350434530407040201
10405020000030002050002050600000300040300000005000300000000000800030000020207000501
13207040324072323030807050405265806850406035807033224235837533854070633080803664801
10002000203000008040805020200000300050004000804000000000000080005030003020400040001
10463277702020803060208080305256202038868280303865402556657020603044605070308050701
10000000002030200030308070406000506030005000700000600050007020800040003050806000201
10485764386020322530408050475070703020236054624240406030706060605320768060643767471
10000000400050005000404040008040604060000070006000505000505060604060006080000000001
18872282404044408035608080305730705030836830502085468678202050208052854035544674301
10000020004060002000206060602000503060006000605000004060004040805020000040000000501
10286020367580338550204053202065278053645063208285706070234070206030844630424420401
10007000300000400080704080004020000060003000400070004000600080706060000000800000301
10805434564763402050708020623050235650805830427250543226308550406050462436206733701
10700000000000702000303000800040000070300040000020003000008000700080008000408000001
10478653787280605346302245202872607020678067455040624040768070544645687037708082831
10200000300000300000700000008000504000703000000030300060400080800000006000005000001
10808027204045444620754326227640704645307082836730508782502278505433402430223365201
10206070002000700070500000000000706000002000800030200060006000402000300070003000801
10503550607520504040305056433353707070646654604020767060567030277070204068863030201
10300000403000808000403000000000500020600000005040005060000050008060708000400030201
10837442826026608843404478252680806070608886688672405068737344505830402440203453501
10000000006060006000007000400030803070500030000000003000007000600000702000600000601
10385258804370875057585050205560705820468050704778526358602030244362566050584250201
10200000208000200040007080200020600040006000407000000070600030800000000070006000501
10408070602067506660408830707070663057505024774044637040702420606062438040807058501
10006050402000004000300000502000300060305000600060000070200080002000003050607000401
13247280404254386020687448706874706220505850806870374760648433433387307023706030501
10000020402000000060200000206070006000500030200070000070400000400050008080002050001
10852050207050523540806760706070364036448036202060747020603470305060448280804062341
10008080702060007060006000400050000020006000804020404000403080006080800000208000001
10406330507060608060343067348255228330803250653050605035305056555040308483308868301
10700000607070802070004050000000000000600020000060003000202000003050404000003000801
10627483704060302080403030305828766323682056684055788760208727807077402027628030601
10007000003050400030802000700000000030006000006040008000204000005000003000005070301
16823086266060682570602084662762474020503345804020747080204023424048528044306080501
10000040000080600020602000007000800070600040602020000050600070006000007000700020701
10623740504850544060505863403040402770502030704642676780326430703573804722852576301
10400000400050000050300000603030700000402000708000000080200040800000700050003000001
10205057445033425270385420883040508634306334803030755030204060482860204060807055551
10008000505080000040006050002040200030004000800030600050406070007000202000703000001
10778360405080605050207070408420545020262080548330503456308054458036804038703680301
10003020006000504040700030600000500050000060800050400000004000800050003000500070301
10607060842287508044353626402053647550283780404030823235472470804428237080276028201
10804080007000603000000000706000400070700000604050000000000040002000007020005000701
10703043533040607862745450706267508065504754802020224268326038734344205570708340701
10305000002020308000000000700020006000705000704080800040003000200000700050800030501
13207874705042707086653446255080308360863080605056808080803530707670707040562030201
10006000005000008000600000800060300030006080007000304000200080706000702070700070601
10288027702256603650608620323840434043408024728250504042543530507025454056302580301
10003000800000800050300070005000206030006000400050403000200000704000004060003000601
10804280207350842760283045705080504080802550402030206540504727208034303040623025301
10500000400070200020008000700050400050502000705000806000405000308000808050006000401
10662453342770206024706020428340748760407086605036404327807020803738607078574660401
10000070000040208070008060500060007000605060002000500000005040004000005000000000801
17247060253085505052624470605082208062742040658223454232534050248054227782635767201
10000040003000005000000000208000002000000080000000000000000080008000000000000000001
11111111111111111111111111111111111111111111111111111111111111111111111111111111111
