11111111111111111111111111111111111111111111111111111111111111111111111111111111111
10200000000060000000600000003000000000400000002000002000000030000000000060000000001
10207075533070654055308054202555407360307024802076408524508056454030542040288458201
10004000002070500030008000500000007000404000400030600000008000000070006000400000701
10756752604034503840602270307537535372302870506870803372283652726255707527305076401
10000060708000700000300030307000006000002000507000600000000040000000705000803020001
10347080403570325643505470202020707052635034776022686043845050802450802060707070671
10003000300020000000302000308040300070006000000080003000002000308000400080006060001
10507567842054688220656053373060252870402477675832403040405556878050487083242048201
10800000007000000020005000400070000050600000000000502040800070000030004050000070001
10265538408527556042407460804265448060206038752420505043624040485772208080264460301
10000000700000004000200000400080008000607000300050707000003050007080007050004000301
10607330705362306540268226447040553220808778707080506044605063202060678047603034601
10400050500000403030000000000040000060500000702080305000505060006000200060004060501
10677460234388505040548588843555254030263640305080408750803030235637603030732080601
10007000600030008020000060006000000050000060308000200050705020600070005070300060001
17205033503030305030877030875080547532885040408478476040302050853040632440703388661
10502000403000502050004000600050000040000080800000000050706020003000500000308000001
10402020207722486063706576506038285370603620735554485867603026206252605072805030301
10002070300000006080300000806060006000300030600000700000004070005000203000200060801
10803080738055805080382450307030606072445020605740404228586060202030603070506845601
10404030003000600070000000303030300060000030300070008000500020503050305080705000201
10463043506230487634864746605430782875628580824025804040205650505060408530273040801
10002030004000400000000000800030000000800000608000807060408000202080300020600020001
10506050368836708577283480235055604660805545403060848070847043262068823050404587321
10305040000000805000000030007000800080500000006080200030000040005000000020402030001
10205076387730706070238066805540578030724568253270808526673440706650568770406040601
10202040000020004040006040200000200040400000006000500000000000800070000040705000701
12403030654038533050602070307763403270803083805063647674843563258020445080503787201
10006000703000007020806040400000200070007000606000000000000050006030004020700060001
10746252602080208060204070606246503065434370306673503364832040502047306050606080701
10000000004080200080207040603000303070005000800000800050004080500040005040807000501
10262762778050656850407070722070604080643075268220303080507020308820575020465534831
10000000700070006000404030002080505040000020004000305000304020408070006020000000001
15362835306025606064307070706540208020527330802034725345708020803026283047428467701
10000050007080003000505070708000803080008000704000006080006070204080000050000000401
10722030237380684350305084808052366027385073606345204060528020606050348850275380301
10008000200000400060505080006050000030004000200040003000400050407070000000200000501
10705656235825405080408030874020332230808660336440653668608770804080878828308284701
10400000000000305000602000300050000050300050000030003000005000500070004000803000001
10666685364670508484207686502224702030287034453080274050542020223785328055506026371
10600000800000800000200000007000207000708000000060200070400040500000006000003000001
10504082805058654840374877583720208847207044442750403866405366507482304360648675801
10705080002000700070200000000000503000008000200050800040002000405000300020007000701
10806730608660206060603073472537802030572846807030824040646060576080203083665020401
10400000307000805000308000000000300020800000007060002020000030004050504000200030701
10684777224053205662808375264240707040502245322588205027844436605440207780508668601
10000000004050006000002000700020708070300030000000003000008000200000508000600000201
10785856208320385046584060405230802620444030704253788362208070483832632070373740601
10600000505000600030005030200070200030002000505000000020600070300000000020004000601
10704070404052305220605330803020243066606074652056572060508530507064854030304025401
10007020503000002000500000403000300060402000200020000030700020005000006040506000601
17332340807837578060364866408874406270207820704570623520247257886544307072208070201
10000030602000000030300000608070007000700030400030000040800000800030006050006070001
10572050208060862260304370407020487027546052402030266050408280304080242870208044651
10005050202050008040003000800070000040006000806060404000605060005030400000402000001
10307480304020808080862083786455636440208250642050303026207027242020707666303254701
10600000206080706040007050000000000000700040000050002000604000003050705000004000801
10447363507050708020407030304348787322234068352028246840807562606046504052653030501
10004000002020600040703000300000000030005000003070007000207000006000005000002050501
12655082755080438430705062753684787070207468504060866070507073644044528055703070601
10000070000030800030804000003000800050400020506020000060400070006000004000700030501
10222820407750563020702835403070505840803020208883777770754760604677202858485645201
10200000600020000070800000608050300000805000708000000060200060300000700030006000001
10304023276022468660733380355030307647807526608080785040802070244630505020307086271
10003000206020000080003070008030200080002000700040700050506070007000607000707000001
10223520807020806020806080305360547020284020385550606573602074248025208087808270601
10007060003000705060400030500000600040000070500060700000006000800060005000700020201
10203020472535405032723783207033743320744820708080368372464530602785553050543064501
10502060008000307000000000203000300080400000802040000000000040002000002050003000201
10206056743080803538463780508644504052203262507080423827365055523475402330305570601
10805000003060407000000000800030003000703000608020700040002000600000400020400030201
14302475202043706038687535537080802440343050808035702050503320702250802070487030801
10004000004000007000300000300030400030004030002000708000500060606000208030600070201
10877056704288205230808330866650476033404025774260605022644240307047563057805520701
10007000700000500080800040004000207040003000500040307000200000604000008050002000801
10408340205760733540645086602060204080803450203070507620203267807052204040526035401
10700000300050400070004000300070700030206000408000808000603000304000503080005000301
10448627584350808063408050865230825440406082307068208762806060605253408042576230301
10000030000020506040007040300060007000803060002000300000003070006000007000000000301
12552070347064405038447760606052705053345060624574843856757020658057673557687226201
10000030005000006000000000802000006000000070000000000000000050008000000000000000001
11111111111111111111111111111111111111111111111111111111111111111111111111111111111
