11111111111111111111111111111111111111111111111111111111111111111111111111111111111
10600000000070000000600000008000000000500000003000005000000030000000000070000000001
10808058384040355087706042606448805580308066508077408368804057357050653030734782401
10008000007070300080002000700000005000606000400070700000005000000070004000300000601
10343254407024603650208430604538338552806830505250708876764536848435704756608087201
10000060406000500000800080706000004000002000606000300000000060000000806000203070001
10868020707660734875305550502040206084525064864083732035243020604880506080303030481
10007000300060000000306000704040700040006000000020006000007000706000300020006070001
10705442232036722570844066558060257330704724247584606080405852257080377038748043401
10700000008000000030006000300040000030400000000000304060300070000030002050000080001
10242626302873635068407640606425664040403066542340807082434030833786403080272570301
10000000700000004000800000600050004000807000700040307000002070005030002060002000501
10802630703673207750446332485050544420605848808080203025205025606080824084304083401
10500080500000603050000000000020000030500000706060404000607050005000700070003050301
10773760644834708080483522347223872030355840407080206430202050325887606070562070401
10008000300020003030000080004000000030000080304000400040706040800060007020800020001
16204057604050507020676040548050856735755040405384648050405030627050484420403683381
10406000308000205040006000400080000080000020700000000020502070002000200000606000001
10606070502757425064305244304087835230708240764875823748804073303848802072604080401
10007050300000004070800000606020008000500070400000600000003070004000805000500050501
10406020654062608080444660707080703057462040305740804582274070702040408070405548501
10303050007000800080000000703040300060000020400020006000600040206040603050302000701
10763063203750356853732722802840234462648660384073607050306870703080503670648080501
10003060003000400000000000200070000000400000406000808030808000307040700060700080001
10305070225424406374283470788063806350203736304080265040565025437026584070606488571
10702080000000208000000070007000600050300000003070300030000040008000000040705050001
10405085253640206030762024408360663030636877247380506684662850605560324220405070201
10302030000080003030008060400000800060400000006000400000000000800020000020308000801
14506050733052558060206060703863405320203082307023474238333756233030543050405357201
10005000704000007070703080700000300080005000307000000000000060002050002070600040001
10622275502070306030407040607784303038368780308653703384423040405087206060604050701
10000000008080500080802050602000207040004000200000200080006050600050006070602000501
10688834746030553440804080564070702040354045256540602040407030308620633060875636381
10000000700070005000404070008050408020000020003000605000306060404050004070000000001
15754382704064204088308020807880407020832840607048458223402070303085355025262258501
10000030002040003000502020805000408050002000703000002060008070506080000080000000401
10524060334730224820202086608046622052857034606886302060377060404080736770236230701
10002000300000700020304030005020000020003000600040006000500020302040000000600000301
10602243553557704050803060747030827850207780758530858727708750805030542872706662601
10500000000000805000206000800070000050300050000040005000004000300040003000805000001
10465222777440605732805845207277606060256022452070642020477050273586376077403022761
10700000200000600000800000008000802000502000000030300060200050500000006000002000001
10702023206062646860643583567420602267805025882240807334506838604253203420822484601
10203070004000300070300000000000708000003000300060800050006000504000400030006000501
10408870704220805040504053627288208060233737804020373080333080568060606024767060201
10600000603000203000606000000000800040400000003080003030000030002080605000200070801
10835688583033708582607522284850204070606842823788302024373588608440506350608568301
10000000008020005000002000500070807030300050000000006000002000600000705000700000401
10882485703520724023276030508840808430476060708764262282405060862463723050248370601
10800000402000800040004040600040600070008000403000000070600030500000000030003000501
10207050304064202480405480608040622063707083522028386030505450807064465020207075601
10008060305000003000700000505000400030205000200070000030800060006000006060406000301
14628480204577625020578764402545702880204350607640264850384342272238402067603040601
10000050205000000030300000704050004000400040200050000030200000400020007020005040001
10538030302020726580305760708080644067235038603030343070608340205080535380805084861
10002030508080005030006000700040000040004000204080303000808020004020400000802000001
10204660402050207050672045784573438560704440625060406078606072555070803764808642401
10500000204070705020004030000000000000700020000050002000408000007070407000004000601
10355666804040705050705040703285722425764024672053458620508653804036304034526070801
10005000002060800020505000800000000080006000007070003000504000006000004000003050601
14538066876020864380305065543756854020403546805030652050307045573082325048805020301
10000060000080600040605000004000300020700050205060000080400050004000003000500020501
10337620803560466040803525708040806450203060705333385230833740605522308755684278801
10500000500040000040300000507060800000708000305000000060700080300000300040008000001
10207037782046722240482540732020308664207535506030332030708030244750303030303032271
10002000207070000040003020004070200020005000600060200050403030004000707000405000001
10425540703030305080507050308220888050232030656240304326402068286083307057404520301
10004030003000602050400070400000400080000080300020500000004000200030007000700050401
10303050652463305022653834402056257650624680406040724686553220304857335070485083801
10402080006000707000000000508000200050300000206020000000000030007000008030007000801
10204036224020604888686850503666803048803557308060646775672086723382405460707280801
10406000007040608000000000500020005000504000202080300020007000400000500060800050701
17204582506064203066424544627050403740725060703046706080803520504770608050283080501
10002000003000005000300000400060800070006070007000303000500020403000804080700030601
10436067205226602670603260332470628082707033574560607074534720606084782073304360401
10006000700000500070600030008000702050008000400030307000400000707000008070008000701
10706460208760334880322083804070403020706870407080505660302286707057505050462074701
10700000300040500070008000700080800080404000603000802000405000403000204070002000701
10733622235280705076408040252370856480506076202033602688304050602286505032427560801
10000070000080203050006050500070008000404070005000500000007020002000007000000000801
13838020784062703087428460402027805042434050858224274337338050222076538422363682201
10000070003000008000000000503000008000000080000000000000000030002000000000000000001
11111111111111111111111111111111111111111111111111111111111111111111111111111111111
