11111111111111111111111111111111111111111111111111111111111111111111111111111111111
10800000000060000000800000003000000000200000005000003000000020000000000030000000001
10308055686030347047607043207433504780202045306036507323306088448050882050664264401
10002000008020500060005000800000003000808000300040400000003000000020005000400000301
10533775407022502750602670805348736572304540703450503326734524572446708486202065201
10000080805000800000500050308000002000008000402000600000000040000000405000807030001
10858040606360763574206470702020202038356062327035475025776020707330405070606040271
10006000500030000000802000206050200020002000000070008000003000707000700070008070001
10503627534027686520527064727080475440207467274423605020308286223030743045887063401
10300000005000000060006000200030000060700000000000607040600030000050004080000060001
10325788207253557075607450707267422040203047475840306054782020246425704020567850601
10000000700000004000200000600030004000802000800060703000004020002030004020004000601
10704580603683708480752652226080768680407268507080302083405074507020857048804074601
10400080700000505040000000000080000060300000708060707000803040003000200020005020201
10533340532326804040468265457383756020727570602040506550302020448858502080557080701
10003000200080005060000030007000000060000020606000400050403020300020005030200060001
17407053507030507060528020522080824358865020604327487040506080678030588740305237441
10402000708000405060008000500030000040000070200000000060507030006000400000502000001
10304070603267364063706532403066663440607830285488728526508084308238504023705040501
10004050600000006060300000807050004000400050400000700000004030002000707000700060401
10306080583086704080332420303040405066287020304330304536585030307080804080803876301
10403040003000200060000000306040400040000050200050005000600080804040804030407000501
10646085705250745637233364404820334266247260377024405040806480708070508460582070501
10005030008000200000000000200020000000300000203000203050406000503040700030400060001
10803060656826308243477650542058706370705277502050474060866088267037676050806658551
10807040000000307000000080003000300060400000007080600060000030005000000030606040001
10204077728350705030458084708440338020278257837880504353345720307220664630305020601
10503060000070002050006040200000600080500000002000600000000000600020000040802000601
14506030288026627040408030704432304580803044605047734667368662475070547050703334201
10007000407000008050208040600000300050008000608000000000000050005030003050800070001
10353676804080308040207030704777705046747720705746707656735040404085507050302040201
10000000005040200060707040606000603050004000700000600070002080500040006060303000301
10372568675070252530608070625050402060264044683560704020406070708740536040278536451
10000000200030005000504080003040606070000040006000807000705060404070004050000000001
18857735207036604063705070706250308020885580802043727487606060708063352062668387301
10000070007030006000604050408000602070005000707000003070004070508070000040000000801
10255070563740537230602058702062565045382026605332605070847080704020733640343540801
10004000400000300020207080002050000020004000700030005000600040604080000000600000601
10805865244227707050806050583070526660306540784360738477503460303020254653703755801
10300000000000203000805000800060000030600030000020005000002000600020008000804000001
10223667654380402537708527802238507020834027676030885030657030833744528053703085851
10300000500000600000200000008000502000507000000020500030300040200000004000008000001
10302068404063272770456625885550308722402037884880603475505535705478603620378657601
10303080004000700060200000000000505000002000800050600070004000705000500060007000701
10205630803220204040504086835576607060378746508070356020664060866040704032572070501
10400000806000305000206000000000600060800000002060006030000080008080508000400020201
10886542726046207888407428643680805070207488634472205086425382404760607720807248601
10000000007020007000008000200040702040700020000000003000006000600000303000400000201
10625266807720583074643040208470204370557030602862586686605020637244524030827350601
10600000202000700070004030800080800070006000406000000040800020200000000020004000501
10505080408027208280506520604040548054205023265085722050702380705052466040502023301
10003040208000005000300000502000600040304000300080000050400030003000005080302000301
18678770606667884060873875808332608560708450306780248840282626444846706046806060601
10000080203000000060400000204080005000500030300030000070700000400030006070006050001
10876080207040484520403260205030333084347074302060678070708860406080488540507022471
10002080508070003030004000700060000080005000206060406000608030006080600000602000001
10408420808050505020366063636732647250803340775040606066605084447020407232608877801
10200000602030203050002050000000000000600050000040004000706000008070402000006000701
10864638604020603030505080405254232584733074852047538540505227808022204052383040801
10003000007030700040704000400000000020006000008050002000205000008000004000002060801
13422033552060372270702086265532684080205223606030785070504074627075573077602030501
10000070000040600070606000006000300040200040806020000060600070006000004000400040801
10532540704850363070807536407050307760802050504335373370372850604765705682372338601
10800000400080000070500000406040400000404000503000000050200060400000300020002000001
10306066236027664630278870875040504622202565504020373080303040767360202070404028551
10006000403050000020006050005030400060003000600050300060304030006000802000708000001
10342360703020407060602070506250445030582040543860408226602078855042206078602860301
10005070004000704070500050700000800060000070800050700000002000800080004000800020201
10404040752253508062424676506027537770652670304070664226653240204263862040257063201
10603020006000502000000000508000700070400000207040000000000060004000006030008000301
10802036528080507543835370806626505064808632205080455477855073664225608580804560801
10505000004060408000000000300080005000405000606020600040007000200000500050400040801
13706668403058806073232664775050408740625070503025808050305670305550703040466050601
10007000007000002000800000800070200020007080006000705000300060608000808080200080601
10234077606485604330806330452360423048402042288350308054468830204058562024307330601
10005000500000500080500050006000607020007000500020505000800000502000003070007000701
10605550504250577630666037702060507020602440202080402840503362204027806030432022501
10200000500040500030005000800020700050203000708000208000407000306000203050002000801
10525354678570506038502040353760537260706042806063807236404030202335502032476420201
10000080000030408020007040300020002000207050002000400000007060004000004000000000801
15457080585066307028658760808055802032434070752327734452372050858047448228737226401
10000080007000005000000000208000004000000060000000000000000040004000000000000000001
11111111111111111111111111111111111111111111111111111111111111111111111111111111111
