11111111111111111111111111111111111111111111111111111111111111111111111111111111111
10400000000050000000500000007000000000300000002000006000000050000000000030000000001
10606087584050882047402037503375603420706086204072703545308087878020852080322786601
10002000003020200080006000500000008000705000500080300000008000000060008000600000201
10354325503066606580702420304635336658408580404740503574465377444858405788808065801
10000040507000300000800020706000008000004000203000300000000020000000305000402040001
10864030204640785774705380604060203026428053774028256026263070504450404020703060421
10005000400060000000806000805030400030004000000040002000006000504000300020004060001
10303446335078453330576085635080534430805422756864406020307824263040536088638034701
10200000004000000020008000400060000080800000000000408030200020000050005060000080001
10242425803336355022708250607353386080207088827680706044883020286622703020734560201
10000000400000002000200000300050005000404000400060406000003080002080005080005000501
10408820808435302430286246274070868820402668807060604054303075703020385027806056301
10200080700000604040000000000020000050400000302020202000206020004000200060007050801
10864820628865804070582245847675283060343380803080706350803060647774608060688050401
10007000200040007070000080006000000020000070603000800040502080300020004020600050001
14203052806060202060533060325080548748744040207464483070604060263020245320203385351
10707000704000507080008000600040000060000070800000000080305050008000800000608000001
10304070308782522024204754708066288680705570527553654747606033605654408037208060501
10003060800000006080200000605020002000700050300000500000004080003000703000300020501
10207050736035807080436570506070706035283080804360402767542030206080704030208487701
10508060005000300050000000606050400030000080700050005000700080808020708050304000801
10725064807460286576735578405730333255352780475042605030704420705060404670443050301
10004070003000500000000000600080000000800000607000302060604000805040400050500040001
10606040742838508833822570846023808240803722806030845070628066766062855020704462781
10503070000000607000000020006000800080500000008050800070000040008000000080305030001
10608065343680402060427028307760524040873464554330206466255380703880284260304060601
10707080000040002040007070200000600060500000005000200000000000700080000080606000801
18602020872036848020208070208558607870506055502077755358265347336060885060407865501
10006000707000005070603080800000700070002000302000000000000060006070005060800070001
10324824403020503080207050406762705038673270606378403283457060304025204050802030501
10000000003050300030304070502000602060002000200000600080005020300030008080806000601
10387477367080383530405040737060807020255058635330402020308040402670558040438422641
10000000800040005000602070008080702060000050006000507000403050802060007020000000001
17373885607023603082808080504580308070573850706037887833304040703062258058627472301
10000080003080005000803040607000307040002000605000002020002020505060000080000000401
10327080327780257620808073403058328084632058402555503020577050707040552440854860701
10007000400000200030408040008080000050008000800050006000300050703040000000400000401
10607568866657404040603020678060328370507820332570873728808450508050642766302286701
10600000000000308000408000600070000030700060000020006000006000200080005000504000001
10368335525770707735206748607376602030673084378060865020523080355287477053805036441
10400000800000400000600000004000508000506000000050800040300060300000004000002000001
10802076804082386370872852564620508225203046378440702885804432607557304420668773301
10304070007000800050200000000000308000005000800060700040002000406000500070008000201
10804260605530504050202052678627606050754354503060452080465020472030305066446070601
10600000807000802000406000000000700080500000008050008080000060003050806000700060601
10424533864057806674203554248580502080603387632426306026684425806380703450505428701
10000000002030008000008000700040305070400060000000006000002000800000202000400000601
10547323204570254084525050705340606880672020705537562485807060845636348070735330301
10500000406000300030003050200020200040003000502000000080600070500000000040004000701
10803040507026706760705340605070566054802027333044622080303760307042644060802082801
10002020506000005000400000607000500060407000200080000030800030002000006050703000601
13664250704586636080637557204857603760408350803630287470887563288662504057408040501
10000070703000000040700000406030007000800030600060000080200000200070008080002020001
10277050205070546580808250305020755034836035404030345030403350508050225340205072241
10004080604050002060003000800070000060007000203040506000703020004070200000803000001
10205560307020603030263072785845247720407440678070803087302056558020205255705848401
10700000602060502030005080000000000000500060000020005000406000005020403000004000201
10823463804060408030205060207255437848784028863026842660707554204064505042368030401
10003000007060700040506000700000000020006000005040008000806000002000003000002050301
18673074558050673360402058426624557070605338704050762080803048872033356046202080501
10000060000030300080602000004000200070400040704070000020400070006000008000500080601
10886720505330653060704232702040602560405060606865788450423740308536508548374284701
10500000300020000080800000606030400000404000702000000080200030300000500040005000001
10205035877062668570627720476020502527807883204080852020807050754360607030503026781
10006000507020000080006070006030200070005000500040400020602050008000403000304000001
10626840502060606060705040802880525060722020244680404777303036564052205057703340201
10005080003000306020600070400000300030000030200050400000006000800070004000200030401
10507020626736702052828586403076785320563240204080386833257370705438746060833032601
10504030008000203000000000608000400080700000303050000000000050004000008020003000801
10705058253070507556878470505473304043602568403070862427762046667883705770308470801
10202000006020302000000000800040002000203000602050500020007000300000600020500020501
14506873304082706063564243832050507670363040704087204050403740306270705030845030301
10002000005000004000500000200030800020007020008000204000400030206000206080200070401
10772058308338208850207540725730322025204063767660204033332280407025268082705530601
10002000700000700020400060002000405070007000800070505000600000504000004050008000401
10706580608840522760472043305050208080702630605020705280602472506048403020456028701
10300000500070600080005000800040500030805000702000302000406000308000805030005000301
10736356886470302042603040652880475230408077505025305426603050507585507083362560301
10000060000050706070007050600080004000702050003000400000008070006000005000000000501
17438060884038804025726420404082302023853050746464554265474050243087652775668445601
10000080004000004000000000302000006000000070000000000000000060002000000000000000001
11111111111111111111111111111111111111111111111111111111111111111111111111111111111
