11111111111111111111111111111111111111111111111111111111111111111111111111111111111
10800000000020000000200000006000000000800000004000005000000030000000000070000000001
10808035774020622062308044806734507730406035807045707838604043565020465070344748301
10007000007040800020006000800000008000802000200040200000002000000050002000500000801
10233627703087307550408240704225524646307230707360305522585478522777302758208044501
10000060503000700000400060208000004000007000502000400000000030000000408000407080001
10582020707430678362208630806060705085385066473083847087482060606370502070706040271
10007000700060000000808000706060800080008000000070002000006000303000400020007060001
10305562726047756220745075744060888550802654472576708050606588445040327034846057201
10200000007000000070002000700040000030300000000000803080600040000050004050000050001
10724444303452482073606780306547428070208032463540708038744020282344503020582830401
10000000200000004000200000300050003000705000700060702000003070002080003070005000801
10308420404243306440563484787060548570502435406050705052406087204070562025306043801
10600040500000206040000000000030000030800000707070707000602040004000600070005030501
10767230844854806040888384533822633040267540606080207280704020873475808040568050201
10006000300050004030000030008000000040000040504000200060807030200080005060700040001
15307035503050705050822040553050265555872080808588648070207020244080676480304877571
10303000706000408030003000400020000080000040300000000020806080006000200000602000001
10605040706584344058806446607055766360304550888745884256808062807373802035408040601
10004050400000005030700000507070003000500070300000600000002030004000602000400060701
10608060726085507070232660508030506044428050604340807467343030206050203020602368401
10804020005000400070000000704030300070000080200040004000800050505030205070605000201
10367028702880468865588426403760246647773270572024807020708840603040602470538030201
10005080006000300000000000400030000000800000306000805080207000402060800060600060001
10402020757563804235535740638054503570708645603060625060866053575032854020605874231
10204050000000808000000060007000200020300000002070700050000040006000000070807070001
10402053452230708030852024707650233080773378742240703533377760705330558850607020601
10205030000020002050008080400000700020200000008000400000000000200050000060503000201
16807060247025523030207080503464702660805026505078787676225774858080848040604378401
10007000208000008030802030700000800050004000508000000000000060008040002030300020001
10223278402060804030807080808363404083535540306755307273548020205085803070605040801
10000000007080800070302040408000706020007000500000600080007030200070008040208000301
10836586222040574880707060562060304060728025627520408080802060806570246070465765841
10000000800040007000502040002030603040000070004000603000304020602030006050000000001
16688364807033502022306040202360208070536620605038762575705060203032278056825666701
10000050008060005000707070508000308060008000608000002060002060403070000060000000501
10876050485350322730703037704036232083735065208372703070664030605080823320752650501
10003000400000500040207080003050000030003000200080004000700070406020000000600000801
10208723675546205080302070687060434620408720243480355776604750407040452483305478801
10300000000000202000502000600060000020300060000020002000007000500040008000808000001
10784566466220402385704884505872808070282072768060226040833050623564472035703025761
10200000500000500000400000008000304000606000000020800080300030300000004000002000001
10305054603066285480452723534820202452408082677370505883308354602843506350544244301
10303020005000700070400000000000807000005000700080200070002000708000500080008000501
10204850407360803040308032745566603070242824805060548020624070627030803084257070701
10800000207000207000708000000000400060500000004050007060000070006050603000300080801
10465426484038203588605887774460605050607223452775502088257728505550305440707332401
10000000006070006000008000500050605070700070000000002000006000300000806000300000301
10236377607360368082545020705370806840874060304577358686706020275828542050534350801
10300000402000700020006020800020500050005000307000000060700070800000000050004000701
10407070505056406540808570508040476075808072555055588080506460305082874020408085701
10004050607000004000700000607000400070705000500030000080300020008000005070302000601
12754320806473744020852438503838507420205580208530278380425766373877207023405030701
10000080704000000040600000802060006000700070800080000050500000300060004050002020001
10648040403030857860205280806070774022676072302060255030406530207080644360302088681
10006020303070008080003000500080000020003000802030206000304030002080600000504000001
10404840706050303050574034567225565620707540383020705035402058467070408288802224501
10500000406030207050003020000000000000800080000020006000304000007030402000007000501
10328223508070504080403050206538786658333088534076545260604875705086203075883040701
10002000008040700020608000700000000080005000008020002000307000007000006000005070201
13542062855060656460302067258536523030307363507040584080302067243026257046302080501
10000070000020400060603000005000800060200060808050000040700060003000004000700030601
10764260506770365050203466604080602270207060505647543360248380206543207374678343501
10200000300030000030800000604040800000203000407000000080800050700000300040004000001
10804072578073787620267260576060307544408263205030354080408060288650808030507036531
10005000303030000040003030003040500040004000700080400080804020005000503000208000001
10354240406070706030802050402240638020275020643480204565205037536082303026406640701
10005030002000602070200080600000200080000040500070500000007000300040003000300080601
10603040832452205025588444506073488580286450206030343345662630306384445050582082201
10707080008000805000000000708000500030300000207030000000000030003000002070003000501
10703057327040208488465370305656303043303727407020744472337067674648408380708670401
10408000005040302000000000500070003000203000605060800030003000600000300050600030801
12206236807077805077782842455080505450847030707042306020406360202430705040848070501
10008000008000006000400000500020500050005020002000403000200070402000206070800050601
10425037203664406680807770757720457078306046287670206088735580403022447063204840201
10004000500000400030400070003000702020006000500070705000400000806000002080008000401
10504880505860886730464063702040202040308370202080807330207457303085304030778025801
10400000200020300080005000200080200080803000203000805000207000607000506030008000601
10652575558580608062704050786380578570503086706057406262306070505733508037423480401
10000020000060302020004020500080007000505030008000400000006050007000005000000000701
14338060436033407074858270408088805073627020332275678588477070246057283345254865401
10000060005000006000000000502000004000000060000000000000000040007000000000000000001
11111111111111111111111111111111111111111111111111111111111111111111111111111111111
