11111111111111111111111111111111111111111111111111111111111111111111111111111111111
10500000000030000000600000007000000000500000006000008000000040000000000080000000001
10407022286040735033406064204665604430203075308042804855403057238050365070374336301
10003000005070300070004000500000006000506000400040500000008000000080006000500000301
10582232504074208880406230406364475334806350406780707645646872668457607353302085501
10000050405000200000200070407000002000003000303000600000000080000000805000306080001
10777060404480424867306520802020706025742072883024233088278030502630502080704060371
10007000500060000000204000308070200060007000000020008000006000407000600060007070001
10508734665034652450364038355060724560302565567277806040205355446050246067458032601
10200000007000000040005000600050000070800000000000707020300060000030003080000070001
10446748508388357077306380606752624070304048858520807055328020772447807070527520401
10000000300000008000600000700040006000507000200060202000003080007050007040002000201
10205880204477405450777578356080255620807524702080504026504058802020737063705048801
10700070300000604040000000000080000070200000602080406000803030008000700070003070401
10634660875224808040722663584424437040852860402020206230405030846546305050754080801
10005000500030005070000070003000000050000070505000700070605060600060004080300050001
16306067407050204080482070337040842472774030302344737070507040337020566760705525671
10802000307000303060005000800080000060000030700000000030805060006000600000305000001
10207030405472572042507635308045285220807770378825824563806083607586706048508060401
10002040300000007020200000508050008000300080500000500000005020004000204000300080401
10803030876067202080782270207030402082346080803520506282646080403020506040205235301
10406020005000400030000000508060600070000060700050008000500050502050808030707000401
10337032604560772746348424703880852255248650257086807020807350707040705680787070401
10008040002000300000000000800060000000700000703000402080206000202040600060200050001
10605040546447305586443830285055602880706526207030368070748044647066666030408233581
10604070000000607000000030003000500020300000002020600050000020003000000080605070001
10403073284850708060552065804260426060348333353640707623323370706420426260702070601
10302070000030003050006060300000300050700000006000400000000000500070000020805000301
17608020276048868040604060604523205430308062305084623858344725688070746020702328801
10002000504000008020602020700000700080006000205000000000000080008050004060200030001
10247542407060303030503030702235402036366880708458204848663070407058706060808080401
10000000004060700070405070205000806020004000600000700080007080300040002040806000501
10245256272030526630704020383030204030573048767750208020405050708470776030655365331
10000000800080007000307040007060606080000020007000605000703030208070003060000000001
14432438202073807054308050602640208020335830607062886354506050604062767068878346201
10000060003050004000605040807000408070005000606000002080007070202020000040000000801
10573060844880756660308056502085243038886077208678303080553060707050883760752720801
10007000300000200050307070005050000020004000400070002000700070203080000000800000401
10804283462885404060208020662040286720606760823220858778705340506030574555604642501
10500000000000605000306000200020000030600080000020007000007000500060007000404000001
10855353476570504848305526508262404030856023742030322060243060358663258072806022741
10800000600000500000400000003000804000305000000060400060200040500000004000004000001
10806065603033766740776576373420304737508033577380207628407424203287207330566387601
10605060003000500030500000000000307000008000600070800050008000704000600070005000701
10506640207660507080202068837623208020636745402060235050868070476040305038577070601
10600000507000602000803000000000500080500000006030006060000050004070307000400040701
10523544455046804278606776255250506080508337224756205065468283306360306830402687701
10000000008070003000007000500020602020200040000000003000002000600000704000300000301
10455472408240423066557020705350405760426030208337434323203070848287855050748250601
10800000708000700070004040200070400060007000506000000020300020600000000080005000401
10404060304073308230503730302030278085406075645032375080604370505053266020406046701
10006060804000003000300000306000400070608000800070000060700030006000007020406000701
14244550206582256030742858604674702850206580605340857650478387654276406062203040701
10000070302000000040300000808060007000700050600050000080400000300020002020008020001
10588020702050283270505630206040476075635062203080666050706870408040523840508048451
10003040508020003050004000700020000070003000805080602000704060002050700000704000001
10407250802050405080648053573548654320202740448070804083504036238080307733403747801
10500000404020203070007020000000000000200040000050003000204000005060207000006000501
10374335607080508070504050808787584766447088622058526230308222507057705074722050601
10007000005080300040605000300000000070003000003070007000205000003000002000007050801
14588052338070786570305087833777456040308842707070533040806084528052842054706080601
10000020000060600050708000003000800040200070506040000030300050008000005000300060701
10622820808330724080408524308070208340206070608288423280432440305384607382872233701
10400000200040000020700000705050200000306000204000000040400070700000600070003000001
10303055334032585420223280263060204823307543203030886020303070447750704060706072461
10008000206060000080003060004060800020003000300060600030207070008000404000507000001
10344250706030804050803050703630252030376020824680805225807078343064807086603620401
10002060003000804080800080200000400040000060600050700000007000600080006000800070801
10308070334732308056327555506025284240463440202020733868356220302883227060666077501
10806080007000602000000000706000400030400000706070000000000040008000008080007000801
10802065476050608526664650507456507055602485202070267225782038484346706660603660301
10406000003040405000000000700020006000707000205080400070005000200000500070400080701
15405228707067604035864364247050402860554080302028807020804330503250505040483080801
10006000003000007000600000700050200080005020003000204000500060602000508060600070201
10346086305727805840508750644730523087204028835520206024853820704084555024302330501
10004000600000300050200070004000705050008000400060508000500000804000003040003000301
10503350407640482350583082208020707080706330207020704360206354805075303030438063501
10300000200030400050004000500030300050206000505000506000208000406000602050006000801
10554842774540508026707060742260753680608084703026307626208030405227405076735880501
10000060000040304040008040800050007000502050002000700000008060008000004000000000601
15324080755068302046352650308044502032428040675522465573568080248083757288372777701
10000030006000004000000000802000008000000080000000000000000040008000000000000000001
11111111111111111111111111111111111111111111111111111111111111111111111111111111111
