11111111111111111111111111111111111111111111111111111111111111111111111111111111111
10300000000080000000700000003000000000700000002000007000000050000000000030000000001
10308052568070828082404048807888808630803043202053408243207036587070778070685447401
10003000006070400080007000400000007000706000700020600000003000000070004000300000501
10268334704035606580205380707556742652504830303620608458325277368683807842805053401
10000030804000400000300030605000005000004000407000800000000070000000508000508070001
10652060403870376772507840403070705074384086257057453022835020205780405050708070821
10005000300030000000507000708030500070004000000060002000003000408000400030008020001
10808782338066526230227036583040583820505464768444604030206283835030487028866062301
10800000006000000060002000200020000050500000000000405030500060000080008020000080001
10288674704742887036703580405222772070307038884350604066528080542822406080462730201
10000000200000002000600000400060002000502000800060507000007030006050007060005000301
10308750403352505280364556642020232350207337604040408072604065806050346066302073401
10200060500000804040000000000060000040500000803030608000506070008000800070006020601
10737630446438802050763788586265426030855420703060503520304050343544503020347040301
10008000200080004060000060002000000080000030704000300060803020500070008050400070001
13204048303070802050342070545070862766675080604836684020406040853020332630603534571
10604000805000503080007000800080000050000030200000000060505050005000200000708000001
10305080507552852065603753708042552640602240872644742532702033505776808044405050801
10002060600000002030500000603080006000400030200000800000008040008000508000600050801
10308060435057704070886370408040706078255030602670308478725080502070802050307852401
10206020005000400080000000702030200020000060400080004000700060403020206030402000801
10622086803280278222572747803740686623822430868047303060402530203080608530774050701
10002060007000400000000000600020000000300000402000505020707000804030700030700050001
10707020247646605637825460386044204520405584705050235060745025232056483040206687361
10806080000000407000000080007000300080500000003070800060000080007000000030802020001
10708026278760707080778034303780584060877468233820706543674230306660328540402060301
10207030000040006080008060600000700070300000003000300000000000200050000030202000801
17403030466078642050605040407258706740305062806066672286235352648030646080305675801
10005000707000006050706020300000800080006000207000000000000040005070007040700020001
10645732707030407030303080407285407064373380305335604277452020808067402050204030701
10000000007080500030508060506000406030006000300000600060003080500020008020602000201
10882373328050834460704030558030404030737023264380703030502030408430884030553388541
10000000200040008000505020005040803030000080008000608000804050202060008030000000001
16434886502045608086305020503740305040757730807032526768804040706085827055267585501
10000070002040008000205030502000803070005000608000006060007070304040000060000000201
10645020528770842760804058602087563064545042405737603070725070203040334450477660601
10008000200000600050802040005060000060007000800060004000300020408020000000500000801
10708566752733608060207040537040567470807270882620874736207460505050424853804343801
10600000000000606000702000500070000080200060000070002000006000800060006000307000001
10342252452220804563306572602872203070637058777040557030754080536467642067203047461
10800000500000300000500000005000203000502000000050600020200060200000007000005000001
10704038807066465670778352538780602234708067842380703558705832506272308760363687201
10703020004000400080500000000000807000003000400030800030004000203000700040006000401
10706630604230505080705072564342407030848347805050646040734050763070206074625060501
10300000802000805000503000000000700050700000004050007060000030005020508000700080401
10488567625067607827608634848740704040508636733286502057555223204840602750302344401
10000000003070006000003000700080503050700040000000006000002000400000705000500000401
10272855207450366053644020206760207870434020202743375546608080558243335070423530201
10700000408000400030003020200040600080005000604000000060200020500000000030008000801
10506020406038505330403620607070752065408083785027728050303270507025344070403086501
10004070605000008000700000306000800050507000200050000020500070004000005030705000301
12365540508333624030276783808555507280204860406440764670282667367752706037403060401
10000040204000000030300000805070008000500080700040000050800000400050006080002030001
10366070608080525830505340805060328026836083707030778060308330302070483820503055821
10004050706060005040007000600040000060003000704060707000608060005040500000304000001
10803230508050706040533046527846358650202250666020708077306024527020704864806624701
10200000803020405050007020000000000000600040000020006000203000008040605000005000301
10277278807060605050807070406642825846686056628055425730502457702025608064886040701
10008000005040400080602000800000000030007000008060005000407000005000006000005020401
13866025687060665430807027267274835070302885606070888040202086733052657042302060401
10000080000020500070404000006000800070200020406030000030200080007000007000200020501
10476350808630754020305768304050803430804080404357375630864670202232504675365677501
10500000200070000040600000306030500000403000405000000030200060800000300080008000001
10208032227072563420482570456040502275404338703040578060702070783280407050705072851
10002000703040000040008040002070200070005000800040500060606020008000702000802000001
10248270602070202070206050806720643020263060322420306444205045463044805028203420301
10004030005000406080600070600000400080000040600020200000007000600070004000500050301
10402050532734602086485546206075642560457530804030446674487240202286588040747036801
10802070005000805000000000808000500020200000307060000000000050007000003060008000601
10703082238080606432628850502688307088604287504050786556446046727335407670805260201
10204000003070802000000000800070002000503000406070700070007000400000200060200080401
12803786408085408043272656457040602260754060703025304080603320304230704020254060401
10005000004000002000300000300040500040005050005000205000700040406000407080300050601
10557052707427506740604670356660868047802066247260804052888270407064345028802270501
10006000600000700080600070006000604060005000400080805000300000802000008080007000401
10204360604280646830324056204060306020303670208020403440502378505034503040325062401
10200000400070500030004000300070300020207000703000204000407000502000205050008000301
10723388383870504084407050454850252320804054308025504254503070702564505037567420201
10000070000060407080006050700060003000203050004000500000008030003000004000000000401
18465050383048808032837780705062202062647020784246728378665040263035787435227237701
10000060006000003000000000407000002000000060000000000000000080005000000000000000001
11111111111111111111111111111111111111111111111111111111111111111111111111111111111
