11111111111111111111111111111111111111111111111111111111111111111111111111111111111
10300000000050000000700000006000000000800000002000006000000070000000000020000000001
10402073447060263043302055403846607620405054702088703768508046728080285040724284201
10005000007030300020005000800000005000506000800020800000003000000060008000400000501
10435233707083308650703460602755488486508830505820703624662648253326504882507063701
10000030402000600000800070505000002000007000308000200000000070000000302000807070001
10566040808620577745805280203050806042885046624076742036638080404740204040402050471
10004000600050000000205000806050400060004000000060005000004000305000800030005050001
10605737877042263330734036352030324370203552746746805050402872352050334083326057401
10300000003000000050004000300030000030700000000000607050400070000050008050000060001
10377886802782848074802880702846267050702063244430205052347050744485204080784520201
10000000600000004000800000300020002000405000500070605000008070002050007020004000501
10602670205444503430446855456020424260508637405060505062707077506020877088706074701
10400020700000404020000000000040000070600000403070503000208030006000400070003050201
10483680833242604030672836387382537020853820506060602870203060384626305020856060701
10004000600070007080000060008000000040000050302000800060402020400070006080200080001
18608054607080504020457030377040336363734050802328248080706050447060476350604287681
10307000303000205030004000500040000080000040800000000070208050003000700000404000001
10503060503278338054202338405053656260604730654675537483404046308525406052406050401
10008020500000008030500000505030005000300060800000400000006030005000302000300050201
10705050632055707030558320703020505052562020405840603324747060306050803080308434401
10207070002000500050000000605060800050000070200040008000200040702030308060408000501
10628076703650373588227662204670332845377630856043803030708870405070507370328080501
10007060002000200000000000800050000000600000407000607040608000307070600060600080001
10504070776387705235428720432036805480708824703040588020662047248074487060308642451
10506050000000205000000050005000400030800000005050800070000030008000000030306030001
10203037734530807040285023207660634020666486258460804233345220304340678240503030801
10203080000060007020005060600000300070300000003000700000000000600080000030505000401
13206040838037257030606070305278203460402043802067763258745436835060878030506565701
10005000705000004020208030400000800080004000402000000000000050007040008080500080001
10474266805020406050208080508238604034773620307645607336253080505027802030805080401
10000000004060800070508050308000207050003000500000200070007050800060006070707000401
10872324243060834230303070426050505030327062263840506080207060606640828080683677231
10000000200060004000808060002060702020000060008000302000206080706070004070000000001
13643364706077508026202030602760502070662730507026863773805070207074237085775625301
10000080005040002000308070308000802040005000805000008060002060705020000030000000201
10763080476240576260803072605058888025824032608758403040762030504020478360346280301
10006000700000500070603020005030000020007000500040008000700020404050000000200000601
10706723462732703030707060777070376280803740782460475733802720404020824483705737801
10700000000000805000807000600020000020500050000030006000004000600080004000404000001
10582235673760203236804723807275603060482063845020426050274050434737244045706058551
10600000600000500000500000005000806000302000000030400060200040500000002000002000001
10405026308063347280887357232680807328808062546720502863302347402378806230728654601
10203060004000400040800000000000408000002000200030300030003000202000200020004000401
10503330506370506070708076663887708060644784707040256040774080554050506033422050201
10400000705000708000206000000000600040700000006030006080000080005020407000600040201
10348762527066305643306678466370405050502548544227606068632422506470506850204873801
10000000004040003000002000300050303050300080000000004000002000200000207000300000801
10353377503380676023784070402820804320756020806628367728403040427434362030426450701
10200000204000600040003070800070800050003000603000000040600070800000000040007000601
10302030708056203860404250208040856026704078724048746030306660508023786040606072801
10005060203000008000700000804000600060707000800030000020300080005000005030804000701
13852880408847244060648854706456307730305540303620722330653758677685603064602070601
10000070206000000030700000204070006000600080500080000050200000700060003030002060001
10655070204060446450206430707060226038583024605030753060604360202080448220804053321
10008030505030007080005000500050000040007000304060302000805020006040800000602000001
10302470604070706060823057332433787580608480747040404084706026447060806623302643701
10700000602020308080002040000000000000300040000020005000707000004030605000003000201
10465275403030203080805040603256732628664047246053543750407534805054703058654080201
10005000004040800020404000400000000030004000006070006000604000004000006000003070201
12632038782020447250205058333755473030408756703020583070305078267085663046705020701
10000070000020500080408000003000600070200040307020000070600020003000004000400030701
10453650708750556020408768505020603530703030403457344270362880207446308222585256301
10500000400080000080300000605070400000808000306000000030500080400000400070008000001
10808045872086335630462460368080702336607644207080862080402070635330404080803023861
10007000602080000070005060007080500040003000500020500050207040006000204000704000001
10445640503060306050806060507720347060223080338820706648403057883025202082203570501
10007030002000804060500030400000300050000050300030300000004000300070006000400020801
10406080532325506068343368807054323250585880505060874573555760307747526020628035401
10306060003000506000000000405000400050600000403070000000000060004000006080004000701
10603043687050208558258420208666202067604725208030457622872086222328407880403270501
10302000005060602000000000400030002000705000504070700080007000700000300060700060501
15803573603084302066272654764030404640736030202052508080306260208830808080626070301
10004000003000006000400000400060700030007080002000603000200080606000508040300060401
10774078603524608770204360455680573072408034626760307033834870206048528073304850201
10003000700000200050400030005000207080007000500080508000300000506000008050004000801
10505680303560322320352087503070404060604780704060502780403374308067802040428057601
10600000800040300050005000400070500040604000703000404000707000805000504040008000401
10555642858820405065307020235830234830405065502036607442802070506536408022876420401
10000020000070708080007070400070007000704030007000800000002070003000004000000000801
17272070246067204075344460803076402025742080853567652535652040685042676245375547201
10000040003000002000000000506000007000000040000000000000000050005000000000000000001
11111111111111111111111111111111111111111111111111111111111111111111111111111111111
