11111111111111111111111111111111111111111111111111111111111111111111111111111111111
10700000000030000000400000008000000000800000008000008000000050000000000080000000001
10305086556060342083206048707636608870205053302033706632207047254020458060747365601
10002000002040800040006000700000003000406000400020700000006000000020006000500000301
10442283802023703670208350607753684828306770703260305354567882353483808658202036601
10000040207000500000600050504000002000004000807000500000000060000000304000407020001
10867050807580585684803860206080605045667075228035433025264060708870205080703070841
10002000700030000000808000402050400050005000000080006000004000305000700080004050001
10304228763055483250363026654080287640507874775546604040208346453030366026222074401
10500000002000000040002000200030000050800000000000706050300050000080008030000070001
10436432503426644064607770702786477080707073454830807073867050453738602030673270501
10000000300000005000600000200040004000203000800070804000007050008030007040002000301
10307350608655304580456384585060658280403685703050802086808062608060383043603065301
10500060600000202050000000000050000050400000402080504000305030005000400020007020501
10576780778766405020622537223765866080227430805030607880203040742674205070676020301
10005000400080003040000020007000000070000070207000700080205060700030002080600020001
13704023808060707020723030588040387274888040705376578040206030388030765480605233631
10805000807000402040003000500070000060000070600000000050402040003000300000402000001
10603060307422368084608762208066245320703420365867584284805043505823806057704040301
10003080800000007080600000405040003000400050300000400000002060006000408000400030801
10303020323038304030528730404030703024883070202420607745486060207040603030405378501
10802020007000700060000000307050500070000080300030008000200030307040407020207000501
10342057208540885288776363502380288626273520568044207020406480303070602630382080401
10006060008000500000000000700070000000400000706000606060402000606050400050700020001
10305060264246308427236250384057408230606265207070322030482083857078575030808444771
10402040000000704000000060002000300030800000003080600070000060003000000040804020001
10205037257380808050875057207840733080263536744230506652568680704720283870704030601
10302050000020007020006080600000800060500000003000800000000000600030000060702000701
16503060553026342060205020503324604540705078608026363267736367836040286040404334601
10005000202000007050504050300000600070004000804000000000000070002020007080300040001
10324468606030705030303070707744304057534630304387304668487070302025507030202050701
10000000008050300050508060306000605030008000600000500030004070500030003060203000601
10332848352040857750608070585040806020444082856760402080304080607250876060362464841
10000000200060008000702020005070206070000040002000207000305060705070004030000000001
18358356203078505087808020508520504080525550404074334486406080708086285046368642801
10000070003030004000208080604000802080002000407000006040006060502040000050000000201
10226070764620822650307046706068545056442052507557405080428040808020575340487320301
10004000600000700030506060003060000040005000200060007000400050608050000000600000701
10204243287644202070708040235030768250307360675830326348304380702030486365508656501
10800000000000202000806000300080000060600050000050002000005000200020002000302000001
10877585458760406443606822505328605070285045348070446040268020373478733044202042321
10500000700000300000800000006000408000402000000060300030300020600000004000003000001
10307076202043777460723456448430402886402073482880604383502363408635207270225286601
10505040005000500060300000000000402000007000600030800030003000705000600060005000401
10307640603560802050705074224355803080387575207050274050285070348030702062848030501
10600000702000702000305000000000600030500000005050004070000020006060704000200080501
10874234774088806263408668322230705060202463477658203052744486602430808740408764401
10000000007030005000004000400060307080800060000000005000003000700000607000300000701
10587765505260663087327070407850602820586050305844645546302060486326323020688280601
10400000702000500060007020500020200040006000207000000020400050400000000080004000301
10205040704072203830205330504050662073206048488074627040506720507036328070502044601
10002080707000004000700000802000300030207000400080000020200050008000006080608000801
16882240608484766030485878603435705460702370505370738840726383728374402024508060701
10000030807000000040600000206060008000700070200020000070300000400050005030008020001
10266040307080343860203720508020362072425062404070534060602240507020672770407043281
10003080304080005050006000500060000080006000707070507000508020004060400000305000001
10606620504060303030855046462578663670305530273020405034603087237020602252702438301
10700000404060802030002060000000000000400070000030007000608000004040508000004000201
10342356502070505080202020202323225577732028753086368420405234207025605047833020801
10003000002070200040607000600000000020002000002070004000203000004000008000005070301
13465068825080524230702076587566727040404575508060278020203033262036745035305030801
10000060000080300020604000002000300030600060307030000070500060005000006000300040601
10733540707480772070602867508070705370702080407487882840888760407367703622256287601
10800000200070000080200000203070500000403000705000000070500020800000600060002000001
10802082673087586220788680636070208677807628505020285050607020262630502040604034241
10004000603050000040004040002080500020003000800020600060406030008000404000503000001
10876370805020305080406050806650827080364070325770507574804072254076304082605680301
10004050007000604030800080600000700070000060400050700000007000800020006000500020701
10403060323666607087227784706025537570447540406040782662362740304728865070676063501
10204070007000403000000000602000600050500000603050000000000070007000005080003000401
10207028874080208587774760507538704077803326303040573437227072333428308380706640201
10405000003070205000000000600030006000508000202070200040006000800000800080300030701
18302755605064304056644885755020406740523070703056508020407750406220306050352070401
10006000002000004000700000800070400030003030006000202000400060304000208050800030601
10677052207247307360305540485830278043303034233520303065635480403076827055608330801
10005000300000400040800070006000202060006000300020507000200000207000005070002000801
10608730407870273340552052402060608040308260408020503560407767808022502070563067601
10500000400040200050007000300070800050207000502000507000707000306000506060006000601
10782725385640707073806020324780434250408068803056807328402060804424202043438650501
10000080000020705070005030300050005000803040002000600000002070004000008000000000701
18625020274054304087267850605054703082577070426782547556577030476025537552885754801
10000060008000008000000000303000002000000020000000000000000070004000000000000000001
11111111111111111111111111111111111111111111111111111111111111111111111111111111111
