11111111111111111111111111111111111111111111111111111111111111111111111111111111111
10000000000000500000000000000050000000002000000000000000800000000000000000000000001
13306848345670742870805758586068804038603270204067507550226080306552422537546776601
10007000000080000030700000002000205000400000804000308000300070804000000000000080001
10406684288080438030657525305770606580423242648820402075705230244060667663576080761
10708000700070703000400000700080807000200060007060305000008060005020000060002080001
10806080306040403883406070884030507064805078506060503567582060505065766470802020401
10700020006070004000007060406030002000008000705000700000500040600080000000300040601
10832057363340534040574030408027754250227430607657472460403823723560653726448050601
10003070000020200020004030003000000070000050503000000040200000000000200000006070201
10202220304032203048603042625342337070378080702080882040622345542858806872603420501
10600050807000006000206000000020000060006050008070004040006000400000807000400030301
10565070507235236630504877377780504452504073232087805086803040204240307080724023501
10007000806000000080300000006000800070008070000020805040007040004000803020002000001
13408772502050702066732672436037425080608080608280206060837050454066674040304255701
10003000300040508000005020007020800050407000700050008080002050005000004080800000201
10882760707250577022405030504020807240505258758632237060408080506775808050285250861
10000000700040002000500080800050006000500000000070000070505040300000600030000030001
10287562204038306272672580288850444070587453332060842338302023365860637728526820201
10000000503000300000005000700020600060500080800050000050002000500000200000000070801
10738780732730843556505062627070807323806020604674847030688230808427605628642063701
10000060700030800000004000000060400000008080004000008050000000805000602000800040001
14583370404020307042473683208454402240863037658055427020374587455080602030208820701
10000000208060603000000000805000300060008000003000003070000060004040004080200080601
10343375303070707762304240655030727082477660308647208077837060307032746070373060631
10800040008000600000300020400040003000000060800000203060000030807000000050400060001
18802030708685252840278650204783808073272068804520406045663630602743573428508044301
10005050502000000080000050608000005000008000604000308000000000400080003000004050001
10663060864076333023687042608020363788403580304045706872806722248060602050522070761
10004000400020004080003000405060000070008080702000402000600080005000500040008070001
10405428802050308060722520322022257050765080842250705030544043606047642576304064601
10200020008020700050000060006050000030500050000080008080200070002000000070003050401
10776080267040476357853030404040652430403467667064477320803630805582744080245030501
10706000700060000000000070708050600070003040008000000040600000306000000050007000801
10602264506085232833766350808050407024633030607033276020334455588036653530802638401
10600050306000000000000040800070003000005000705060006040007000000020000060400000501
10202050308032328568543070405086873440506674202070205075206367756240832060284260301
10706030007000002000003060305050000050300060007000703000600000000040400030000050401
10783030876736808062708050606050853054583030245348702820508586823060507066248050601
10000060003000206000500060602000800020000080000000504000700070000020203000008020401
10624837705035703050672330804426727830403485455230602047538450308242702827434020701
10300000705000007050002000400020000000700080000000407080000000806000004000300060601
10805370608643364356667047556080882358553770428328405080704825308047366050404650601
10007000404000800060005030003050600000000040004040002000300070507000006040600050301
10884087402030608080804070534020607073246067505060708850383020205775507062265030301
10006000700070508000800060005080007040005000006000300020207000705000308000007020801
10304730748350505243762472607083673220307778555227628080404040806040702244408040201
10700030500000800000300070004080000030600000400020002030203060304040700000400040501
10232070602643662280405050454040776080608660703080503030704052706060468770644040401
10002020503000700030408070000070008000608000608070300080505000206040000050007070401
13645030202040807030402047327872606022403044205080877320504780607027623062702020801
10003080208020004060405000300000708000204000202040500070006000805000408000802080701
10604080202050384360302770203270702820602860636080258057367453404820205080304840501
10700050702060003000702000306000207030404030008040006000000000500050305070800080401
10282230705023702025503073304054408040303080608044302533872250506020802060244050301
10800050606050007080003000007000006000807030300030300000000000504080804040007000601
10202030707038374020705743308356287422304080857730408456343753302070203063706224401
10606000702000006020400000800020008000008060000000300000004000006030805000400000501
10408284508888602050305280488080207047845034658530506233352072787060703556737060201
10502000405070002020405000300040408060003000700020703000007070800060200000007080701
10404440305040237040205025803570408050602420504040222036308080305280608552703070201
10705000800060000060304040006000706000200000802020700070002050300000200000306050201
10206074367633576870807022466050703622784226205055202580205040683483628250705370801
10200020006000000000708000000030700000000000604000004000405060000000005000300000801
10353520605040757285205842768358542555348870276367672060605087337752307024475222201
10000000300080300000700000500000300040000030000000007060207000000000705050008000601
10546342858530402240206330505850204040862044654340305080806483562720606054304050801
10000000000050408000500060005000207040400050000060800030700000006070008000008080001
10248640835540803062263037688080424080607380874084346620807586608050665524582053871
10000060006000408000008000700060500070500000800070000000400000806030000020000080001
10277043705025304248703623206753808330368360508560276764474320605026677030332670201
10008000707000408000600000600000607000800040405000800070000040500030000050000030501
15804270203530606080867360348330504060707036302046857020284730332830202263265054801
10007000500050603050000050000040503080406000204000004030800080004000200000007000001
10308085286040708078202072748020604026602220206056603020504037802067658560703388701
10503050002080003000306000006030002000300030003000205020707080002050000070300000201
10875046406042446730402388764058584620542043857320706020806060325060366052822080361
10005000708070000000503080000030008000300070005030403040306070800050400080003060001
17404850707040206658307060656660704080805347306070706020607020865270307350303075201
10005000304060500000500030000000505060800000007000800060005040002030700000708070001
10568036404080504370455236743632802030347272333855672563745044407040404326307630401
10007000006000800030000000000000200060000000000000000000002000006000800000700000601
11111111111111111111111111111111111111111111111111111111111111111111111111111111111
