11111111111111111111111111111111111111111111111111111111111111111111111111111111111
10600000000080000000200000004000000000400000003000002000000080000000000030000000001
10705033557020224082407073803525803320606063808065308288208045748060357040666566501
10004000002080400080002000300000007000705000800080500000006000000050002000500000301
10755273308038207640606480804445384678207670605540405674642585865642303686705022201
10000030707000600000500050407000006000005000506000700000000020000000306000303050001
10677020702730686865502650707060302053848025375034427083533040804220405030402020551
10008000700020000000702000405050700070003000000050003000008000207000700040004080001
10307853852072254870346072525050863350406774858628607070304272585070434078255028201
10400000003000000050008000400070000050700000000000307060800040000020002070000080001
10423364404672273023608630702584455070204044427870807045442030568246806070225670601
10000000500000008000300000600040004000608000300050202000003050003070007050002000301
10502360405747405670248488728030335640205258203070303038205025503070238022808075801
10300040200000805020000000000050000080300000302070508000307070007000500080005040201
10338850768372605060245466722837754060656860207060506780702030237668402050326060701
10005000500060004070000030003000000060000040606000300050608040500020005060400040001
15405038208030406030436020674070536234827080606732246030603030525050522640804886481
10308000703000707040002000400050000030000050500000000020503050004000800000205000001
10805030802823487088503253807056477650803680764673838574407087304448602048604030501
10007040800000002030800000403020008000700070600000200000004080005000508000400080401
10605060528068803080388870303050405067626060703360307523876080403070504030407245701
10606040008000700040000000705040700040000080800030004000200060605080406040602000501
10454072507360728248763473504660268384436670837087403080604750606040606650777060501
10008060004000800000000000400040000000400000602000306050505000206050400030600020001
10407040755858403738232630437036403540605645802020268080376028367035374020505635821
10304030000000605000000030008000500070600000008080300050000030006000000060708080001
10802075778840304040443047704360468020544257353580708232678640503840274860506080601
10406030000020007050006040400000600080800000008000400000000000500040000050402000801
15302040655053482030707080506663806860602057704075343267535263874020573060202355601
10002000503000003070802050500000700030006000505000000000000060007050007020500080001
10732443402080402060205070806847608064222420605574206657584030706084306030605050701
10000000003050700060607050605000804080007000400000500080003040800020005060304000201
10447362253050273570207070862080604060628035835630703020406080508430563030472585651
10000000200020005000707080005030804040000080005000702000704050303040007020000000001
16673755405044408046703030306450303020224630607052336554203040702062572044733647201
10000070008040008000503050706000606060005000306000007060004040505020000060000000801
10362070677680265670305035203074333056842058305276505070433030608020523570472760301
10006000300000600040602040005020000060006000800080008000700020504020000000500000801
10508244753466306050402080676020534270804670476580585557405760706070237855408426701
10600000000000605000208000500080000020600080000070007000007000500080007000807000001
10868432545750605233504327406732702060355073233040822050243060533255782057208078421
10400000200000400000700000003000406000602000000080700070400060200000006000002000001
10403038808033266520824684348260602584507086764250805466406463207244604380345665601
10808060008000200070600000000000308000007000300030500080004000702000800060005000801
10607650202440504040205045422388307080854488506070244040844040672060604054377030801
10500000204000802000805000000000500020800000004020002080000080004050804000700050801
10883626264078607432203286744430308040407587468286302057854432407250308730603277201
10000000007020003000007000800060202030200030000000007000004000500000703000300000801
10622688502220323082644020204420305320855020303528725373407040465375342080837270801
10800000606000700080008020200060700050008000407000000040700030300000000050006000201
10205030504058503430304340405020847077804083223055338080202820402055457050505067601
10006050606000002000200000808000300050806000400020000050700020005000006080403000701
17542670405878772030382652506378404830202260405750344560835672482873505088204050401
10000060404000000080200000202060008000800050200050000050200000500080003030004070001
10475040508020538570807630707080885034777042802060675070308840205040477540805028251
10004020306070007030006000300040000060006000304020804000205020006040300000806000001
10604360605050402080484085333287287570407280847020306064802035466040306636508552801
10500000505070806040002080000000000000500040000030007000702000008040805000002000401
10336633608050606030405020203454285568473072426064274220205286407025507088624030401
10003000004040600070204000300000000070002000004020002000707000003000007000007080201
14234024478080583660605062427727782070306723706080868070403023282055467033207020801
10000050000020200080206000007000400080700020807050000070800040005000005000800050401
10574280805840424050503272804070307360702020604736645380285730404663804553737766201
10500000700030000060500000608040500000402000702000000080800060400000500050008000001
10304078585034748480586250765020406347205422608020437040705040245850805080506083351
10005000608030000060008030002050400080008000500060400080504030005000302000206000001
10462860302020402050203040203330465050352040285860406476608067666067406044705550701
10006030004000807040700080700000200040000040200070500000004000600040008000200030501
10302030836223508087388262403065673830485880507020364848878450302272637070627054401
10202080004000804000000000605000600030200000507050000000000030002000003080008000501
10702046568050408646686460406565604077408578404030633846862088665846403870306850801
10602000005030606000000000200020002000605000307070300070003000300000700080200070701
12307652603034704088338328664070305530548040703053704070606680307540802050382020701
10003000005000004000300000700050600040005060008000505000500060507000806080200030401
10856026207566603320504550833370526026302088486670802055636380203075644046206320301
10006000300000400040200020003000304030003000700040608000600000402000003020007000801
10603830206680887850454085706020607020703520502080602220404382506023704020336047701
10200000300080400030006000600050400040507000308000307000307000703000406080008000201
10556786322580502035506070765440755740507028202063508887508080507686708066553270401
10000040000030203040007040400070002000504080002000500000007060004000002000000000301
14253080885058506042447350203064806084752060865463373282424080374048258446777838601
10000070005000007000000000703000007000000070000000000000000050003000000000000000001
11111111111111111111111111111111111111111111111111111111111111111111111111111111111
