11111111111111111111111111111111111111111111111111111111111111111111111111111111111
10700000000070000000600000005000000000700000003000007000000050000000000060000000001
10404023353040224055204087202855702320306038504082207676307048452060682020243746401
10004000003060200040002000500000004000408000600060700000007000000040006000300000601
10738326503037704480608420804678884427202430203660205558424667825466702863406053701
10000020602000300000600050808000006000006000408000300000000070000000708000404030001
10354050408320728844205620303060203064437038442076482067335050303480505040508080851
10002000700060000000605000602030300070006000000050003000002000302000700040004070001
10503662435044762380727036777050752250402573455643203060408588764070674027563062701
10500000003000000030003000200050000040800000000000205060600040000070007080000060001
10444342304584685037607850804483685020602074682760408047554060644362705020533770701
10000000400000004000600000800060002000707000700060502000007020003060008050008000601
10808270704534503470535374787060278650808248208020305065404038503040774027605062301
10200030500000706060000000000080000050200000706060802000204030002000200060007030801
10288340342868808030765463253636664020564750604070704740204050266525508070388070601
10006000500080007060000050003000000060000080708000800070307070400080004040300060001
12503023406070807080734030653040347637772040502283354030302040677060637660206662851
10405000602000207020006000400060000080000030700000000050707060006000600000405000001
10808020708675548036804823402067352660702360352225658383702063608523605046708060701
10002060700000004070600000308030005000300050300000800000006070008000402000700080801
10706060553068404080888830503050807042874020302450403387822040807080205070303444301
10702040008000200020000000504050400070000080300040008000800020708060504050802000401
10768086508880427344734642607550254448374620355067204030604820208070807760754070301
10003050003000800000000000800080000000400000305000502020605000303050500060600060001
10403070286558502584447270478035805770303834807060837070882026653055232070302878441
10304060000000603000000020006000300040300000005060600050000080004000000020405050001
10602075643670203030532024808770778060832742723660208724454640602260738740407070301
10808050000040006070006020500000300030400000004000600000000000200040000050303000701
14508040278046375030403060408843404560607087604077565754232384674030728030307535701
10005000805000007050706050800000400040002000802000000000000030007070006020700040001
10862772308080204040707070202385407033348640408448206447322050707087606040702070501
10000000002030200060207060608000605020002000500000400020005020700050004050807000301
10362333827040862280602020743040307040387043586720705070502060502520832050534664471
10000000500070007000505050007050608050000070005000508000406050704020004040000000001
15533325803075602024405020404230808040876240403083567776707030208046673052342428401
10000080004030003000403020307000208050004000305000008050007020707060000020000000501
10228080644250635760808067802068776045867077503482602050787040504030377420666850701
10008000700000600050406030007080000070002000800040007000700040707060000000300000701
10707246272633808030308060583050652640507230355530268372805380803080632466505264801
10800000000000204000403000600040000030200070000070005000004000400060005000405000001
10683827445760604672806827302874307080384055564020832070646040528472278034606085321
10600000200000500000300000008000308000407000000020600060700020200000006000007000001
10402083707024886650877352352280406525808022536730304236406744402355608750763864401
10708080002000200080300000000000608000003000600030700070007000407000500050005000601
10205680607280808080303048388573604070472448405050282060872040257070808088474080501
10500000604000305000207000000000200020700000005060005060000060003040303000600060801
10482837768077602483306578482360507040704642884845708037468554605820306680608632401
10000000005070006000006000200080504020600050000000002000008000800000208000200000701
10285635506280676048556040505550206340737060704458773846402030788488566020442840501
10700000705000600040008080500030300040005000207000000040700040400000000070006000301
10805020508043804320308770506020586058804025684023655030704770806022487020408072801
10004040207000003000300000703000400060206000600060000050800040007000002080308000701
15755780504854675020565334606534706350302330302720288630862625745257805066604040501
10000040805000000060500000607040002000500040200020000080200000300060003040004060001
10466030308080852520302360507040738076426028302040256080202880605030852370702022231
10007020607050003020006000400020000050004000502040708000607080005080800000708000001
10703850303040508060544054358644357520307380238030207037605026338030307352507585201
10600000707020807040005070000000000000300060000040002000502000002030608000004000501
10373356607050706020708020404377268265836045555053345250606658806058403028766070801
10002000007080800050708000600000000030007000008080004000607000008000007000006040801
18568068867040533520203023524356876080402574203080447070404088236033256023808050701
10000050000080800040502000005000800030300030407060000040700020002000005000400040701
10553280403430584050608488306030804350806080503625774380725250607546608674368374701
10600000400040000020700000402050500000303000402000000080600030700000700070003000001
10605084627067843340826270626070707833603557407080438060405070885270803060703068271
10006000803050000030008020005040200030008000700030300060407080008000508000708000001
10236730507040606040206080806630744050587020873450704245303038356086608076704360201
10004020007000608020500030400000300050000060800020400000008000500030006000600080601
10207080226374703056646362507057647780684570508080262538587870606824886030737083301
10204030004000604000000000408000800060200000405020000000000050004000006020007000301
10307074724050207727443580305433708037604564404080775585568036288723208340605370701
10408000005080208000000000500030002000408000606050200050002000600000600030800040801
18708747802037804036345472627080405470282070708073403020607880705620703070873040401
10007000002000002000400000800020500050008080007000805000200080608000602080500070801
10825026808348607350406470858260843038806084663360805042873640602073565033207530601
10008000500000400060800080004000604080007000200060502000500000807000003060007000401
10702230603780663370387078605020505080403450705060703570607272508054606060444072701
10400000300050600060004000500020600070407000502000703000503000202000504060005000201
10854767228580806023802030862440464220604082302027605847406020306385302086847730201
10000040000060602040002050800080003000604030002000800000007060002000006000000000601
18678030236067602076267720507024808057482040653254863454674080673044542574628565201
10000040002000002000000000803000005000000080000000000000000060007000000000000000001
11111111111111111111111111111111111111111111111111111111111111111111111111111111111
