11111111111111111111111111111111111111111111111111111111111111111111111111111111111
10600000000030000000600000008000000000300000005000003000000050000000000020000000001
10408058244040568057805083605837705650503067807065703423806038783040455070856546301
10006000008040500070003000700000007000205000500050800000002000000030005000800000601
10482872303046503270704420505455735232708450306520503444847247534626802638808043401
10000060607000400000200040506000006000006000803000500000000040000000605000608060001
10855030308450745854507720502030307088685076788065734036538020806720802040806030351
10006000300070000000302000306020800060004000000060006000006000805000400060005080001
10406375357027663480724046227020425750803342672264706020407388344020347023874044601
10800000002000000050004000700070000030200000000000802030800040000020008060000060001
10834352304268538087508760202226578020206046334550704037372020388434304030663330501
10000000400000007000400000200030004000308000200030404000007060008020005050005000601
10705550803876405320662572254070888420503683402020707082603047605060254076404024501
10200060300000204050000000000070000030800000806060807000305050004000600040003080801
10283640556637702060564762446537656060633420504020803320204050852766602020277070601
10002000600020008050000020004000000060000050804000300080508050400060006040200060001
14806047403030605030577050388070743784782040606672723080708080244020632720205354441
10803000207000603050004000400050000030000050300000000080206080007000700000602000001
10403020303625543068208548805027722870404780484543467648706026805288606086805030401
10002030200000007080600000703060005000800050600000400000005070006000705000200040501
10305020235058505060842750504070504034826050805560703664534020402050607020804857501
10603050003000700080000000206070400040000060700070003000700060602060307050504000501
10887067304260488836843374308260278658653220342056706060704850306020703560236030701
10004040008000300000000000600060000000300000806000302050802000307020600060500030001
10507030883488503578447540325037204380608776704040554070663087286076258070204863771
10205020000000303000000080006000800050800000007050600020000070002000000040806040001
10806046245640708020655043203430744050868584483440704256433560204230456630505040801
10703040000050002060006040300000800040200000005000200000000000300020000050808000501
12406030733078322070804050302446508760806057406054267352564632437080476080808426201
10005000807000006060704060500000500040002000404000000000000030003020004060800060001
10422537808040406020404070305873402028755270506384402776786060703072408080305070601
10000000002020800080202060605000804080006000600000800020006040400020006070407000701
10863832684080283440206040288070403050665082745680605040202050507460478060632638341
10000000200040004000403020003050606070000070006000707000506080206070007080000000001
18427763204063504025805060707880608030667380608047735564706020702026638027447767301
10000060005060008000305070205000207070005000502000002070006050207040000030000000501
10344040658430228580206025805058376064346045504448606050357040507060342370326780501
10003000700000200020504050007030000040004000500080007000800030402070000000500000501
10505437553535602020602020625050482880705280367480235655407440504040753454403372801
10500000000000405000502000700080000050600080000050005000003000200030006000806000001
10487446374580604886808732406556203030676077736060367040686070754428722087606057731
10400000600000400000800000004000806000505000000020200040400080500000005000004000001
10703046307035372850572773637220605322208088586730502362606627504322702760785558401
10402030007000300020200000000000406000004000200080200050007000807000500020008000701
10307870808720405040802024358656607050263242802030635050288060685050606032477070201
10600000404000704000205000000000600040700000006060007030000040006030305000600080801
10852246543038807658807638235840305070602433347846703066646745205850605230604356701
10000000008030003000008000600050205070400030000000003000005000200000304000400000301
10523284305320728023327040205670803460387030503425828368602070668553823050724860601
10700000502000400040008030300070400080005000807000000080200020300000000050008000601
10606060608035206270407230507080456043603053252043756070702630603055634070608034301
10006030406000007000300000302000200040707000800030000050500050004000008020306000301
18585540704337583020263334303424308620603570503220664860736584886863307063302040301
10000080702000000070500000605060005000700020200070000080200000400080005030003040001
10658050808050854340508780402040284076884073406040566070702350805050748650408064731
10007020206070002030007000300030000060004000403030406000602060003020600000403000001
10708770805030208060444022464327666440706860547060408038607085428030306243606345301
10200000205050404020002030000000000000500080000060007000705000002050205000007000601
10773534804040706070206070602774536857676082657025325730504564608044308068684020501
10007000007080400060502000800000000040007000003030004000202000003000007000003040501
17885073523020855260707073474357853060406267203050378080608022764044356047604060301
10000040000080800030507000004000700030600080807060000040700020008000003000500070601
10634340606830347020306766207050208250808080807873587750863860305756308677238466501
10300000200080000080800000804080500000802000708000000040200020600000700040007000001
10804025462066658250368420344020304222703482606050365020604050666670608060405074331
10003000403060000020003050005080200020006000200070500020805030008000306000705000001
10368320302040707060808080308540844020357080773380403783706083545067606045604660301
10005050008000308060700080700000300070000080500050800000007000500070005000800020401
10405040452625502024857275207044267840843870704050682267884430207535575070875063701
10707040004000407000000000506000300050400000706020000000000060005000002070003000601
10205082477030608248426740303228406056706686507080255823643062675727408760506630201
10503000002020607000000000800020005000204000405050300060002000300000200060400060701
14704438205025606048578543455060703820453020807032406070502780605340204050423020701
10004000003000003000200000700060300060008070002000806000500050805000306020800020701
10237025206778808340402770324580243024606023284420606077582260808066446042202650201
10003000500000600040800040006000206030007000200040604000400000202000002050004000201
10604860403460546740727043708070302080808460305040603570704737503078503030467066701
10400000200060700060007000800040500070603000502000807000505000802000507020007000501
10424623738320702025808060888850642640304047205037502588506070808786704073884230601
10000050000030505030007050300020007000306060004000500000005070002000005000000000701
14644040527057804083658250708036502077582060273838386355636060322033436723377482201
10000040007000002000000000502000006000000050000000000000000040002000000000000000001
11111111111111111111111111111111111111111111111111111111111111111111111111111111111
