11111111111111111111111111111111111111111111111111111111111111111111111111111111111
10700000000040000000700000004000000000600000002000004000000070000000000080000000001
10202023336030674084607085205677406630207034503075507743307037657070863060563657301
10008000004050700070008000400000006000406000200060300000005000000030008000800000601
10523784305074204250405830604527536523202850607230802678328478588564207867204065301
10000030304000400000300060604000005000003000405000800000000060000000403000604030001
10732050606670385456608280607030508023673084468058622082273040203480503030708020751
10004000400030000000408000205080500080005000000070002000004000703000700050008080001
10803546448086258550754056785040438820805887385324505060407432553030723082566064801
10700000003000000040004000400040000020500000000000204030200040000050006060000020001
10728387508353584052303620708472856020504028754640603072287080238587802050252760301
10000000200000007000700000400040005000308000300020502000005020006080005080008000501
10208220208682705720633543662070732550304264605050405053304064608040254062402072501
10400030300000406070000000000030000020200000408080305000705020006000700040004060501
10473470552624708050484684864482548040654660602070402670503030688683602080487030401
10003000200030008060000040004000000080000070604000500080708040400070006080500080001
13807052305070503050873020858060682443423080302467758060503050736040223520506846421
10302000508000607020006000600050000020000070700000000020407050002000300000307000001
10503070804552573072306486303054843850702450882675387262802046502663404082308030601
10002040500000006060700000502060006000700050200000300000006070005000607000600080401
10704030253057806060645380306060808082553060802270702565775020308020602040604283801
10508050005000700020000000205060200030000070300050006000500080603050808040506000801
10457075406720326545422278604220628777277530753028305040804220706060404620365040601
10005050007000700000000000700020000000600000207000602080608000202080800020500080001
10608020436226605342544740668054402450804447705030522040845072272027822030507383531
10304060000000306000000060006000500080600000007030600050000050002000000070808070001
10206027574880208030375085708650336050824282247450808836382720803770424670805030501
10303070000060005050005050600000800040400000003000800000000000300050000050705000501
18602060565068847050702080706443402670608024803052524474472684823030327020503466301
10004000604000004060404050200000800040003000805000000000000040006050006030200070001
10564784404040607080302070307358706087486650705682303563643020607052203040603030801
10000000002080200070307040407000705070007000600000400080004060500080006080303000501
10426872476070844440603050624020702060455032277450804070808050807440788040373866531
10000000200060008000508020005060505020000070006000405000802050304040003070000000001
18736473702065706057502080305570306050824570406088586546404020204034583073527577301
10000060003080006000602050202000508020003000202000008060002020604080000020000000601
10288050732730375820603077707086654032557047206448302050576060504040536860564420401
10006000700000400080508060002050000030006000600080003000400040207040000000800000301
10608773278257607020202030543030472620603370827820636562608370405050544487303747701
10400000000000806000707000700050000050400050000080005000004000300030007000507000001
10457673244760604234307862306747304080664057573060628030425020255744228055304057371
10700000600000300000800000005000507000606000000070200050800080600000005000005000001
10804073808036867730245326625750707588706066833750708577306377604366802540446428601
10505050002000200030600000000000203000003000200070500050005000705000400020005000301
10603820607570304040607062727462602070743227306070656040824050728060204078662050201
10600000408000807000208000000000700030600000002040003020000050008030702000500020701
10842263576038407848406564858580804040404764766554402082752282607250204850505228201
10000000005060002000003000600030303020200080000000006000006000700000605000800000501
10834467705360233022464020806460305840448070306535637864703040636345637030253530301
10700000205000600040005070300060600060006000506000000020800080400000000020003000701
10604050206033806270304480302050352085208052832067352050402860505053736050508084401
10007060302000004000200000304000400070607000200030000040800050002000006060807000401
15838640507586442060887853407573608860403680307470524720273658867345203054803020601
10000070408000000030600000706040004000700040400040000040600000600080008030002080001
10787030203050586630802380303080828023647072302050588070504580505040348870605034271
10004040802070002020004000600020000020003000704030402000402030006080500000703000001
10508620703030307030537046473557267850304760264030205088603034622080505547608864701
10400000807050604080002040000000000000500070000060008000206000002060207000007000201
10865577403050704030608070504553828766353038765048727680506376503068306044635060501
10002000002020800060804000600000000050003000002040002000308000005000003000003080201
17366063642070348340808022534363447070402347307050784020805076384024265085804020201
10000050000040200030805000002000300040800070406050000080600040002000008000600020801
10552750303870385070302465203050705620407060806328743470274550807462708783546353201
10200000800080000050300000703030300000307000302000000050600070300000700060004000001
10206045276027377520365370655060402754305738402040482020508070457370703040403072741
10006000804030000040007030008050600040004000500040200050806040007000404000503000001
10484520308040405040306020807840626080524070664460605264607068263036408042803580801
10003050005000607050200050400000200070000060400030400000004000200060008000700030601
10207030826427708074267638208068425250354740704030486782556680705486382020734047601
10205020008000804000000000805000400040300000607020000000000030006000008060008000801
10606022336050504362547360607643608034607746806070566284623056838584204460402340301
10506000006060502000000000500080007000408000306030500040004000600000600050800050201
14206527603048606024637538472070507240576020602035702080605780702220707020522020201
10007000002000005000500000500070400050004030008000408000700040505000403020200050201
10333042705666604620208240434240864042503028384340205066835860306062276083706780701
10008000200000400040300060007000303060002000500020706000200000708000006080002000701
10302850805320348830827074505060804060606220203040503440203388308072403080466043801
10700000600020700030005000700020800040503000202000202000503000602000406050007000701
10477448333560406056507030766650645560807064304084702723407080503274702045275760401
10000050000050604060008080800050008000406040007000700000004040007000003000000000801
15766020537084702086575260304057508036267080532674367675843060843057622428628434601
10000040007000003000000000302000004000000080000000000000000080002000000000000000001
11111111111111111111111111111111111111111111111111111111111111111111111111111111111
