11111111111111111111111111111111111111111111111111111111111111111111111111111111111
10200000000020000000400000006000000000700000002000003000000040000000000050000000001
10408045455030467044307034704888705460205088507075303577702043236030783040364787301
10004000003070800070008000500000003000404000800070500000003000000080002000700000401
10253366407042808820702480307286257432208380303260807466878273875254402523702077501
10000080806000300000600050604000003000004000505000200000000040000000502000203030001
10634020408530827758505280608030708057283072747047585063852030208220408070405070851
10004000300040000000804000603040300070006000000030007000008000607000300040004030001
10707534284088356780724047628030626850602867655773402040205573728050777055546048501
10700000004000000030003000500030000070700000000000707050800080000070007070000030001
10785346303677376022606340305428523020407027358830708044446060488557507040648870801
10000000300000002000400000700080008000806000500080203000003030005020008080006000301
10504260303778803570667438575050654630202224807080602037503023407040282073302033801
10500070700000404020000000000070000020400000406060207000402020003000800080007030401
10263630862353807040746578832745373040472840208080303230802030385487306030522040701
10005000800080008030000020003000000040000040706000200060803040600040007040300020001
12203072407040707020875080238040886845533040607546884030603060353050762740208373671
10307000703000203080005000200070000050000030800000000050504050002000700000208000001
10308050203557486074408487302043742780207740742323466345802023505825702036604040401
10005020500000008050700000405020007000300030700000300000006050008000703000200030601
10608030325027608040345420707070308066636040507580506286523060302060402050802774501
10707060002000500040000000306070300070000070300050004000200080402040404080307000601
10573067604420267523688737808750784483466450674058403050402250705060803440783080501
10005070008000300000000000800080000000200000608000608020505000508020600070700040001
10205040866846305457633270744058405380608354406040883030872088766024336070304885651
10403070000000806000000050002000800020600000006070800040000060007000000070605080001
10205045552320305080653038203280267050437546345550207683325850407730356730508030401
10504040000040005040002080200000800060500000003000700000000000500080000050404000801
17708080748025635060608070805558408420504055402078764443333222648080528080502244801
10004000306000005060805060500000400050003000706000000000000060007070005070700050001
10757522403070504070206040405228502087376570207522508558227070406065607050207020501
10000000008020400020405020205000208070004000400000500020006030500050006080407000701
10478275546080535470606030644070304060738063785870702050608020507750748080775736851
10000000600080004000303080002020404030000070007000504000202050304030004070000000001
13374822207054502037808050607320207040743240505026758822404030307056656087283863601
10000060002020008000208040506000503020003000202000007020003020408050000020000000501
10228070553550283860505044405087534037326032205383604030778040306060768780478840501
10007000400000400060707040005020000020007000200030003000200040607080000000200000401
10206582846747404030308080445030223830808560465440255865707820205080588472604724501
10500000000000402000803000300050000070200070000050008000004000800060004000508000001
10822267343450504353203274703223603070436072225070562070474050375527437085304073351
10600000600000800000500000003000203000606000000050700040400040800000008000006000001
10802048407068826730583255287730506763308063866320402735407653703343408360252633301
10307030006000300060700000000000707000002000300080300050005000606000400070003000301
10305720408720205080503078276677308040734634803060244060558080535050707042338040701
10300000703000202000405000000000200080800000008060007020000020002030306000200030701
10847288368023503655805466556330504020805268342727603036745855303550204730405575201
10000000003070006000004000800060704050500040000000007000007000300000506000700000501
10524427204520477028683020807250304240866060808788827378302040655867552050456280201
10600000407000800070005030200020500060008000703000000040300030700000000030007000701
10507040402074802720704850504050338042208083374047675020307860803045633040403025401
10004030702000004000200000507000600060304000200060000080600080005000007040706000501
13777430304653327050534426205238503430207260206470727840326425586438702062805020501
10000070503000000030300000704060003000300040300030000030200000500050008030003040001
10287070705050248650404630605030244067525035706020842030808240606040636430506022271
10008050303020003040006000200020000030003000603050403000805050007060600000407000001
10706360204040608050585036458466264380607770666040304076707028248060207426503582501
10600000503080406050006070000000000000600070000060005000808000006020705000003000601
10464826408020304040802070802884277562564088755066288680703836405065207063358030501
10007000004070500070308000600000000040008000005050008000205000007000008000006040601
14585062788050322870508088756862863080505426703080655050508085838028752066405050301
10000020000080300030305000004000800020700020308040000070400020007000005000400040601
10627550602550472040406572708070205560706080605445888780686630305262605682235432601
10500000500050000020800000802040600000408000303000000080400070500000200060006000001
10305034742046753470537820643050207253708358605040287080303070555840608060703083521
10007000302040000040006020006080600030005000600080800070503060008000307000805000001
10865550406070503030604080704770444030523020868550507867508087452047505077607780201
10005050007000804040700030500000700060000040200020800000004000300070006000500080401
10403050756285502042364247804057285380383480606020532723653870503656882030322062301
10303020002000204000000000606000700080600000507040000000000060002000008080008000701
10805075554060805524542640504424506086206753203050534465662065428578204420202330801
10205000006020408000000000800020006000505000607040300070008000700000700030400030301
15707552408086207086645366787050204840764030605067802060507640302530206030667030601
10003000003000007000300000300020300020006020004000204000400070704000207050700020601
10422084308335806760505640847230423083304065384580407056746670807064334058608630801
10007000500000400060700040004000807020007000200070502000800000504000005020006000601
10405460706720238750482023405070707050705730805060808250307747703045408050764068401
10700000800060500070006000200080500020307000702000507000207000703000805030005000701
10785463356580704037708050658220337320707058602076302844505020306825208065236430201
10000040000050306070006040300020008000802040004000300000008040006000004000000000501
12287020534046704077652460407054402027338080235844578785282020664058474855778633601
10000040007000003000000000708000002000000070000000000000000020008000000000000000001
11111111111111111111111111111111111111111111111111111111111111111111111111111111111
