11111111111111111111111111111111111111111111111111111111111111111111111111111111111
10400000000030000000400000003000000000200000008000004000000040000000000030000000001
10208023342030382056707042607454208250505023606085707636806047428040657020538883601
10003000007050400020003000600000008000206000300020600000003000000040005000600000601
10655888807044405270303420407638588648508840602620503877264257574867308547208055201
10000040303000400000400080202000008000004000203000300000000060000000504000805080001
10434050205370738383706330607020808038758027665036667022536040206350804070208020641
10002000200060000000202000805030200060008000000070002000004000206000700060008050001
10404644456052237520562066527040662750804554787347608070504644686050552077837074501
10600000005000000070005000600050000050800000000000506070600060000060003050000060001
10355655503734345025505830803675728050705023264350708043833060625724607080877870701
10000000700000002000300000300050005000603000400020605000004070003080003080004000601
10407380808333302530567558728040772630402337806040803037408066604060227083507042601
10500020500000203050000000000020000030800000407020506000807050004000300030008050201
10624580772234708070843557636825772050282470704070606420407050543546303070827040801
10005000700030007080000040005000000080000080204000300040207080800040003040400040001
18804052404040505040473070758040452687282070302864566030704030324020552220403482481
10203000406000204030008000500060000050000080200000000020402060003000300000204000001
10206040208686425062802553503067738530403440837273844533207062607438204068203060501
10002040400000003060700000804070008000200080200000200000004070007000304000300060601
10705060343032405040374340503030805022772040602720502322885030208040407040202263601
10606080002000200070000000403050600060000060400050003000600050203070304040306000301
10435032402730477232337628602620723785462360377027402030608520307050206850265050301
10005070003000500000000000600060000000600000508000808040604000804080300080300050001
10604080725786208475784330662033607840803853706050735020258024752052248070203486431
10408050000000606000000020006000600060400000002060300020000070007000000070208050001
10504062672840403080377072806340332020234872527470803587676660504360872820605030301
10802080000080008080002080400000200070700000006000500000000000700040000080508000501
12502060686025267030404030707842205240805024802026454347447666574020772070407634601
10003000604000005080305070400000300020006000508000000000000060003070003020700050001
10452463608080406080503040604683207088257220304834807583647080208065406060608060201
10000000005050500030202030704000405030008000700000800060007060700050007070207000401
10844687454060267760207080472050803040584052536720307030302040507480477060758223481
10000000300020006000308030004040702070000060002000205000807020706080003060000000001
15776664303043308043607020803430508030883580603064376232205050207043268038362887401
10000040005050007000708050506000803080005000705000005040002060605030000020000000701
10768030547320382880302032407075365072353056407875707040874040602030732870426470701
10007000600000200080308080007070000040006000700020008000700050605060000000500000801
10203374348347503040308070265020276670507240285870327353808850504050444243604368401
10400000000000802000305000200060000060300060000050008000008000200040005000306000001
10267536822880406224206552703734503040865057264020378080643040567527238083505058531
10700000200000400000400000004000307000307000000020800080600050300000002000002000001
10303043703047475370354322275240306462807023264260606874703223403368607260385444701
10407020005000600040700000000000403000007000400050600070004000707000500020002000501
10806820807430306070403048525625308070437363807030575050584020242080405062878020401
10500000807000405000402000000000800070500000006050008030000060005080504000600050801
10884728548026407525607654556830405040504547767874307022254262202250608340204747401
10000000006030002000008000500040506040800070000000002000005000200000403000500000201
10765475603730263074267040704660705370356080702827348454302020877478628050426480601
10300000206000400040008040200070500040002000604000000050200060400000000080006000501
10302070203065406750408760406080688046706033876028738070708620405063872080403028701
10003020207000008000300000605000300030307000200080000050600030002000003060507000201
17388850407886838060362336505722403430803720404760286480644862346374207024606080401
10000020407000000080700000502020005000300060800070000030500000400060006020007040001
10667020502050383760808550805060738088528066805060332080207560303020353660208085871
10004030506040005050004000600070000020006000507070705000604080006050700000305000001
10708520808020708070747073528755435440507230387070607022302045634020702343202553701
10600000508030205040002020000000000000700020000080005000402000007030406000003000401
10623438502080603060506080607624787648442035584077347670402344708085702072546020301
10002000004050200070307000300000000040008000004060002000804000004000006000005040201
18665048632080386320203078685866757030308547207080765080407043826057433052203040401
10000080000020200050806000002000200070500030603050000030700030005000006000400050701
10523650805870534070806422203070604580204070403374734780744660704246307352545352401
10800000800080000030300000207070600000204000206000000050700030200000500020004000001
10303086354052835330372340348070702883806255603050588050705040676470205030606032251
10004000507050000040007040002020600070008000700050600050806080002000504000602000001
10528650605040303020807020404820235060673070463250202732704035476057506033406550201
10003060008000605070600020500000500080000060200060400000003000800070004000400080501
10206060774524804085446738808088638230763280305030586645247380806254577050778078801
10208060004000804000000000205000600080700000804020000000000070006000008050006000401
10506026782020306562385770606232607074502758508050344882643085564564702560802370501
10305000004070704000000000600080007000302000706020700040004000800000600030200050201
16508564208037602022665277533030307840552070606072708070707740205320504070725040401
10003000004000008000500000400080400080005040005000706000500070508000603040500030801
10256048802532504770207330743540727087208042322240302073663760605088362043508330501
10006000600000500080400020005000706080004000500070504000700000807000006060002000801
10702630506380353220872067404040304040307420208020304740308564705085404050856083501
10600000600070600030008000500020200020203000803000403000506000506000302040003000701
10732573767550708053203070222670882540602078306083606434402070603762704052743440201
10000040000020708070005020300020008000305030003000800000008020007000006000000000701
15632060335036508028363840206072207038762030856647736453576040436022377425463572301
10000020003000004000000000308000005000000060000000000000000020005000000000000000001
11111111111111111111111111111111111111111111111111111111111111111111111111111111111
