11111111111111111111111111111111111111111111111111111111111111111111111111111111111
10800000000060000000600000003000000000200000007000005000000040000000000070000000001
10705063485080865053304077304556508880506025506067403354203033233050447020222877301
10004000008030500070008000500000005000602000600080600000005000000040004000500000401
10573473604025306750502650506882652748306770806240204863642454535875402456407075501
10000050507000800000800070704000007000002000706000700000000080000000503000603060001
10538060403230336544402740403020803024478076445043458044782080604480807070704060581
10002000500070000000206000602060500030004000000060003000006000206000300070004060001
10402566747083742620846032427040836230407562775473703040205823446070763057268076201
10500000005000000060008000700020000030600000000000402040300050000060003040000080001
10878542505273484044802550307623526070602038465530806052736030373323507050482220501
10000000200000004000700000700080008000206000300070506000003040008040002070005000601
10406520308758708880447237472040345830206724604040302074707044708030435043504036201
10600020400000205050000000000080000070800000605050202000303040008000800040007030801
10868850627374208080574668237268425030345360706030406560808040762256507080236040201
10002000800030004070000060004000000020000080706000500030603020700050003030500070001
16707053702030502070428080264080774325483030803766548080605060328020827820602235381
10507000505000204030006000500060000020000020500000000050605060007000700000204000001
10604040805846226043204527302065673380708320645656748463305034408887206072603080801
10002080600000002050400000402040006000800080800000800000008030008000506000500060801
10605040234048508030546460505070607046542070502420402323756030407050805040808636601
10507070006000500080000000705070300030000050500080008000600030208040607030205000801
10348033802380465423258355307460846653845520822027804050506660403040608880464080501
10003020006000600000000000600060000000200000408000407080508000403060200080600080001
10307030435725308264487680643052203850206446808060326060772088726038227080606627531
10402070000000802000000050007000500080600000006040300030000060005000000060503050001
10602076733680707030438077704240586040738478366730204574748580802840526760607040501
10505020000020007080004020700000700020800000002000300000000000500040000050207000201
17204030765068264070506040802744607340604072203046825728372457724040367030703343401
10002000406000005080303040200000500040006000306000000000000030004030002080800070001
10566656605080604050807070302568405037685540508566204466667050508028405070205040401
10000000004080500040208020402000403080006000500000500060005070700040004040207000401
10782683267040377430204070542050403030644046277370303020302030508220588020277277641
10000000500070002000502060003040306070000040003000206000408070506030004070000000001
16488454208034305077604030806530508080427520702073777467804040608054242053746528201
10000050006050003000406030702000702060002000207000005070006030702020000080000000501
10222060368530423230205052208038782078254082808847703040457020708020822340572530201
10003000800000400050403040005080000060006000800060002000700040807070000000700000501
10406284743238602070702080488070688380807750658850833375505480308060542824304855301
10600000000000203000308000400040000020500080000060003000005000200040005000208000001
10643333522870205554803746303762608020883062833030763020846060546465232088502028671
10400000400000500000600000007000202000608000000080800070600030700000005000005000001
10302045703053768550652323577240505722207056377230808646803272807762606440664477701
10408080002000200020600000000000305000002000400040400050006000303000400060003000201
10404530403260405020506023324645404030342848803080568040524060844020604067754040201
10200000207000304000203000000000300020300000003060003030000030002060502000300050801
10736828765078602742308742646430407080304525532822604064482287507620703470704527501
10000000008030003000004000300050704050300020000000006000002000600000402000800000401
10482686402470335063327040506630303460757080703778882767606040772526274020247680601
10300000204000700030003070400040200020006000705000000040200060600000000050007000201
10207070606022205280804560708030455078308067788067264070507870404066548060508025501
10008030806000003000500000407000700080604000200050000070200030004000008040504000801
12762360807586328030736747207424502870603760506820638240867587246888205042703080601
10000020808000000020500000306030007000700070500080000030400000300040003030004030001
10663030704020476440506370502050346044433065805040234050308640304020754540204066651
10002020504040005020007000800030000030005000306070307000706080005070200000702000001
10808780506040508030628077682642666460603570825050205065306068556020303852707753201
10200000603070808060004070000000000000600080000020004000605000007020204000003000401
10277448202050802030303060605765557443232082362035668330203836304078305046388050201
10007000004060800070404000600000000060006000005080006000707000008000005000006050601
14663033367020428450208067823268668050407754507080237060708044748077776025508060401
10000080000050700070207000005000800040600080302050000050300080004000004000300030401
10435470204530667020207238607060608480602020408677338380732380705622207337453875201
10700000500060000020800000607050400000607000702000000040400020500000400060003000001
10607035266065567640427330663020608633804425805050585070804080746530805020708036431
10006000607080000040006050004020300060007000500080200050604070006000606000208000001
10672840508070407080708050806380566020474070628630305837502058435057708023404240501
10005060004000407070500030800000200060000020800040800000007000700030004000200030401
10304060335383204076363563504085423750627380604030727362387760808587567040763074201
10707030003000606000000000407000600040600000706040000000000070003000003040007000601
10502088356060603487776240504585508065808547702050474327547084468735508520208680201
10307000006030808000000000700030003000705000503070500040003000500000700030800020501
18706235602045202072824352687070502570344040207035502040207320507560205040774080301
10006000006000004000300000400060300040008050004000408000300070804000705060600060501
10754043706256303670204680362620242037207075464340705055285780403085888078306780301
10008000700000700080700040007000802080004000400080402000800000304000003050006000601
10404380605660747780623073203020304020504540407070404630808854304038706020234037801
10600000200050600050008000700050200070208000302000806000808000805000407030002000301
10874588586470506075802080345660477870606032805044606677804080503556606058846540501
10000050000030807060006040700040005000403070008000600000003030005000008000000000201
13577050235035506047823530308088206063427080268236866843657030482024336766456732301
10000060002000008000000000803000007000000080000000000000000020006000000000000000001
11111111111111111111111111111111111111111111111111111111111111111111111111111111111
