11111111111111111111111111111111111111111111111111111111111111111111111111111111111
10800000000020000000400000005000000000700000006000002000000050000000000060000000001
10804025636060634024406064305246606760503043608068406322705055524040864070282387801
10003000005040300050003000800000007000405000500040800000007000000040002000800000601
10888838803062302520303280704725557377408520204740402484854748743234804577203087801
10000050703000300000300060202000006000008000804000700000000030000000507000705020001
10888040807860554565406670206050306026552032668038545053232080403660302020806020531
10007000300020000000506000503070400050007000000050003000006000203000200020005060001
10404724787068655670288068834040726520406235873234308070503455526060364057345083701
10600000003000000030005000400080000080600000000000602060300030000020006070000050001
10263244604375365067802620205233222030507087852620203068738030675658202050665530501
10000000200000008000600000500080003000205000700070404000008040002050006050006000701
10807450406685304270766624552030723830806742702070703055306047305080622032708024601
10200050400000508050000000000070000050800000402050604000602070004000700040004020701
10883280735635807050388277622783887030675220708060305860704050673523402040377070301
10002000300020008020000040004000000050000070608000500050806030600030003080300070001
14206037702070802030645050762020468724563060202852328020708060645060547630808368541
10506000204000604070006000500020000030000040200000000080804080005000300000406000001
10502040507234726073503886702085872560306680262638738482204084207377303023808060401
10006080200000008050400000607060002000500050700000500000004050003000807000300060301
10306050278074505070647780807080703088573040605230306774846070808070604030506835701
10308060002000300030000000704080400080000080300080006000700050507020303070503000401
10862037305360382783644652205270874523785720268076302080807270804020704220773060401
10006030005000800000000000800040000000500000505000407020603000402060800050200030001
10805040663768807522742470558044605470703353202050682040534066383072458050407455641
10206050000000302000000050007000400070500000008020300020000030003000000040703050001
10607075844420203020785053503340387070732272825220302844552760502380386450607050601
10706020000030002030005070800000500070600000004000700000000000600070000050402000401
18308080222057664080802080506844304530202065606065325627777462536060533040507285301
10008000805000002040307080500000200020008000706000000000000080003030006060500050001
10455788606030805070508040607547208056775220605285608677727020807068403020202030401
10000000007070200080404030407000607060005000600000200040004020300080008040208000201
10367826332020754650804020674020707070832054844240406050407020604560754080423274651
10000000700070007000607040006050406020000020002000302000206060708040007040000000001
15836333708026208083508030503840704060883430707046548872708060806065774073456856701
10000030005060005000806040604000404040006000305000008080007040205030000020000000601
10768030636430577820602075804035684043573058304787504040853060805040546440782760601
10008000600000300020406050008030000060005000500070006000500030302040000000400000401
10306825677448206080702080433080343260503630733470455768805650506070488762307454701
10400000000000706000206000600030000040600060000060004000006000400030004000706000001
10637278253850303445204278602586502050238036285060365030256040566567456034407073581
10700000800000300000600000005000706000805000000050400040200030400000006000003000001
10207044707083344330583888465230807552202045442480307356802354705438408670727527301
10606020007000700030600000000000604000005000800050200030002000306000300070005000601
10702540703780704080304076737822803020556775705080562080635020673030603044636040701
10500000302000803000302000000000500070800000006070008050000020008050202000300050301
10375376365053404738203668758450607080608722542538603022573284307630805480202738201
10000000003020007000007000500040805030300030000000008000007000800000705000600000401
10546326404880268043682050804270604770633050308826846748707040888866386070464460601
10500000204000600030007080200060600020002000806000000050600020200000000080002000301
10406060705072408730206360707050254053204028883086576050804380605056788040307076701
10007040504000005000600000207000300060405000400080000070200070003000007060508000201
16752740802885362050274485407455806470808420605760235350378364554886703047407030401
10000070402000000040600000808020008000500060500060000050200000200080005020002020001
10823050606040455660704430505030288046863062503050864080405340807020654550302076381
10007020306060005080003000700050000060002000407080203000504050003040200000605000001
10207280802020807070855088458638445840207840337060407073606037685050403835502888501
10700000802040806080004040000000000000200040000060003000503000007030305000007000401
10735447308020807060407060503548678643673042247057272830202885706073403026278060401
10003000004080800070507000800000000050004000006080004000504000004000004000006070501
13434025434060636820205023263388646020406245506060424040404084256088448028205030301
10000050000060700030302000005000700080300040208080000050300070005000005000500040501
10537250608460745080608872306080203750706040202783264820374560703824408757645844401
10200000300030000020800000406060500000207000408000000020200080200000300050008000001
10603068778044762360378850427070206257502676308020262050708070285460303070408064781
10004000205060000040004080007030800060007000300070600080302030002000602000807000001
10844550704080502050505040204740447050753050263370702467608053882082207042705650201
10005070008000308040200080800000700070000040400070700000008000300030004000200080701
10605060767327306047247355403088338570533460808070837544436320708622752080545075401
10304050007000803000000000603000300060700000406060000000000080002000008050005000701
10805024653080207477364320208223302042507788702050872677537023485523807420208570201
10307000007060708000000000800060006000406000604040200030006000800000200050700040201
15407843204063805024575372645020602470525030707047405080502260602560703030678050301
10006000008000004000600000600080400050007060008000502000200060604000804020700020501
10472042306585404440204680387440623057406056584450603083642430306058674053205820301
10003000800000400060600060005000805020006000200080806000700000408000004020006000201
10604370505780582230478074505040402050702740502020304270207555708055804030746062301
10500000600020600050005000600020400030403000604000304000705000706000307020002000301
10784672352450507048405080864370356640207032605057604555505020202646202038264780801
10000070000030808080006060300070006000804020004000600000007080006000003000000000201
17666050688087605082583460203058808072443070422655552837658040778082533255465268501
10000080008000007000000000205000005000000070000000000000000030005000000000000000001
11111111111111111111111111111111111111111111111111111111111111111111111111111111111
