11111111111111111111111111111111111111111111111111111111111111111111111111111111111
10700000000060000000700000003000000000400000004000005000000030000000000070000000001
10206038242060788086403062607728602520407077206034305575206056885040628020653486201
10006000006070300080003000800000007000307000600030600000006000000070005000300000601
10636425707058506850505530403537664532804450408850702568866325826654207642203078701
10000080507000300000300020503000002000002000707000600000000080000000408000507070001
10578040608750544662805370805080708054656042265024436084545030408280203060608030381
10003000800030000000804000607030300030003000000070002000002000302000800070007050001
10402787723084868550846036627020483720603226634732406040608385284050564042347023801
10500000004000000040004000500080000050600000000000403020500060000060005050000060001
10887524803675477042807270704778488070702087872570608037382030736334406060266230501
10000000200000004000700000600060007000705000300070402000004060005040003070007000801
10806520605582804550287677673060627580303882703070706082507078403060764088807058701
10300070700000608080000000000070000080200000603060806000502030002000400030006020201
10884230273572803050343586582367667040823530608060808360705030654473803060758080401
10002000700060002060000070008000000050000060202000800060204080600060006060200040001
14605068605050507030273030268020828668222080408628526040202030488040563340603262531
10808000705000606070008000400070000070000080700000000060708040003000600000207000001
10207020304668286067803866406055586740804460626366677362806087305226504054705060701
10007030700000006080300000507030007000800040800000400000006040007000302000700050201
10805030822032802020725660508040505047758030605840405378673080308070806020204664301
10405020005000300040000000307060600080000080700020002000800070804040707060603000601
10675023607530373727356224705580234482363520238035306030502640305080303740858070501
10006030008000400000000000300070000000600000708000208070704000604070800060600020001
10403030267373402226472720687056406780503644503020646020384073362043337030605755251
10608070000000404000000050008000400050400000002070200080000020007000000060408020001
10805073756320804040748033502370534040664433328260605874572370607740482780702040601
10803030000060004030006080500000200040700000003000200000000000300030000020205000201
12407060682062243020303040402667604460607077305048554332854342676020346040502636701
10002000203000007070408030200000300020008000303000000000000070008040006070300060001
10437223208030403050403040805637504052526740504322807773283060307072703020808020801
10000000006080500020202060403000606080008000700000600040002020800070006050804000801
10824754767050653870505070652030708060644072663730403040408080602540454080465636851
10000000200040003000607080005040807070000050006000503000207080407020002050000000001
12576724804076808063303080508460607070767570708066482632303050803085663066644665401
10000030004060004000805080702000803080004000506000008060004050708030000050000000801
10642070777430338870306064302058872053464072308523708020255050608040463580274560701
10008000400000800080607020007040000070007000500050008000700050604070000000400000601
10508236863474204040205020264070367440505450838660475636607250504040486866402586201
10600000000000305000702000400050000050600040000050008000005000200040007000602000001
10832548267740706442604675603768202030566063388040887030745020834223363022402057381
10700000300000400000200000003000407000606000000070400050700060400000003000006000001
10208055706035283220655472572730603285606026672440405446204585606525406420857557701
10706070007000800060500000000000603000007000800020200070003000408000400080002000801
10504350202270303020302036254822305080555566406070534030675080627030303078437020501
10400000606000402000704000000000200030700000005070008080000040004050604000300020601
10877838248056704366507358842230506030206672333375703034344724402460407670708343801
10000000002070002000008000400060608050800080000000006000006000500000205000800000501
10852446303830233022242020308260205260638030603747288635308020564836242040864850801
10500000504000300050006080200080800040002000303000000040300070500000000020004000701
10802070207044602780403630505060536028205088752038886060306530407055623070205044701
10005020402000008000400000707000600070707000600030000030500040003000003050704000301
15258580805872824070722228808485608520202580808470888330737534337388307073305060701
10000050204000000080200000606070002000300070300020000080200000700070003050003060001
10238080508070425460203220607070773048475074608040576020808540807040685530605065641
10002080407050002040005000200050000060002000803070205000705060003040600000803000001
10306360502070305080887044854226338580405480825030508024702058857070605333504448601
10500000303060306080008020000000000000500040000020003000405000005050502000008000701
10332323804020208060605060605747364432687044323026872550805466306053404033688080601
10007000004030200030204000400000000030008000005040005000603000008000004000005080701
15338085862030762840305038635533872060508522508060446020508058842043636065607030301
10000070000050200040604000005000200050400040408030000020500040006000005000200060501
10673450307840588020605374407040503620803040803858228850585730602274808374363726801
10500000400060000060200000304040200000504000403000000080700020800000600050008000001
10702057564056568740552850376070708462505676304070232040702050773560403070302037461
10006000406020000040002060004060400020003000400020600040303050004000208000706000001
10523650403040704040306020708440872080872020777340303567406054885047708052707520501
10007060006000802080300070400000400060000030800070800000004000400060002000700040401
10605070848426202066227378608032463560776270805060624667422860803646862070553054501
10708050008000503000000000605000400020700000705030000000000080005000002070007000601
10306033482050702886644760403255203078807448302070827276768036885648605380607660201
10607000005080804000000000700070008000603000402080500020005000400000400030500040301
12603334602082408075585362774030202620847050208045705060608760803630507050743050801
10005000008000005000400000200070300050003080006000305000200060407000804080800070301
10777077507655408340704860765340827048406034847220802087626550406078452056305870301
10007000700000200060800020008000408060004000400030403000800000504000005050008000301
10308450707350242340277025503040803070408540306060203560308282206088602050558026801
10500000800040300080003000300030400050206000702000805000707000807000203070003000601
10378657488650403074408040824420662470305072404034406887304020505732703044623260601
10000050000050302030008080600060003000705060008000600000008070007000006000000000601
12578050673032405043432620208084704036665040276785464534563080354028553757465526401
10000030008000004000000000208000006000000050000000000000000060005000000000000000001
11111111111111111111111111111111111111111111111111111111111111111111111111111111111
