11111111111111111111111111111111111111111111111111111111111111111111111111111111111
10200000000040000000500000008000000000400000004000007000000050000000000070000000001
10806056333080765087406083306487608880208048406085806857402074644040375060453576301
10008000003070700070006000200000007000704000700050400000007000000060008000300000401
10264355504025504860204420703274268454703430406440308748267658854456807677707035301
10000060504000800000200060603000006000005000805000200000000070000000603000604060001
10725020302530586676405320802040302058368053835044237023672020703240302040206070481
10004000400080000000806000705060400060002000000050007000004000206000500070003050001
10602483543037257720356037444060632540804542822538205060305564285030267036474067601
10200000008000000040005000800020000040200000000000406050500070000080007060000080001
10485483602568486025508660203846846060206053752370502056622060768573807030766520701
10000000500000005000600000300030005000607000500020802000007060004040004060004000501
10704420308722705650484657785030358260806238707070804027502062204060783055302084201
10700080300000306020000000000070000080500000207040708000608020006000600070004030801
10378370583463608060237256436263432080642340304050205230307070326884707030322050701
10007000600060002060000060006000000050000070407000800050608080600030005050500030001
13707037605020306040425030836030377666268060207435837020202030627070447280407286661
10404000308000802080005000500030000070000080500000000030808080006000300000804000001
10608050607773567055205237508055452850404860536848827788204087408342408068603060201
10002060700000003080200000802080006000400040600000300000003040008000406000400030801
10307070585033306080866460202040803025575020506850205885263020704030803050804867601
10508080003000400070000000506080700020000060400040007000500060806020404070508000201
10654057507360375867727267507360832555262750883065505080702520504030306330475040701
10004080003000400000000000500060000000200000808000607050605000303080700040500050001
10506070527856506276835860587043302780303352505040347060347027824068822030706573221
10708070000000503000000070005000400060400000002030300060000030006000000060604030001
10308038675260806020778027305750857050248627382630804328743720607440788530802020301
10302020000040005030003050800000800040500000005000300000000000200070000050204000801
17206020326022647070305040208554202480202034802058263564336755525070248040705263801
10008000802000007060502020400000800050003000302000000000000040007020005040200060001
10674365202080808060205060305364402084787520703478208433453060404073403070206080701
10000000007050800020507030705000507020004000800000600060002030700040007030203000301
10867468546080252540704060632020703030224038776480308070505040205220623080876857221
10000000500060003000706060008060407080000040003000803000208070708020007050000000001
16664377305082202068202060804640403080366850702073832374703060508082744037865236401
10000070007030006000406060602000402060004000804000007080004030204020000040000000601
10737060832370732620803048804048337048224088205642507020454040203080727560424530701
10002000400000800050406020003040000030004000300080002000700040506060000000800000501
10508833838423707060308020362040524250405820247340472563202880206050738627705588201
10500000000000406000508000300040000070800040000060007000008000600040006000305000001
10483584832420308283706553407755603080552074823070763080822050478388754052207054721
10500000800000300000500000003000502000202000000030800040700020800000005000003000001
10808067506074758780425647883660607268803086387350807788802365603833302240687288601
10304040006000200070400000000000506000007000300030600070003000502000700030005000701
10306380807820208020302053674523406030727458408040877040356080225030505072535030201
10800000306000306000608000000000400070600000004070007040000020007050205000200060801
10485527358083206252303233234520803070405485554576204035232585807670703770802346501
10000000005080006000006000500060305060700070000000005000003000300000306000300000301
10438634706860363023882030802630406350528020207254442422808020563424863030276250601
10800000506000700080005070600080500060004000808000000080500050600000000030007000701
10504070305056304540202330807030742022504073848055444030806570405087777030205036601
10003070608000004000600000204000400040707000400070000070400030008000007070704000801
18657430507535467040625857602358605270304560306460235730236587774472305085206050801
10000030306000000030500000707050007000400080700030000020200000600020005070005080001
10472030604080444770403440707080564056368053507020377060603730803020752350207085821
10006080605020008070006000800070000040002000708050706000308080008080300000208000001
10306450602080307070883075288465588780707860723030303055607088657040304554407388501
10300000708060407080004050000000000000500050000050004000304000006070502000007000201
10747382403040802040405050402783543863478043884033586520302887706066305077468080701
10007000002060300030607000400000000040008000002080002000804000007000005000004070801
17365035222070838260304087384284885050203855705050432080507032883086555085408070201
10000020000040600080502000003000400070700030206060000080700050005000006000700040601
10664730806530347030303455603030702260503030304282783570853270203627606464423262401
10600000200020000020400000505020400000503000703000000020600050200000400060008000001
10208037245062228770523820654050604233803555703060467020803050333680503070702024371
10002000602050000050006070006030800030008000200020400020205050003000704000808000001
10468680403070502020805050406880444080226080286260206733604044257067504067705220701
10003070003000505080200080200000800040000050800070700000005000300070003000800050401
10807080624345702025882465503022633650866720403080245876866680805253888070555044401
10606040003000406000000000705000300030300000404020000000000050004000004040006000501
10205025667040207258884880806822604047507454808060676426538025885353208830708570801
10603000005080807000000000400020002000704000404080700080004000500000600040500040501
12505262802057208025486356756070704830455050504058807030405820204670305050523060601
10004000006000005000200000300080300070008080008000607000400050503000304040400080301
10434044408583705570405570333730643054407023528570506087636570205086673024203620801
10002000500000500030400030003000706070006000500080808000500000405000007060003000601
10307730705760432650822086404050502060403560403040404850604848306087202060382075701
10300000300050700020004000500060600080506000507000508000508000306000204030007000701
10678533752540408057405080723850665240504082803077404383707080203548506023543860801
10000030000040604030002030600080008000506060007000500000006060002000002000000000801
14677060658057708025665320204036208058862080536862382346832070587027332332437337801
10000080005000004000000000302000003000000020000000000000000030005000000000000000001
11111111111111111111111111111111111111111111111111111111111111111111111111111111111
