11111111111111111111111111111111111111111111111111111111111111111111111111111111111
10700000000040000000500000007000000000600000004000007000000070000000000040000000001
10702053866050278063502057806736202850208022505062207855604042282050585080868864401
10006000007070200050008000800000006000804000200050500000004000000020008000300000501
10658452702054208670503280205778723382603460802270706227272848386332408776404075201
10000060204000800000800020802000006000003000405000600000000050000000305000508050001
10825060803570723784406350707060704077532078754023348025233050203420506030407030341
10002000800020000000602000504050600040007000000020002000008000203000800040008020001
10404243658024277250787068673060386740802736276525208060807335442030772063437056701
10500000004000000030002000600080000070800000000000608040400040000040005060000020001
10673755606843242044407760205477358060303067662660405057872060226765408060832370201
10000000400000007000500000200040006000203000800070805000006080007040008020005000801
10803730308357803220267225865020254720408464302060507067503065803060735084503055201
10500030400000305020000000000070000060200000204040507000407030002000400050006030501
10855270244578305060643825462482337030543380503030804250403050345736203060683040801
10004000300050003050000050007000000020000080506000800040606080200020005030500020001
13302024803070807020785060523070662753746040502348246020306030226050683370703753281
10708000602000507080005000200060000070000030300000000020604080007000600000806000001
10808020607622668047806663705058446570507320545778446576304057403734305068307020701
10006080400000008040600000403050005000800030400000400000007050006000708000600020201
10407040233075807050726320306080407056457040304380206465885060304070206050406477301
10804050004000400020000000502020700070000060500030006000300060207060306060205000201
10277027604440824767657767407270867672368450684047504050208450206070408450453050301
10007040003000400000000000600030000000300000205000403060302000504070400060300030001
10203050223554302486453680682022508220404832603040786020726066436076467020804588871
10308050000000405000000050006000800080200000007020700060000060007000000070504060001
10706035668820708030528026503380468040452265738640208744682250608680467580208050201
10402080000020007020004070300000400050300000003000800000000000500030000070306000801
18706040858053258080407080608337703370804025703078463342455324563040735050703342501
10004000707000002070605060400000400060006000702000000000000070005060003040400060001
10364745508070502050804030402863407086778840606533206353424040505055202040303060701
10000000008080300080304060402000602080006000600000700040007070200070004020707000601
10678744324030736870402030375080208070728038583640507030508020706520752040876464271
10000000600030002000505080005070407080000030004000702000602060404040003040000000001
18256224304053706082406070207770503050772650602064637263808080608048874082322642301
10000030006040005000808040308000403080005000404000007070008060705020000040000000701
10343040877380258780704065408062444043588082303222407080744080407070352550567660401
10003000400000400050205080006040000030003000600050004000300060304030000000200000701
10305473858374403040305070672070433740807440223780257353707220405040268735203453201
10300000000000808000302000600080000070800050000070007000003000700040005000202000001
10874533728450406487603637408438408080373073742060723050825020675358874075508076261
10600000800000400000500000005000603000206000000060800030600030200000003000004000001
10603086302044745670474645384670808524206072836220302388308465604758605320486684301
10304020004000300030400000000000208000006000600070400030004000707000300070003000701
10806880807530704030308024785426807060726726506040437050623070443040403033825050701
10700000305000305000804000000000800050600000006060007050000060005040307000400040801
10735543438044804464504477675220406080308336766256806024833368205360808680503488501
10000000002030008000003000700060205080700040000000003000004000300000206000300000601
10534623702830684033376030202250205640422060805763467743808030248487856070554350201
10600000803000700070005050600020600020005000207000000070700080200000000040006000401
10505070808065303740505650405030426048804083234083343040204670306045368050608034201
10004030503000007000200000805000300040402000800080000070500050004000007070304000501
16782560807234845050358776504623205450508680208220846740588673276645304082707050601
10000070408000000080600000605040008000200080200060000060600000400080004080002050001
10638030407040775620803760508080653088673055506080732030308440204070866460408086421
10008040308070003040007000700020000060007000804030804000308040004020800000702000001
10303770408070606040676037462757528720204750388030705066704057758050304234508446501
10400000606030603040008080000000000000500060000050003000502000004040808000007000801
10234852703060303050604080602273885845728087483025575320605246403056802047882060701
10007000002060600040806000600000000020008000006070006000307000004000008000003020301
17732055332070422820508025535575235050606742705080427070707046675076763075402080601
10000060000080500040708000004000200060300020205060000080700020005000002000400040301
10862730706670557020606266308050307770705020602627568650337630805554208336767376301
10600000300040000040500000706030700000606000302000000030400050500000400040004000001
10702043757044747340345360374030502652408285204060576050504020436620606060404064441
10002000608070000020008070006030700050003000200060700060803040005000307000606000001
10377440203050406030506080607640734020663080766680805437408082662022208025308220601
10002020008000607070200080400000600070000080600040600000008000800080008000500050201
10403060438633705022324847206087753660638350208030283724884550603477358020853046401
10308080007000605000000000204000200080200000403040000000000080005000005070008000701
10608036253040302365435540403847602065705762305020365282685084428525608230303380701
10506000003040407000000000800070005000804000703060500080007000700000300020400070501
16607457505073404026874482224060405340265070305036306050702640606470207080736070501
10004000002000007000200000400050300070006070007000703000300040707000502050300050301
10873048607755203830602640337440226036604064552520403028337520405046728083503880601
10003000200000400020400040005000407040003000700050607000400000404000007030005000401
10203450608760748660854066302030507060506350706020302570507766702063405070766068301
10400000600080800020007000600020800040803000505000406000705000707000308080008000301
10757586763360202028702040774230467640803035803078202688204070803645405032234870501
10000070000040403060004020600070005000706070003000600000002060007000007000000000301
17556030835026805084375520303032406075756040447636737358484040424023674445384252801
10000040004000002000000000204000008000000080000000000000000020002000000000000000001
11111111111111111111111111111111111111111111111111111111111111111111111111111111111
