11111111111111111111111111111111111111111111111111111111111111111111111111111111111
10800000000040000000500000005000000000400000004000004000000050000000000020000000001
10404022473070655035804065706865807470202068505045707734606032668030846050682442801
10006000007040700030006000500000008000703000500040200000004000000040006000300000601
10762235208078502880503250704525626332605230204640706735887876773683506447507034201
10000020305000600000800080605000005000002000508000300000000030000000802000308080001
10826040308650524686306240707030803047355062686044687058574030208740206070407060831
10003000300040000000306000603020500060005000000080003000004000608000200050006060001
10302234742054875830787043558070347430405538768588705070604284225070746052838028801
10500000003000000040006000400030000070800000000000203020500070000020006060000030001
10684678702244367032804670307454868080707063525560207055625020253744708080623530701
10000000300000002000700000700070002000505000500050207000005040008040005050006000301
10205650705544606540253547433050375870408286407070207038405068406070254087203067201
10600020200000806020000000000050000030400000408030603000204080004000400040006030601
10875650885474804040225263785442257070274570806050402360706080673634502040827040401
10006000300030005040000070003000000030000030607000300070604070200050003030500050001
12706024203040703080546030368040333274845060308557448030302060236080273660506485281
10402000405000404040008000400080000080000030500000000030807050008000200000505000001
10506020808288885028802284708048285750703470476572422646502058404473804084605050801
10002020700000006070200000706020008000300040700000800000002070005000206000700060301
10702020226044205020387670704070204065275060808750606387668030703050203070502853501
10204040007000400040000000705030400080000060700050005000300070406030402060608000801
10842067502880625746725774308770233575552450348022607080605520407030702280275050201
10004080002000400000000000400040000000800000602000703070208000304060700080600060001
10708030456333507822387680675022207240208578806080778050552063422074833060806666241
10408080000000802000000030008000800040300000005030400070000050006000000040807050001
10502066826420302070683043204760364060552644844780308652235750403750533320505040401
10306060000060004080008070700000200060500000004000200000000000500020000040708000301
13508040784024275040206070606372206470707027305026324873574322484060735050302268501
10007000605000004070606030800000200030006000408000000000000020003060002050400080001
10556686408030803070408030304668502075764280404368605432286060206084704020804080301
10000000007030300050707050803000703050003000700000400070002040300080008070606000601
10662868423050577870506040652050404080767062563560608060807030504840582080478535571
10000000300050007000708050007060702030000050003000208000202030207070004060000000001
16866534707062305024804080707260702060452580502045646242506080607075375058733636801
10000070007040005000708060606000304020003000608000007040003070704060000060000000301
10752070268360257230506065602083737065767073202257706020776050402070253370566720601
10006000400000800030204030005070000070003000800020004000400050405050000000400000201
10406432428456507040807020537070727570705660724430465386806660602060434243503666701
10200000000000402000804000800030000080200020000030008000002000600040008000404000001
10538227228620506725304657202355607070658064888020533070253060385742445048202055231
10400000200000300000600000007000405000803000000030600070500020400000007000004000001
10802082808027338720537742883450406833203078673720805588202687808645208280267887501
10307080003000700040700000000000303000003000800080200030006000308000600050007000801
10205480506750505070202047352862705050783484502040433050836060244050405025472080501
10600000705000802000303000000000600070400000007060002050000050005080403000800020601
10268763538083207565708776736660307030707562562354308058283277605750304440503335801
10000000006080003000002000700080304050300070000000006000003000800000503000400000801
10827287606430786084886050806820606740428080302658863866607070823674435030456660801
10500000607000600020002060200050800050004000503000000080500020700000000030002000501
10806070507052708880607640603050857033302038523044586070205350503087426080203076501
10005050506000005000500000503000300080507000200080000030800050006000004060306000301
16872460606283375050334484704286203560706270505250563520356548484488502043602060201
10000060206000000060300000504030007000800040400070000070600000300060002080004020001
10876030707080824830203720502060428073368056502020253020706220202060362830203075241
10003060206080002030005000400080000030004000206050402000208050008050200000502000001
10404840403030202020435023822822558430708780744020602062505026568070306475506552501
10800000608080602030003070000000000000400080000070002000603000008080306000005000801
10442633407050502020807050502263664636633083247028552440703724506063405086545070401
10008000004070300070208000500000000080004000005030004000408000006000003000003020801
16588052548070266620508072343448266040208858707050484070403033638036557025505020301
10000020000040500030302000004000200020300020402040000030200020002000007000300080501
10675270302260722060406365808060808820504070502655258870858530706772505366222822801
10500000700070000020400000706020400000207000304000000030300030200000500080006000001
10804073378026353770773430856020802337507237608040878050508030476750402070802028781
10003000202040000040007040008020600070008000500020200070803040008000504000803000001
10663450602080803030206040505860848080335020286440402223504025884046603037404330701
10002070003000704050400050600000500020000020400040700000006000500070004000600020601
10205050675677205043778578604055756440424820606060887455742470805852464050488038301
10303040004000605000000000808000700080600000407070000000000080007000002060002000801
10202073647040608338357680405645503064707352208020328328686034765656706470302350701
10507000007020506000000000200070002000605000302070300050002000300000400070800040201
17705742507054408077485553577070208460483020202032306020403230704760307060872070501
10002000003000007000400000500080500020007070002000306000600030706000706060200020401
10326022608536706580307260434750374088602066234860207027422650402022742053404750701
10006000500000800070800050004000507080006000500060308000200000405000002030007000601
10407470208570735280252034808040206030707560404040405430403847306038304030382066501
10600000400080600020004000700060300030602000703000808000508000206000406060007000601
10676567772550608088702030828750654870305083203047703433703050703275802064366760701
10000080000060707050004070500050008000808030007000700000002070006000004000000000801
12825040728022308078622230508056502035578030665577525326375080273076638247737656601
10000020008000007000000000805000005000000040000000000000000020006000000000000000001
11111111111111111111111111111111111111111111111111111111111111111111111111111111111
