11111111111111111111111111111111111111111111111111111111111111111111111111111111111
10700000000060000000200000004000000000600000006000008000000050000000000040000000001
10802025467070786027408032707738707660408077505024404746807052425040538020444375701
10005000003030200080007000500000003000504000200050300000003000000050008000500000801
10664872402043307720503220705465785554403560504520307852236227467754405864607072701
10000040804000400000700070407000007000003000705000300000000070000000508000606070001
10438030607640363554708440607060703054224084863055848027354040405250504080208050381
10008000800020000000408000204070300030006000000040003000008000208000300050006030001
10306276363087738360453087642050822320403657576385605060203328733040832045858058401
10600000005000000060006000600040000060400000000000205030700030000070004030000080001
10875822203783724063408540307684555060502026766570202075747050635363806080833370201
10000000800000007000500000500050002000502000800060607000006080005080003060005000801
10305760706624207430875548634060378480804327305070505076204038406080333068504054201
10600040700000504030000000000040000050500000806040807000403030007000600070005070601
10635240547686208050678454362264876080728270408040705550803040832224202020756050301
10007000600040002020000080003000000020000080703000700050704030700060002050600070001
13702023804040208030382020226030338335882030706668237040707040226020652330602432741
10204000202000406030003000800030000050000030700000000070408030005000600000206000001
10202080207263343054804846207028374570804340765233728866206027205323804082403020801
10005030800000005040500000506060007000800050200000200000002020005000403000600070601
10202030286087604030862420504060606033442030804480705863267040305040303070202248601
10302020004000500050000000506030400060000060800040005000300070402040806020307000601
10344023304260862238824766702850338287477670423043204070808350205020403550246050801
10008050003000400000000000800060000000200000804000204040803000503070800050700040001
10503050435742308867343560442083804430307274804070265060686033425078666030405326361
10604050000000702000000050003000600080400000002050800060000030003000000040808020001
10406078523520406030826073206520337070326778675680807473654240608330787570705020601
10504070000020008060004040200000800080300000004000200000000000300070000050406000201
12303020377074846080404020506248703520803027402053462252387583424040385070505785301
10007000808000005040605030500000700080008000206000000000000080003040004080700050001
10732765606030502020605080406884606072564320808382506258848050708084403050302070301
10000000004020600070304050408000307060005000700000300030007070800020006070804000601
10865854338020746370302080382070405080757037643830503030403080608280786020353532781
10000000600070007000408070007020405040000070008000205000503040504030004080000000001
14647522206036204076307030407760507070442580804044726673607040708038288022685755501
10000080006080008000806050305000304080003000403000008030002080504060000070000000301
10352040638320276780507045405044288066765037407545502050772030205050445860762620801
10008000600000200030403080002050000050006000400080008000700040607050000000400000201
10704542722445403080508050682060767250805420737270257266602380203080626646607486501
10400000000000204000806000700070000070200040000080006000002000500040004000405000001
10687838676450805577507674206245806060887076328030337040258070557874545034205037681
10300000200000600000300000003000707000805000000030400020200060700000004000007000001
10303036602076742760272482332830406854802035232850206474503428505563208820282727501
10706080007000600020300000000000804000008000400050400060004000307000700020004000401
10702570507620508060707064623877604080233524605020284070335060623040803033243040501
10500000703000703000807000000000700050200000008030006070000030002060202000700030701
10436437887078403422303426637660802030402257828488707087728586702570404580605522501
10000000008040007000006000600080803040500070000000002000005000700000507000600000401
10377255702530324025333050606380205470428020205566864466207020645864283050226560301
10800000202000700030006040800030700030002000706000000050300040400000000070007000501
10202060204043407770804270604080867046705034843058776060807660605083344050208066401
10007080402000007000400000608000600040708000600030000040500070008000003040402000201
17875830608256665060266472805858808640406270403520254780248725775488304052806030301
10000040403000000050300000503040002000500030400020000050200000200080004040007040001
10328020408070583280702230703030428078375032304020538040602630706080725770805066661
10002030203070004050004000300070000050002000805070506000606070003030800000705000001
10404260502020606040884062272476685750207220887060406043406038565050405832804523601
10800000702040606060006030000000000000200070000030007000608000008070207000006000701
10236473304020603070602080307264424883264055588068334820604875205083602074288070501
10004000006080500050208000200000000040007000002050003000705000003000003000004060801
18864033556070373760303058624682468040408672402030822060802023373064773032307070601
10000070000040600030505000005000400030700030502050000070600080005000008000500030301
10886580404380366050605226204050303780407080507587324330848320205378508747632344601
10400000400020000040800000206050700000707000607000000030600030700000300030007000001
10307023463087578470586360887050706264406847804020276080806060834480408060508058321
10008000605050000040007040005030300070002000200070400020303040006000505000707000001
10343450804070203070406060807250248020546030246260707786608044673048406054408450301
10005070002000202040300060700000200060000070800020700000007000400020002000600080401
10708080427274607052855267704025864740338370603030266285727260408846648040373035601
10205050003000606000000000208000400040800000204020000000000020005000004060004000701
10502058726030802668228420306325607027406832706050457446338067282552406540202480801
10303000003040603000000000700080008000803000506070400020006000200000300070200070201
15608488306088708064842752885060506480277060802087403060803330304460408060632020301
10006000007000003000300000600060500050008050007000406000500070505000707030700080401
10262084605446802430406250565240466072404075536460704036447520602023352034804530201
10003000800000700040700040004000806080002000200020407000300000507000005030003000801
10304260708360633740787032402050508070404720608060802330508747703076706060654037601
10200000800070200060005000800080800060503000306000605000405000606000706060006000401
10542873656650203023404050328620773420204072402043803673406060608248705082243440301
10000050000070202020007080300080006000808060006000700000006040004000002000000000401
12578050257052202034585680503035307084365050855747255445243060387048574234747434701
10000020004000002000000000702000007000000020000000000000000060002000000000000000001
11111111111111111111111111111111111111111111111111111111111111111111111111111111111
