11111111111111111111111111111111111111111111111111111111111111111111111111111111111
10600000000050000000600000007000000000200000004000006000000060000000000080000000001
10607072757080576038206073303474606860504038306064304686803032337080228080586555501
10004000005070600030006000800000003000603000600060300000002000000060004000700000401
10423885704037506780307240804356736253508730302450203228653624734223603424805037401
10000030208000800000600070305000002000007000807000500000000040000000207000208050001
10674070406260563737306430302040808056284028526062744024754050406640207050406060261
10007000800070000000505000507030400070006000000030006000008000307000500070007050001
10402588483073858840755066826060222270207853846575707030604225752060747058283036501
10200000006000000080003000800070000030400000000000705070700060000030002080000070001
10222554407825478085602450605587882070308043456420304043333070654865205080882680701
10000000800000004000200000800070002000207000500020403000008060006060002050005000701
10805460302735806860253568433050263640307235402070406067606078807040744064807027801
10500070800000608080000000000020000070700000205050207000804080005000400080008020801
10425860773863203080328876376824352070554420607030807440706020432375403020758040701
10008000800030003070000070006000000070000060302000400040206060400040007080600030001
12704047408040604020357020577050726474874030202247637050604070466070622780802285671
10703000305000208050002000700080000020000050600000000060603070002000300000208000001
10607020203876765035608886305078855880204750362644233667406082205747406046202040401
10005020800000004060600000404080008000700040700000500000003070005000507000700030501
10605030588067304060733240405020208057276030202680607822248030407060406060303667401
10204040006000600050000000202070800030000040300050008000300080207020603030305000701
10856042202670435472485837702640526376752540333085805050705520405070202420856050701
10007040002000400000000000800020000000200000302000304080807000407020600080200020001
10502020484364702876227320874086607840805235305060273030564023477086537050303633551
10307030000000402000000030005000400080800000005040800050000030007000000070204060001
10705087245760407080832027804720333060476752255730505783686380706750354550607060701
10303070000020004030004050400000800070600000004000700000000000200060000080706000501
14402040465033878050503040202735502640804075707035375545578884653070268030203858601
10002000705000004070405080300000800080003000205000000000000050005050006080400030001
10642372603060204080705040203837204086285860405278204223558070208083404050807080401
10000000006030800020507030806000208040002000500000800030004030800080005020303000701
10828477753080655380605070267020405060765053637630602040204030503260785040788533461
10000000200040005000808060002030407040000030006000403000606060203020005070000000001
12376357607037606023304060703840703040247260504056363677206070805052823025472827601
10000060005040003000704020408000805030003000503000002070005080602030000040000000401
10334030324630544470303084406035372072654072605256205080274060502050764560635320601
10008000600000500030406080004080000060008000300030005000800020206060000000800000501
10808482355845306080806080756050246560408470458350563484807560304020226265703456301
10300000000000404000606000300030000050300040000030007000008000800020007000807000001
10737452358780305355203528305584307050836038582050334070487030873738567072606023641
10700000500000600000800000005000208000206000000030200050200020300000008000004000001
10808055304065425660227784436240403368607085665430502285706836508428605470427674801
10808080008000600040800000000000802000004000700030500080005000503000300040003000801
10802680604280602040405022638633303040388842508050554070354070758060507058782080701
10300000302000303000507000000000400070600000002060003080000040005040406000400080501
10584375647053502548805587278460605040705856488835202085774824508830204740406235701
10000000006050004000003000400080204050600070000000005000004000500000204000600000801
10385666204470286022632040603540205860655020807663825652706050275256345070546280301
10700000304000800020006080400080300050002000603000000080800080300000000020004000701
10806060303085605320203240703060735048702023422052325040604320707056256040607034601
10007040302000007000500000503000700030705000800030000080800030008000007020803000401
12368440706477447020888286506343604680803470602880332440277878657887407064303030401
10000070508000000070600000702060007000600030300080000050700000600080005060007030001
10243070303060567880802670303030638023436037605080742050205270608070224320302055871
10004070406060007060003000600030000080004000408040604000407030007020300000304000001
10607670402080308030786055858434477750604660335030505048405033262050505634707887801
10800000304060604040002060000000000000300040000020008000703000005020404000008000801
10243436505040308040405070808832773765236082663026376460607746305062307056683030501
10007000007060500060606000300000000060006000005040002000503000008000003000008020801
17677047568040234720602068563636666060306687204080663040606082638076244038602040701
10000040000050200070406000007000200070800080806040000070800070006000002000700070501
10555880502670238080805672208020505620705020506563742270645260502334506882637322301
10700000800070000050800000304040500000506000506000000020200050800000400020005000001
10306054226023772830227660353050607364805843407020783040308080453450504060407062541
10004000408060000050007030006040300070004000400050600020808030008000306000306000001
10725650806020405060502030405620562060782080843450706757704022745052806086808220501
10006060007000804020400050400000700070000040200020200000005000200070002000800030601
10306040432674505077444453608083283860748250608050572436686250502728383070586067601
10803020008000602000000000805000400070300000405080000000000040003000003060006000401
10404025342040304554455550306743207037206662802050524874556048464468203860206540701
10207000002020502000000000200080004000508000402060500050006000800000500040400030601
17602724506042805058575252343060706540745030704055702040708820504280502040838040201
10006000004000007000200000700030500050008020006000703000400080507000705070800030701
10384058207327506660603280322860237078203028353720804074585270802083662068603720201
10003000600000200070300070005000704050006000600030507000800000307000002060005000601
10605750405570673840668086606070406060705620707080703670205558605078502030873062701
10200000800060800070004000800080200050707000702000604000207000402000503060002000601
10743332435580504064802020574250663740508026808048803374604060805225502068677850701
10000030000020405080004070800080007000604040007000400000007020008000003000000000301
18845030564037305078382480208042606034843070657258633686526070768075865364724766701
10000070002000005000000000202000004000000070000000000000000080002000000000000000001
11111111111111111111111111111111111111111111111111111111111111111111111111111111111
