11111111111111111111111111111111111111111111111111111111111111111111111111111111111
10500000000080000000400000002000000000800000006000005000000080000000000040000000001
10505066227040843044705066602786804280406028806058204637403062736020348030268457701
10007000006060500060006000400000005000405000800080700000005000000040002000700000801
10677787603084402850606270406757834634702560807420808833774628335755605846307068701
10000040207000700000500020706000004000007000403000400000000080000000507000604020001
10667080708330587425707430604050606067233027256043277022833060703660308030702080221
10002000500030000000305000304030400070004000000030008000004000606000300050002060001
10702768885068524380653072748060363630202278328572804080804435468070828052834073201
10500000007000000070006000400020000080300000000000406040300070000030008050000070001
10486626408677358024306650403384862020404082735530608027463040776882805020862630301
10000000400000007000700000500050002000205000700040305000006080006070008080003000801
10206750703473305330435568364080433680205648604040303057308038203040363064308034501
10400040800000803020000000000050000070300000702040702000803050008000600080007040501
10365680876325402080627888447886685030636350502020402430307060853686708050733080501
10008000800060002040000050003000000020000080703000700070408070800050008030700080001
16206024702040303070872040657080845582245060206476224030406080775040438660703765431
10506000503000704070003000600080000020000060800000000020604060007000300000706000001
10706080506877262082707778206028456380404720862526554253806084706327607068203050701
10007070700000006070500000305060008000200040600000400000008080003000505000800060501
10702030574024604080434350308060203032762070506680207275663030808060707060504636201
10208070002000200030000000208080400040000050600070004000600050606030608040807000801
10522027405770548253427436302440686543477580854022506050205270604080202250277030301
10004020004000500000000000800040000000800000304000702080505000604020700040600020001
10205030683443703323473650373026605670807655608080585030824062465057256020704683441
10505080000000605000000080006000200040500000008070400080000070002000000050805030001
10304076564820307020343063703420365060723737742820308743547850605750867830305030601
10304040000080006020006070800000400040800000004000600000000000500080000060705000701
17505060886056767070507030204284708760208054503045273486472778553030243070506325501
10004000303000005020304020500000400080004000803000000000000030003070008060700030001
10528876204070302070508020305687702076823640708358602566583070707026505080204060701
10000000008070200050302080306000802050003000400000700070005060300070008050302000501
10528328853060686320707050438030407030875027847340503040208060802270823070523845421
10000000200080007000308080006080308080000030004000707000604080303020006040000000001
15885546204075508066603070807280606050557420808047726268302080604026543028348352801
10000050004040005000605040706000607030006000507000007050007060507060000070000000601
10673060273470288620202053302078446065466055205258202070646050502050267570578240201
10006000700000600060808040003040000080006000500040007000800070206050000000700000201
10502532653325602050507020865020684570308820552760287242805720203080848482603268501
10400000000000304000608000300040000060400050000060008000008000300040005000803000001
10833338427570508268608525805284604050458054466040623040743050753664342074805047331
10700000400000300000400000006000703000408000000080700080700050400000002000002000001
10305063502084774370657522256280805486203032753450406858508348207544203230537444401
10805070008000600050400000000000203000002000800020300060004000703000300050008000201
10803420305370303050504033684733506080776562604040245070722060482040603023844050401
10700000405000308000306000000000400070500000002060008080000030002070805000500020401
10673262338086603275406232662820704070406475283262204056286335804620808860203866601
10000000002060007000003000200040505060700050000000004000004000300000506000400000801
10328373405340262063432030707240506250882060308386225743805030643723642050333560801
10300000207000400020007050400050200040002000704000000040400080600000000020002000201
10407050604044203270507440505020336062703047253037235040708750708043523050202076601
10003050703000004000700000205000700070602000700070000030800020007000003050808000501
17342830803252487080346788204832208760208680305540453540755652556742705088805020201
10000040205000000060500000807060002000300040700060000040600000800020007060008070001
10537070802050425860405730603030882075457078804030274040305420205080584520403038341
10008060406040007070003000600040000070008000404080303000708080005080700000705000001
10305820805030703020423083225438374360607870724070602037803022762040208576504847801
10800000503080508030005060000000000000600070000070008000506000004080805000008000301
10727782206050508020407060506558857887868077232055646530603363508047805082443070301
10008000004040600020605000500000000050004000006050003000306000008000004000003030401
12846038647060556580303027666774242050603374505050767070704058738022534027605040401
10000030000020500020505000004000300030400060604070000020800060005000008000300060501
10478340806680538040608536506050303650604050306434638670382480603237708566776253201
10600000700040000070700000205060500000208000708000000040500020500000200070004000001
10702036584032624840254480253080606743308843508050658030604060288730605020807036281
10004000805070000080008060002020600020005000600060800060405060006000604000305000001
10467240608040505060406020706770647020724060562580802362802076253055203076408740501
10002060007000505030700050500000500080000050700030800000007000800040006000300080701
10807050524587307024764478304087677730783470704060664238785330803448665070622087201
10602080003000608000000000707000200070200000203050000000000050002000005040007000801
10304074232070408688756860503235407078702436507020634657323054856483404860405770601
10604000004020304000000000200040008000508000202050800070005000400000800060300050401
12802728202048408038762372277020202440866080502065205050208370604370608080757070701
10007000002000006000500000500070500070002060003000603000500070406000507050400070301
10822088505255706550205430466640585087508053267340608048664560203086486044605370701
10005000600000800080600040008000508050003000300040504000400000806000004050005000601
10303430707220528830328067408080705020508560408040708340804577608037503030766074301
10600000700070400040007000200030700020407000304000506000603000205000808060004000401
10482326744240505052504050442860537470505078604065703554308060706572503057342220401
10000080000080407020003070200070005000204080007000700000002050003000004000000000601
13456070746046808045867380806036804054444050857835254677484070366064747284263384801
10000070002000005000000000805000006000000080000000000000000040006000000000000000001
11111111111111111111111111111111111111111111111111111111111111111111111111111111111
