11111111111111111111111111111111111111111111111111111111111111111111111111111111111
10600000000030000000400000004000000000600000004000004000000020000000000050000000001
10706084648020487052602042405332402430603034404084308647202062278060426040852282201
10005000007070700020007000300000008000402000400060800000005000000050007000800000301
10428473607046408570208440702272527786808750504840206232286624267357804428805062201
10000030802000400000300040605000002000004000503000500000000040000000607000206060001
10637030402720773448803220203080202047522055548083587046273040804430407070803050881
10006000700020000000805000508070200020007000000020004000003000605000600030008040001
10703646276036287560866062322050662860404227757444207040407583687020582085375055701
10600000003000000080008000300050000040600000000000706060400060000050008050000070001
10728368702464483045805780204665766060402026457540504058882040854556406070863350601
10000000200000008000800000600030004000608000500020305000006030006070002040004000601
10302850407726702250728274366070766530608623707020608026402047508060275023503066701
10500030200000705070000000000050000070200000203070307000408050004000500070003030601
10524550336436804080655384727624388060362470703040306350807020234367207030566070501
10002000200070006020000050006000000050000070807000500080703040600020006070700080001
16202084605030304040765080552030288524564030802252753070405040433020368270708244651
10502000402000402060005000400080000050000020500000000030708050008000500000307000001
10203070203264877036606748504023475320608680762767443546706036404636505078703080601
10008030400000002020800000703070004000700040600000300000004060003000603000800030601
10203050776025405020225880506060602063663030308430208737548050607030707020208846801
10803030007000400080000000507070400040000070500050004000500020707030406060504000801
10836077507660575262865483302720354456824540648063803080604780503070205220253050401
10006040008000300000000000700060000000800000708000207020406000802070700050600060001
10707020487352202848867370787025602420408364205050475030262085555046527020203738331
10403080000000407000000020007000700030600000005060300050000030004000000030403070001
10207073475840305030875078407780534030535562448680308336446870202660344470802020801
10504020000050004030005020400000600050300000006000300000000000700050000020504000501
12306030562037823020205020803666308420404072507035777522632728676060763080308435301
10007000808000008070806070500000300020005000806000000000000080007020008020600080001
10263453304080607020508060306843206043276640302585205346834060306025508020204050201
10000000005080800070205070507000805040002000200000300060002040200070002040805000601
10242824466040256580502040287070306070578054522860502060403040207380623050753532221
10000000700050004000507020003080607070000080008000605000808020506070002040000000001
13344546208085808082607020506280208060375770402088684775305050505074867063482868801
10000070005050002000604020402000603070004000408000004030008080703060000050000000201
10836080523460344270508048404083832085387085603632403030543040506080228880267430501
10004000800000400020304050005030000060002000200070008000500070404040000000400000801
10805724224836704070502040834040583260607480286220222372608450505050422882306677801
10700000000000803000305000400080000060800070000080005000008000300050002000803000001
10763362534850704525503847506826802080462037677060778040785080474476422037804032851
10800000300000600000800000005000704000708000000030400050200040500000008000007000001
10502085304088865530267487725730408875302042872370605352705486305857302630824558201
10308020008000600040400000000000607000007000200030800040002000705000800040003000301
10302870408320206030406062522284506060527787405060743030253020558070305033878050801
10800000506000303000304000000000600030800000008070003060000070006070307000400080701
10527875343026508433806426446340203020603266863342306052676668205350306670802522501
10000000005080006000002000400070603030600070000000005000003000400000403000400000601
10234784205370848063444050602730808550372070706232325585507030667788687070682640501
10200000206000800060003060600050600070003000605000000030800080300000000080002000201
10607040805068205470704830204020742045602052254044785030707420804048766020508085801
10006030703000006000200000206000700020203000200060000020500070008000002040402000201
15373250707646865060757678808682608280302630606850225550543724775742206028408030601
10000040303000000030200000708020002000400060500060000060600000300030008080004070001
10766060705030834880408380402040383032238078305060338070403740306020746260503077241
10007080808080002050008000700060000060002000402020504000202070002030800000204000001
10305450608030605060267055233858268650205740236030604057205023833050602268702474401
10500000402040503060002070000000000000500060000070005000406000006050606000003000301
10685448203020407070502040308788254745543086758027454280603352803038703026683050601
10005000005020600020605000800000000050005000008040006000303000006000002000008070301
12283076848040434440605083452476263070308552402070877050806034882025737052502070701
10000070000030700020202000003000700030500060708060000020600060002000003000800030201
10564450707870864050507375204060705540702060402425288770754640608862508267858746301
10500000300020000070500000306060800000403000502000000050400050300000700030006000001
10408075353056464240575640355080707873804585206030265030408040674440203060703038451
10007000606020000070008060008080800070003000300030800070702040002000303000307000001
10435270203040805050507070206850437020622080328530305248307085646053402056304370701
10004060008000605030800080500000800020000050200040300000004000500030004000600050801
10608060758754503033775888202035683460333770804060736788734730502583323060334052401
10207020003000608000000000206000600040700000208020000000000080005000005060002000401
10703068245060304488753720808847403058503686506070824875568086578425304280406230401
10306000005070805000000000700070002000806000605070500070002000200000400050600050301
12805466203056307038454744222030408860377030804066805030508760306350603040588070501
10008000004000008000500000700070600020003020006000605000700070502000607020400030801
10434044607835508330205460874880732045802052457820702033867450802033875062704650301
10003000400000500050400060003000602070002000500030708000400000304000002020006000501
10703740608430625430557083602020804020208770607080708670404436802077206050535043501
10500000700070300050002000600020400030607000303000407000405000403000307050006000501
10832284483770305083207050436550478470705075804043306686205070503757307078863340801
10000080000040302020004040400060002000707050007000800000007080008000004000000000501
16345040743033503036826560608048706025855040865757458332353080555085587865855887201
10000020005000004000000000203000002000000020000000000000000060007000000000000000001
11111111111111111111111111111111111111111111111111111111111111111111111111111111111
