11111111111111111111111111111111111111111111111111111111111111111111111111111111111
10000000000000600000000000000080000000008000000000000000600000000000000000000000001
12403382542250876840308574584036503038407340502057203770758050807662624532483375201
10005000000050000040300000007000503000200000303000504000500040605000000000000040001
10206336584060887050364377203450303630588837352360308075506430274050377784673060561
10308000300050507000700000700020508000700020003050303000005050002070000080004040001
10403040607050208283806020275060203045608054305070806585664070208085552330404070201
10400060002020002000007020207040008000007000503000800000300030500080000000500060701
10362067886650658050482060503056585480575450305646654370703876286670336747855050401
10006080000060600020007030004000000030000080203000000050700000000000300000008060401
10707370508075204062608023266448645020778020405050338030666456258545804622606380701
10200040608000004000408000000060000040005050005030006070004000500000406000600070801
10635080705742565620408226526750706538502053268054403035405070302420503080627053701
10002000503000000050500000003000800040002080000070603030004050007000507020006000001
16206366305030305076322878837082474080303020307680502080268030763045743020805743801
10007000800040706000003040008080700030305000200040008080006020007000003070400000201
10867370204530334087704080807030403680203743734688642060808050408783202050286360261
10000000300030003000700030200050005000700000000050000060206050500000800080000040001
10874268503085506843535620732430537060478424778050353353506074862660764875723870301
10000000806000500000007000700070800030400020300020000050003000500000700000000050801
10266850333230468778508083847050508658303020704732673060658860407782404478837073701
10000070500060400000003000000060800000007060004000007040000000702000507000300070001
14735480807050408033333788402885703270238035346078466070355462747060403060304640801
10000000504080703000000000602000400050005000005000003050000040005020007060700080601
10757343502030802265607870353060733045727820702836707036745040506022435080658050531
10300070007000600000300030700050008000000030300000304020000070505000000060800040001
15205030204465662660785370208742505067246053503440507076477360408225244547408072601
10005050506000000040000080202000008000003000802000306000000000400080008000004030001
10562020656085243027266042807060627776707350303076204326208272653060804020657030451
10004000300020008060004000806040000020006060704000305000400070005000800070003040001
10708826405050508060555750355037886020873020447250708060757073407057853437308088301
10200080005070400040000050006040000040300050000030004050200080005000000060005060801
10856080238080726237844060805060224480506553468046255440205740508375238030568050801
10706000500050000000000080703060600070002080008000000020800000207000000030004000401
10508537303065373574768550504030207038342050602024533030276826664028546850302376301
10800030702000000000000040500050008000005000402080004040002000000030000020800000601
10607020802075276238825020205027537580808444302020203087205888442650556030444780301
10405030008000002000003060608020000070800030006000207000700000000030500040000060401
10552020874786205084403050802080576056688030656333803870508826344030505057224050201
10000080006000708000500020708000700070000020000000404000500050000070404000008020401
10246283706067204020347230605774282720208836455820402048476820708258303752243040501
10400000706000004070007000200050000000800080000000604080000000808000004000300060801
10807340604677256222547088244060488324543460875453506030402768808026864080507460501
10006000705000500020006080008040800000000060006020003000300080208000006070200050801
10838087306030408030602040777070604066353023604070802620883080808387806027687030601
10004000500060306000300070008030005060004000002000200030203000608000304000003070501
10305240586320408255233642202083332330305668323248366050307020308060604747503020801
10700040800000300000200070005030000040800000700050007040607080507030700000400080201
10654050307676225420205050387060483070805760806020808060502038508050858770844020201
10008080703000600020803030000080003000305000307060400080602000505020000060006070501
13888020408030806040406086562273602083707048708060433630405460308078632038807050701
10006020804070007030602000300000407000602000602060300080006000304000807000807030801
10603060804080457720408670307220408450302380852040866023456635203650805080504660601
10200030605050007000504000802000204060302030007040007000000000300070308080200050601
10257880807026603042808078806078508060702030505058806463564280403080504030863020801
10300080403070004060007000006000005000704070400030800000000000307070406020003000201
10307070205046265060807546308758875526802080627670604543642264502070704057302244501
10306000305000003040700000800020002000004080000000800000006000003060306000500000201
10306565803782605040508520277030404076483086733450607282844086437060307244248050401
10202000507060006060807000600060708040008000400050803000002070400030600000002020401
10608320206040777040408065206420706020704280502030472047607070603240707756604040201
10607000500050000020503060005000802000300000706030200040006080600000400000505040301
10702072434785468260805023427070805726488684808065803840702040835477728840402240301
10200080006000000000205000000020600000000000404000008000208020000000006000700000301
10683850208030283882604658763738677277868530763576434020404043563725406037563867201
10000000700060300000300000800000700020000080000000002060407000000000508020005000701
10288745653680404620406470506740207040526044476380605080406253545370705046303030501
10000000000020503000800060006000708020200080000040500050200000003060005000008050001
10784420824720305085683082534080583060307780628025542460705572403050647676755022431
10000050005000302000007000400080600080200000400040000000400000605040000070000080001
10832028203046507784707843206884404550827780602240764364766250405026845020473320501
10004000805000206000200000600000408000700020604000500050000050500040000080000020701
13203280806550307040624650536770604070808024208052837070237850455560805258887027601
10005000300020308030000040000070705020805000302000003070700020003000800000008000001
10503062847080802064508022867060706022703450307087305050406048604074428280406466801
10802070004060007000607000008080006000500040007000802070705040004020000020400000201
10625054807062734850405662288052775320573022654620202050302020825040276026563050551
10003000205030000000806060000050005000600040006060505020302040700080600070004060001
14707450607030203767607030673780407020808365604030602050707030782740502760403034801
10005000202020600000600030000000805080800000006000600020003050006050200000806020001
10235037807080804450533868546352704050542353228323443458288048805060306256605720601
10007000006000200030000000000000400040000000000000000000004000003000400000300000501
11111111111111111111111111111111111111111111111111111111111111111111111111111111111
