11111111111111111111111111111111111111111111111111111111111111111111111111111111111
10000000000000400000000000000030000000003000000000000000600000000000000000000000001
15706747778640852520303764677045406035504520806058202570883040202723576757622645801
10002000000020000030500000003000202000800000704000508000800020307000000000000020001
10202272587060767060275554704450603240633643752420804055604240646060775765254030881
10604000400040704000400000800060604000400040003060807000003020002040000070008050001
10208030806020303856805070837050503086305085403020603243427030305037363680806030401
10300040003070005000003070304080004000008000707000800000600070600040000000200070801
10856027222430445040884070604064464360784260504287757850605738423640237727873040601
10004060000050300040006070007000000050000040307000000040200000000000300000007020701
10606230703072506077703054832543537080748050503040836020542828648475808725806270301
10200070703000003000503000000020000020004040002030006080004000200000704000800070501
10437060208387642560407722448740804284606048858068406087503060508580808030274036201
10007000202000000060700000004000800070003050000060602030006020008000406080005000001
15708643204040304052335248268028362050608080608730204030452080844022262080704768301
10006000200080203000005030006050300060608000300060008050005060002000002020700000801
10658350207670782044404020204070305470506477626784556060604040408434204050652530831
10000000600070002000200070400050008000500000000030000050505080600000500050000080001
10356622404026308275246280686720282060626577332030283285403053768820727476342860801
10000000508000400000007000500040700040700080700070000030007000500000700000000030501
10542550362380676352703075554030203437805020207752748070574620605222805232336058201
10000050500050700000002000000070500000003040005000008080000000402000402000500040001
12623330202030202056275424204737806430433067527083675020235347363070403030507430401
10000000504070203000000000607000600080008000008000004070000030004020002070600060201
10488662706040502455207660653040687056226380202772704032376060708085325080573020631
10500030005000500000500070300020007000000050500000605030000070802000000030700060001
13703040602762756280762730403443502065563054504850507086842670704662475678506087601
10005080603000000050000080208000006000005000704000308000000000400080003000007030001
10773070585065228067732082505020645858506660204064503547208855856020606050522040831
10007000500020005080006000705070000030005040408000406000800020006000400080007050001
10206245503020507040564320537065384060872040877820503040368032602062522828703033401
10700050008060500060000040003070000020300020000020003040600060003000000030004080701
10238040685060753328768020705020642770604234563083476520807620408622434050558050701
10406000400030000000000020603060700030007080005000000060400000504000000020002000401
10407754404065772682235720502030204033433030602046624070466425386063882760604287501
10400040603000000000000080300080008000006000508080007080008000000030000060700000201
10302040404063337876558060702047853560403535404030805068603333537560273020768430301
10506020003000007000003070508070000050600030006000804000300000000050700030000020301
10432080246584504067407030605070362022363040438675202880605262537040503086566070401
10000020005000304000500020706000300070000070000000406000500030000070205000004020701
10323272307088504050726660706652723460805334542740608032564720507278202833454030301
10700000603000006050007000200060000000400030000000805080000000502000006000200040501
10703350306768566737352032788050355385728330448356302040306442403046455030703850801
10006000405000600050006080006040800000000060002080008000300050804000002060300030501
10454026806040308060204070347060807072232027706060702760522040303644804053665070401
10005000800020803000400060005070006070005000005000800060202000506000706000002020301
10406440523640808588838582506075485880305372877752356070405070604030604557603020301
10200050300000500000200070005080000070500000800070006070604050602040300000400040801
10684030408587663720508020247080874020302740802060506050307088206020888740856070301
10008020203000500070803060000080002000603000205040300080203000207030000020005040801
12526050806070504020506053575667606082803042508050736860504780206053726056605020401
10008080506050002070303000300000402000606000503050600080002000803000805000303040801
10203030508070486240206230707230502320408720457060383076746355207640303030306840201
10600030204060008000505000508000806070202050006060004000000000600030805020700020201
10427870708055704044704063708084807060406020307064403378265780703020704080688040501
10300030804080003080008000003000003000804060200030200000000000404040206020007000601
10704060407055576080502683602787872774502050457650408847256826806050806074508662601
10706000204000004070500000200060003000005060000000800000002000005080302000800000501
10605733706745208020606820455080707045845028435580206875255084672040802446756030501
10604000606060004050504000800040207020002000200020606000006080700040300000004020201
10608540206050622070602066802550308020207420206020766054704020808230604545703050501
10808000600030000030305050005000402000400000303030200020006030400000200000807080801
10802036828847438670808082478060406257844737305067707570503080728845778270603780501
10300050007000000000706000000060600000000000307000006000803030000000007000400000801
10858680605020346662508682286728374372648560462536427070207065663543206078448722601
10000000200070300000200000600000200050000070000000003050508000000000207050008000801
10544286633250502560403680706660807020577042835220805050506576858530708072407030201
10000000000060707000800070007000603070300040000080700030300000008040005000006030001
10675850463560808042545043676050742080407330246084458830605382804030563637684085451
10000050004000307000004000400050600050400000400060000000300000204050000030000080001
10558033306023806287303724803232407330768350504430658788373570608045873060363680501
10004000803000702000700000200000702000600050404000800020000050200050000080000060401
17408230807660805040755460365350402030202077807023265070426570654520508622474088801
10002000700070507040000050000040706080704000408000006070200070006000300000008000001
10705057242080807027503055552040206052503480604026408080608044408068582450408622201
10208050004020006000604000005020005000500060004000404050306060004020000030300000801
10657066503085783770407436622043685560474033575520707020404080884070852072324030231
10005000506050000000702080000040007000600030005040808070708020200040700050004040001
13603820302020307232504050886820706040607436506030506040807020738580702870607084601
10005000302080600000500070000000205050400000005000500030008070005060600000404070001
10766033704020804540636435365846704040747626636278657888563045704070202284803580701
10006000005000500070000000000000500060000000000000000000006000007000200000200000801
11111111111111111111111111111111111111111111111111111111111111111111111111111111111
