11111111111111111111111111111111111111111111111111111111111111111111111111111111111
10500000000030000000300000007000000000400000005000006000000060000000000020000000001
10807022533040487086805037708234308520302028502083603238804084287080333080366477701
10007000005060200060003000500000002000605000400080200000002000000060005000200000201
10872785406078405880406560403453668722504520605420803734327776288668308275603052501
10000060204000800000400050204000007000004000203000300000000050000000302000603030001
10447050305380456636403620202080607058684075846034733083582030708420305050405070571
10004000500040000000608000303080800050008000000070007000004000305000500050003050001
10305624347077228830547074767060836350305742465853302070507638736030678023788028601
10200000004000000080003000500050000080700000000000707050500070000030003070000040001
10778767806635722067202620203728755020303075288250507086573050222523305050254680201
10000000500000002000800000500040008000503000600020304000003030004050002050003000501
10805620507667402250446648243080827350706833807040602063404073204020522074407078401
10300030700000507030000000000070000020500000603020207000207070004000600030007050601
10365630525746206080322728746675823080287340603040205240408040376864306050232070601
10005000700080007050000060004000000070000050707000600050406050700040007050400070001
18504047204030608080358070623070766685368040707823754070406080365060522530305874781
10607000206000207050003000500020000080000030400000000070204040002000300000506000001
10404030503842673042308584603064338230806230434553743868307073806828806033603080201
10004060400000004050500000707060004000200060700000700000003070005000404000800040701
10802030486087304040462260202060708038444070308740402347627080703080503050407844401
10304060002000400020000000503030200020000080400030006000300020407040307030502000401
10745082503730345788565675406330273742375440848075208070602580203030707640867060401
10005020005000500000000000500020000000800000303000307050702000405070600030400060001
10305060738676407623378720775025506870305253807040388040373034343083484060505635461
10504070000000707000000050004000600060800000004080600050000020008000000080406070001
10607062682340802050768038202640362050532433384750607656772260608770347850405050401
10403030000050003080006040600000400030400000003000600000000000400020000040505000401
15604060255074333070406050604466505820706052402086383524475686258080534020504342601
10005000802000006080302040200000800080004000203000000000000020007030004060800070001
10437377608030506070405060706848307047344680502627606234888050608064504040707040301
10000000007030300080805040707000404040008000200000600030007060200020005070703000701
10237426447070358880703060748080607020842072577350204080804030702220225050736456431
10000000600070007000203080002020402080000060003000604000702020806060006050000000001
17348333203044807038705040305680308060377760502054344585807080804056667038285852701
10000050004030004000504060306000203040005000207000005050006030305030000030000000701
10728070466740878680807023508088724025764073204534604040725070308040852270747860501
10008000300000400040604080007040000070004000800060006000600040704020000000300000501
10605532626663705060604070547020734640807670438660222676802230802070355367607424501
10200000000000404000707000600040000030400070000070006000002000200040006000703000001
10435648844470306668603327206245302060482026252050457080428020432255734034803083871
10800000400000400000400000002000703000702000000030300030500020800000004000005000001
10602078606047248280478437766560504333603037322650406272602425306277407420578642201
10607080006000700060300000000000207000004000600050200020006000507000300030005000601
10607220302830508080707048623882808080458338303070487070273040266050703077522030601
10600000305000508000707000000000500050300000007070002050000030005050603000600050601
10334385825055304247506852334470704030605462777734202055856838408830202440504852201
10000000002020006000003000700070204040600050000000002000002000500000204000400000801
10825738503550864036548080207460508820565060302237535655606020245357438040487530601
10800000504000800030005040700040700030002000607000000070200040500000000020008000501
10503030804056408640704730204030554034302082565085862070502250502055652050205062501
10002070505000007000500000804000500030206000200050000060400030002000006040505000401
12467350702322387080478446303386505320708460204520258540375558632282406087808050301
10000020406000000020300000405070006000700070800030000060400000500070005060007020001
10263080304070444820604760804020428066847042703040238060402320507040375470606022231
10005080606080002020004000300070000030002000405020604000405020002080700000207000001
10307830503040705050634084833373438440706660826060805024802023384040407864402536201
10400000303070806060006080000000000000400080000060004000406000004030707000002000701
10348823208080505020602070505327664275373054386034552230305352203053204047732030701
10004000008070600050605000400000000070002000003040007000505000003000002000008070301
17568035677040344380608053658648278060202558803030736070404085366064224045606060701
10000020000080300030705000003000300080700050307050000040400040005000006000600030501
10783860802470548060705327404040703580503050404233382770366230806562303245825683601
10400000500070000070200000306040800000608000205000000060500030800000200060002000001
10602063358065768680382570682080707537507868403080268030203020372550807080806035781
10004000205040000060002050002060500060004000200030800060202060002000308000608000001
10672740805040406070404020402480546070545080833350303363603084828077502047807570801
10006020003000403080300040700000200080000020600020200000008000800050002000400070201
10603070654785504085232786404045332380466430603030445673642750802777374070744025701
10808060005000402000000000303000300020200000307060000000000020002000008050004000501
10607046834070603727337420205634306056707423803020778424357058867873507770604340701
10505000002050805000000000600080003000807000607060800080005000600000200050200080201
16506582404062202085723857863050207520785060305054808040807360404520607060673030301
10007000006000005000400000600030200030006080004000503000400020205000306060500070601
10532068304475302260608230234570765085208033255850803077776670502053672046207620301
10003000700000200050300050006000805060002000400040408000500000502000005040002000501
10607750303420662580877026406070402080302720804080708650807267504034305050574083601
10600000200050200060005000700080400060406000804000305000708000705000702050007000301
10654436255270303038307050784870833560302027702022504545606080302327308047442330501
10000080000050604040002020600050005000406070007000200000003050003000006000000000501
17348040722064606053783220402035807035745030677777263268633030582088284233623225601
10000030007000003000000000204000008000000020000000000000000040008000000000000000001
11111111111111111111111111111111111111111111111111111111111111111111111111111111111
