11111111111111111111111111111111111111111111111111111111111111111111111111111111111
10400000000020000000300000007000000000500000005000005000000030000000000050000000001
10503038223030445072805036807585508780205054705063703387706078367040355030272883601
10005000004080300070002000300000006000703000200080200000005000000020003000200000801
10826686603037503370603860502467232564306320302220403662686283484848508583502088701
10000070806000700000700080502000004000002000308000700000000040000000803000502060001
10828070805350727743702230607080207022523044822043462076228040506450505030306050741
10005000800070000000607000607030200060003000000030003000004000407000700060003080001
10603586754023827860882042262020738630505866465228806060305543487050272062555038501
10700000003000000070002000800030000040700000000000402040700080000050003040000040001
10333426402658787038708280502352843070207055587450406028764020423388303070472560801
10000000200000006000500000400050006000806000800030806000004070007020003060003000601
10605550803842806260278787283040757680804427407050602032502038207040282035402058701
10500040500000807070000000000050000070400000208040302000506020006000200020008080601
10442630854388402030346765364622373050765750205080308720805060322254802080584040501
10005000300030004020000050004000000080000080603000500060604060300060002060600040001
16807064703050406040787030436070337742854020408482867040404050474080774460306273351
10706000605000402070002000400040000030000020300000000020608060004000300000206000001
10504020802764727043704888404046332530503550525727353778602085207483706047202080401
10005040800000008020300000606030003000700060800000400000008060008000502000400040801
10304070535072503070725260402040304066266020306450704655225060704050403050602868201
10506070002000800050000000406050200030000020700030003000600080606070702030306000401
10535025508350875628476578402260685838584540366087202050406330207080402840642060801
10006060006000500000000000400040000000700000608000705080708000207030500030200020001
10806030445642507723853360748032607740808532602080756020755046523066544030604277871
10807070000000405000000060003000800050500000003030400080000020002000000040704060001
10302024865670602060826058802380362020528523846760308666287750602740734650403080401
10407070000080006070004040700000500080500000005000800000000000600020000040706000701
15606030463044443030803060504548408760504024403034353372534778583030366030805365701
10005000702000005050302040800000600020008000704000000000000080003020005080800020001
10537746804040206080702060506775708048338870407347504882653080208075404030307080201
10000000005070700050806080702000608070007000500000700070006060400020003020407000501
10372887434080862420802030875030408070354063755470402050804070503220764070824856621
10000000300040006000705030005040208080000080002000307000604020502070008050000000001
14456472405034708083307030707770803020783330402052536465405030502035355025832235801
10000030004080008000604080804000302070003000808000005020006080702030000040000000301
10427070422480485420704074207052486077285053508746608070226020606080532530664280401
10003000800000300020208020008050000030005000200080007000800060405070000000600000201
10507238265875305050802040727080463480508680335530473252802680203070436434307728501
10400000000000204000803000700070000050500070000040008000007000200040004000404000001
10682353862230407878402252803427303040388037375080787080368030648874328063207038621
10400000800000600000200000005000707000304000000080700020200060700000006000008000001
10508036205026886280282567844550802556303048722770207286707385607875203370252446601
10303040002000600080800000000000203000006000500040400070008000603000300040005000401
10508640303520505020207085527287208030827426504020548050463040736060207063742020601
10500000306000306000606000000000200020400000007080005060000030006050805000800060701
10544566378075802277702843584250203070304544288478303038478777506660206230804546601
10000000006060008000008000300080208030800060000000008000003000400000208000500000701
10886785705470452062447080607880802360434040304774366332307030747887527080646880301
10700000804000700050006050300080400030002000607000000080400060500000000040006000701
10405070508067303830602550608020244053304037752026644020307270504032722020305064801
10005070507000003000700000303000500080803000300040000080700030004000006030607000701
16227560603633777040558885204483504360605830602860648880884658246267806083808020601
10000040503000000060400000304080002000500030800060000020800000800080005040004070001
10265080806030326420306350808060276034232075703080847070304350703050333480406065761
10007060603070002080003000500070000050006000705040703000305060007070200000707000001
10808660304040202030526026653656626420807750853080806066606033443050303433505738201
10500000606070702030006070000000000000200060000040006000303000003020204000007000301
10778442802020305040202070402744633432244078766024428750307852808034805046747040701
10008000002060200070404000700000000060006000008030006000708000002000006000007070301
13555052768030746530207086677585464050702265706060444070307023687043254068305040201
10000040000070400080706000004000800060200030602050000070400060006000005000500030401
10467350305860528050204384607040807680205050705655273720738230305627508336385265601
10700000200070000040600000807070700000602000603000000040200030700000400020007000001
10407048586083756870466330687020607667502652305030667030307050424580502080505052821
10002000605050000080004040008060800050005000200050200080303030004000407000804000001
10448470804030402030507080402680582070557040375550708322403036466077803084606250701
10003030002000206040800050700000200070000080800020700000008000700020002000700020601
10503050827557404083256664304067564260763280407020372277753620302626458060464057801
10504070004000308000000000606000200080500000605050000000000080007000003040004000801
10205067442040708486522850203325302048808486303050827884667027858863802580508630201
10708000005030306000000000200050004000402000708070300060004000800000200080500030401
18507656308057803088787372473060305530868050303038305030502740606880303070873070701
10004000006000007000700000300020300040005050008000806000400060602000504080600080401
10326033204546802330508740668720576085605073528850808027647630502077223042504770601
10003000800000400060700050007000802080002000500060207000200000808000003080002000701
10204250608860768540383028603030808030503380708050402540706456808044306020733077601
10200000600060300070002000300030800050804000807000506000704000808000204070008000701
10685884864820703066605060267420222820608038702052607653502080805434504033666450301
10000030000020203030006080300070005000402030002000600000002030007000007000000000501
18738020847056808024323440702036608063547020786878544426226080274085528456434585301
10000060004000005000000000307000003000000070000000000000000060003000000000000000001
11111111111111111111111111111111111111111111111111111111111111111111111111111111111
