11111111111111111111111111111111111111111111111111111111111111111111111111111111111
10600000000070000000600000007000000000200000006000005000000030000000000060000000001
10407035832020283074705026208723502330808034508026603346603022436050678070348665201
10003000002040700030004000600000008000606000700060300000005000000040002000300000601
10635674204072508550302640408437447767307240504280705637354433673822603843206075201
10000020305000800000700070202000007000004000404000300000000060000000704000204050001
10386020505720535736706570703060405048644044678036242077576020507650602050205030541
10008000200070000000805000808040800020002000000080006000007000405000300040005080001
10202575244043245560326035283030565740703854582578504060704832748060542057257074701
10500000005000000030006000700040000080600000000000608040300080000080004070000070001
10855243405473473044508230406563734070407065484860307024232080823864603040728650601
10000000700000006000200000600070003000603000800060506000002030002030003070004000201
10406380204827504240822537845040658470308238405050405076807034808080388065403076501
10600040400000703060000000000050000040800000406050505000706020003000300050008080501
10886780877867606080887576568624574060867420307070606340404050445772505060445020201
10002000300020004040000040007000000060000080206000400020805080300030004020200050001
12507035302080203040542020758030524574854060503725742040706020454080323380607837581
10503000603000507060004000600030000050000080300000000030405030005000500000806000001
10404070503435767053602627503052786570704820625824845872202058204256305038208060801
10008020400000007050400000808080005000200040600000700000006020005000806000500030201
10407050424033308080686450505020703037267080506850202443887020206030507040502384201
10505020008000300070000000302040500020000040400020003000800080506070803050504000201
10742023408220686526268877705220847644762720724025306060607650502050205350348070401
10005030002000700000000000500060000000500000205000402080804000207020300040200050001
10403030766877308533447460852085605830606855702040448020877066446046325080408276241
10805020000000507000000040002000400020800000006020700040000070007000000040204020001
10506066542370206070677082606760386060824256825580406773255870802770488650208080601
10204050000030005030002040500000300030600000005000700000000000600050000040402000801
16207080748074826030407050205776408320807078503068622246667864776040566060308355301
10007000603000005040707030300000700050004000803000000000000070002060005020700040001
10644365207050405050702020303278702062584380508736207464827070703034205080804020501
10000000003050700060307070405000704030008000600000600060002030800050002030203000801
10662854857020777550604030323020208040248043842860807050507040803840684030863543851
10000000700040002000504060005020704020000050008000807000804050703060006070000000001
13484438306052608053607060705430702060758680206035233437408060604025723073635572401
10000020005070003000703040605000705020005000706000007060003020606070000050000000401
10263030578320378820803044705028628034764034502576208030783060507050553850638430501
10004000400000200030204020007020000070003000700060004000800070505070000000600000401
10804677873366602070603050563040278430808440868650235374804550304080434246703862301
10800000000000302000202000200060000070600020000070007000007000600050006000408000001
10835382748860602724306463608258308050236062643030744040887080832482823027706027451
10200000300000300000400000006000804000206000000030600060700030300000004000004000001
10807037207072587480862566435360807326405058222440707483707376405785606760242483201
10308040005000800040200000000000203000007000700070600080004000608000300050007000801
10808750202330707080206084844443603080482346804020855040364070358040406054668040601
10700000203000502000208000000000700030700000004080004050000060002070207000200020701
10543343343032804352208356443660308020603735446836607073356478504350504450505348401
10000000005020007000007000300040204060200030000000008000004000400000306000500000401
10428246506560437063475060505720604580635080306685344328203080853862577030247450701
10300000205000400040003020500030500060008000806000000060500030500000000030008000501
10603030203078402460507840805060552036202074277046885080504440705078866060503082501
10008040705000004000300000404000600050503000500030000070300070002000005060704000401
16885470208554425030487736603353308870203340306540727370226432775868203063603070801
10000080608000000050500000806040003000300070700020000040400000600070002050008080001
10736040803060622480408840507050828048552056602060568020402330606060573840503026261
10008050304050004020004000800050000080003000507060403000205070007050300000507000001
10508740203040405070528048862274624520705820424030204048202058643040805552808363601
10500000507050406070004050000000000000600040000060008000807000002080805000008000801
10234424307050206060807030404386824226464036876028787320403746204044204033558060701
10005000002030600060304000800000000030007000006020008000402000006000003000007050401
18263066634050332520206063267678477020704552802060223020408077688048628068605050701
10000020000020200070206000005000500050300030302020000030600060003000003000500030301
10687360803860723070404222303040808730208030502684624420867350308665608354872848301
10700000300030000070800000206030400000807000802000000030400040200000200020006000001
10707082445022563550764450442020606576604767208030826050703040622430203050604085251
10008000608060000030005020005060400050008000800030300030308030007000802000707000001
10225740807060403050405050506840346020388080645550702845808063487054806022208260801
10003040003000402070500080500000500020000070200050300000002000400040008000800020701
10607050343833204074255887404056346840682450603040685427456830306535247050338057701
10206030008000206000000000405000200030600000707040000000000050004000007020004000501
10508045483020605834462830405488503073802665608040833343338037857665603630704860701
10702000002060704000000000200060003000606000606040700080003000700000600050700070201
18706434208066202045252846562030206870674020607028508080606880503750508030576040401
10002000004000004000500000500020200030007070007000506000700020402000406070600030301
10546046307842505730203440227870786057803026534580607034543730603038353077708840801
10003000400000500040200040007000604050003000600060307000800000603000004050004000201
10502250204570264650433082605070202040603860508070707470303225405022806070285053701
10500000400030200070004000300040200030402000207000308000702000405000606030002000701
10363822863850507027505040553580824280606053703068504525307050703452803058578540601
10000080000070702060007050500060006000705060006000700000008020004000003000000000401
14566020535057803028486760407085305065436050366833843642742070444053326354378834501
10000080004000004000000000606000008000000050000000000000000030008000000000000000001
11111111111111111111111111111111111111111111111111111111111111111111111111111111111
