11111111111111111111111111111111111111111111111111111111111111111111111111111111111
10700000000060000000400000003000000000500000006000005000000020000000000060000000001
10605062282060446044508025708273803840208048407074706825302043447050244050753765501
10004000002080700080006000800000008000806000700020800000002000000060007000400000301
10568242305042808870505870707663465258806760708480604723286738468558803824206038701
10000040305000200000300080406000003000007000203000300000000070000000803000408070001
10566050303220234356604830307020707037732058778085863033752070308780407030602050681
10008000400080000000602000206040300060003000000040006000007000203000200020006030001
10607533567065275550528072524050224320503727474553305050305462668020845047476055501
10500000006000000040002000600070000050300000000000303050800050000050005080000030001
10452526403366682076408230804882883020804058427220402072754070377624408020363230601
10000000500000002000300000200030005000204000400050208000007080007060004040004000201
10508870406684403450467882634080542380703375205080207024808028605020378023407032401
10700020400000805050000000000060000060600000705080603000408050002000800060004040501
10778630327277602050738462384352468050285230404020506360308070238527508050283040601
10005000200030004030000070003000000060000080503000700040803080200050008060700070001
14202048502030406070762030586050846667522070607256767040406060774060625650207846251
10806000204000705030003000200060000050000040400000000050605020003000400000507000001
10602080505866757066707384308088653480208860452638382663807054202854305067702020401
10006050400000006060300000305060008000300080700000300000003020003000506000600040501
10607080538087605040647750203080606085224040502560405432376020504070505050505448701
10202040006000700060000000507030400030000050400060003000500020806070806070705000301
10257064602570823288565688508750767764558380825082503060707570204040403670425020301
10002080006000600000000000500030000000600000304000205020707000406030800070200070001
10605050847643705276826670575053405460602468508050667060366062562087635020202463751
10302070000000304000000020005000400020400000006040200030000080007000000040803070001
10504082622720706080826025806720325060444372725420507234253830607760454840307080201
10505040000060005060007030300000200040500000002000600000000000400070000040708000201
15702050344044873080406050704832703440508037606027287253264746443060646020408674701
10007000808000005020308070200000400040005000707000000000000030006030004040300080001
10828557402070308070202080508856206077664340308723708734582070503064208040306070701
10000000002020200080305020506000804060007000700000200080003080200030006030607000301
10774863563070464670302040735020403050246062868840407050204080606480726030434563231
10000000800050006000604020003080805060000080002000308000206070705020007040000000001
13522222306042702024802070307260805080445240307085223585804060403084478036824434401
10000060002060007000608080607000605070005000402000004080002060808020000070000000201
10347020274680534650607027504043745028486056707783302040262040703080537430438270501
10008000500000400060703080007060000070004000400070007000800040406080000000600000701
10202258266426208020802030656080732380805520478660474675403730304050353267307446701
10800000000000404000605000300050000080600080000080003000005000300040007000803000001
10265664532240807487302888503278205020465062272080453040245040525383587034803055381
10400000700000300000200000004000606000604000000080400080300030800000003000003000001
10202035403063532230262473576640202233502082524470703643705387303288303580674453401
10406030007000500020300000000000202000005000500040300040003000602000500080008000301
10805480303620402080204032865525304050566277508030834030575040574030404086334040401
10700000608000705000704000000000200060300000008030008080000030007080602000200070601
10754783232066707488505836354420207040702384886382407032452848208470802880706564301
10000000006060002000006000400080504060300030000000006000003000300000702000700000401
10465763204280672052253030504660308370442070303476753577706040573532833050775660201
10300000603000200030006040400070600040003000405000000060500040800000000030006000501
10307080708032805720604530607080286028306047273066343040708770308047585030605046201
10006040302000002000600000302000300030205000500040000070600070006000008030403000201
16253850705623337050355585208842407360707340403680854850735248567284407085705040201
10000020606000000080500000807070006000200020700080000020600000200040003080004020001
10347020505060836560402350402030458047445075605040628050305380705020467350807028861
10002080807080007040008000300060000080004000204080407000302050004050200000808000001
10707320504030506020226048286836556430603430723030507022608033336040706637808236701
10300000505070703070004070000000000000200040000040008000404000004050304000004000601
10485262602020606030307080602634746688663023882047323240505764502083404067554070301
10006000007040400020608000500000000030007000007070006000706000008000007000002040201
14658077528020772320303083484585472080606732204020383050408083244048754064403060401
10000070000070400020408000008000600060600030506060000040400020007000005000800030601
10655280404750525020806727702080406340602060505635664280224480707266404822346452301
10600000200070000020700000503040700000804000703000000020400080400000800070004000001
10205056676025672530327830243050802525307468802030467020805060385220208020803028281
10006000302080000020007070007020600050002000200050300080704050008000808000607000001
10363760405060207030206040307540255030545020658320308277706023733068505083404850801
10005050004000705040600050300000600060000030300040300000005000200080004000500020801
10504050358272607037464752808058253780567380604070732765526270503244885050677086301
10206050005000705000000000602000200080200000206020000000000080003000004070003000601
10408066448030706723562670307673306045808746506080225748227078555338605270402280601
10704000003070706000000000300070004000303000705030500060004000200000700030600040501
17608343306052403037446764665080603530782080304043606050606240802850604030327070201
10004000005000008000500000800030700080002020007000506000500060508000203030400060401
10253033607663608350406730277730385074604047483470405073525850202088865033606370801
10004000600000400040800070008000205050008000700060206000600000607000004050003000301
10305420806480626250684044207060402020608640307020804760705744805022704020656068701
10400000500030300040006000600020700030606000307000405000506000308000507050002000701
10864268438550708033708020643780385830406054206072805336207070304553706074563720701
10000020000040608070005020200060003000206020004000400000008060007000005000000000401
12222050453048207067436360202086606082457030578572328858258070852083284747867722601
10000080008000006000000000505000005000000050000000000000000030003000000000000000001
11111111111111111111111111111111111111111111111111111111111111111111111111111111111
