11111111111111111111111111111111111111111111111111111111111111111111111111111111111
10700000000070000000300000007000000000700000008000007000000020000000000020000000001
10607028636070525045307077803775808420707073603086303266606056773050564060223357701
10007000002060700040006000400000008000406000800060500000007000000020004000600000401
10726573503064304660205350803852257487403460207850707638764774686772507627505075601
10000080307000500000500060407000004000007000306000800000000080000000804000407060001
10848040304750267885303420206030206087683036667073882036458050408250404050507020831
10003000700040000000302000807080400070005000000060002000007000706000300070005030001
10502353255068383760425074466070545870805724344422407050502227623070645066228082201
10400000005000000080007000600070000030200000000000202030700080000020007080000060001
10286563205262758078308630306887353070303047582550704044686080526328608020238840601
10000000200000006000200000500050005000406000400040806000003050002050007080003000801
10708420303778604630424366772020887280704853705050603088802066605050537027506047801
10200080600000506030000000000060000060400000205060707000408040007000600070006040401
10577820772465807070728377423545557030225470606050408830304080682474308030438050301
10007000300050006030000080008000000060000070606000700080703070400080003030800030001
17403053805050405060783050438070577852258080207758384050504060532030746340803323381
10804000308000405030008000200020000030000050700000000070204050002000700000603000001
10403020603256734028804734308085426640806850533524564355804065502358308053408070301
10003040800000008060700000502030005000800060500000500000004020008000408000500060301
10503030226033805020578770508070302023423070403570705648286040406040405020808424501
10304030005000500070000000603070300050000030800050002000400040405060802030204000601
10557048608760233624783447802280768776637570626064508050304830508020303340462060201
10006020008000200000000000300050000000400000507000302060403000407070500080800040001
10606020524846206855823370787077706350502482307040437030343084273074524060307538341
10406050000000804000000050003000600050500000002030800030000080005000000060204080001
10408055526520203040842043207560363070667687543230804267466360708880588620503040701
10408040000070007050005040800000800040700000003000300000000000400080000020502000801
16403070757084675040302080605247404280605076606052563856535678437050856060305444801
10005000602000004030404050200000500040003000606000000000000030002040005070500080001
10386822708060803070703020503373402084822420305537208865854020503044204080502080401
10000000007080800060304040606000403030008000800000700080002030700030003020603000801
10288864425060382230303060562060304030332084744470808080808040204450454040522748231
10000000800060004000703080004060708020000040007000207000305040808020008030000000001
17636873508037407086603080305560508050236570207066358682608070802025588024646826701
10000040007060006000203030203000403080006000703000006030002050702040000020000000401
10478050223730846660407045606068358028564062602325704030464070308020544450567540801
10004000600000400050308040006050000030007000400040003000300080508080000000200000801
10708236845475608060302030634080645350803880228250626674404540208020457834306867301
10200000000000607000302000500040000060600070000030003000002000800030002000706000001
10347658478520608328607585308424304060527048433050538020327040734735748087308087851
10700000500000200000300000003000303000802000000080400060600060600000002000005000001
10802056505087752620732866663680306335206024736620808783608454606876307330522862501
10702030002000700070800000000000202000002000800050500050005000608000800070008000301
10707370205240408070305057838726804050385478505070378070223060854080203044734040801
10200000606000805000407000000000800040700000005070008080000080006040207000600050601
10373573266023602646504434378440507040306483585645206046427536404540405230702822201
10000000007070003000003000700050707080600070000000005000007000500000805000600000301
10586638404550736035723080802780404380872080408873878488707060672764538050856450301
10700000504000800040002040200030200030003000306000000080600030800000000040006000501
10208070506032608320405230307060276066305056226086474050205750203082673020803023401
10003080505000007000500000607000200040606000700050000060200030008000008080807000601
12652330605574874050745324306564403530405770604720724220867822836632803062208060301
10000050204000000050200000408080003000400060800070000050200000500070008060005050001
10837040606080476770407460802070665066487026702060838020603330203080786270403052771
10005040708060005020004000500040000060007000803020408000406040007080700000508000001
10507850708060207020448056642357338830704660227040402033808077363080402736307322801
10400000403060205050007020000000000000400030000030002000803000005070205000007000501
10475335607030704070307040405864575842633046424038624860606876308023206085222060301
10002000006060800020503000800000000040005000003020003000402000004000003000004020201
15235085442030344220602045564842477040203664207080268070307058455034452052604020401
10000050000060400080702000005000500030600020505070000020400040008000005000400050301
10825770704840248030302484407020406220207070504875466260838450702764707237687836601
10600000700020000040800000402080600000705000605000000020300040400000200050002000001
10504076634077722550758860437050505868203848702060682020504040528540607060204052281
10004000202020000040005050008020400070004000400080800080703030004000206000507000001
10524430807080505030206030507440627040283040722540702847803073446022307085606770201
10004030004000402040300080400000800020000070400040400000004000200040005000300060601
10505080475325806066825677203064468420856340407060776728563280705426665030656052701
10308060004000502000000000308000400040300000805080000000000070006000007060002000601
10406078667040508425556440406624208086206657205050847233267054687265506720304750201
10704000005030704000000000700080002000803000807070800030007000500000300070500080401
18603623204036403088873864653070804270835020408078405030503450805730805060237050501
10008000005000003000200000700040300060005060002000308000600080603000607040800050201
10226088705526305240708450757730466045502038724340406052835520305025828054207660601
10005000500000500070700080004000304070003000500060306000700000705000005040003000801
10306530802450745430372047702040405080407370803080803260506842502072806030247035801
10700000600070500030008000200050300060605000607000804000504000307000208020003000501
10384358248620202067807060875280777480702082403052402372604080202336403063656570201
10000070000070503040006060300030004000604030005000400000008030008000002000000000801
15244050823044208083573270307065303023272020284476554654437060484043784667853375301
10000050005000004000000000505000008000000070000000000000000050003000000000000000001
11111111111111111111111111111111111111111111111111111111111111111111111111111111111
