11111111111111111111111111111111111111111111111111111111111111111111111111111111111
10500000000080000000400000006000000000400000006000003000000030000000000020000000001
10703074743020666044604065204278707260204053503083504464408086234070234050454524301
10008000005080600040004000400000008000403000600080800000007000000020003000300000701
10664463805053407460307750506757885273405320507740807525774344386538408757803058301
10000070505000800000400070706000006000002000808000800000000070000000205000808060001
10738020305670474835605280505020805067435075263074642036757080707540208070203070281
10002000500040000000604000406040700080003000000060005000008000505000400050007020001
10308722245032257740868058868030478520303287673336304080808635634070834037467045301
10500000003000000050006000500040000070400000000000807030500060000030005050000060001
10248888703537768034705380404228324040408025847560602062687060273246604030723420701
10000000500000007000800000700080003000403000500060206000008050007060003030006000701
10506650206265607370835335864080386430203862504050602065203064305060552056603044701
10800080600000408080000000000030000060700000606030202000304060003000300020008070201
10656640876643507030438754473567685070624430206020404220204060476646207060578040201
10003000500030003030000080008000000020000070803000200030204080500020004070600060001
12402026706040503070537060233040747284367080306335758040608040485060458430704532561
10707000807000702040004000800030000050000030500000000080703080005000800000606000001
10504050804444653088403346408085752630707730784245462463602047705653706073707020601
10005070800000007070200000302020007000500050500000700000006080004000708000700030301
10705020388023402060765480504060303078543050203470503476333060802060806030504343201
10203050002000300070000000202060700040000070400030002000800080707050202060806000401
10254025503620448367248426402280245665824350273076706080304630802060204380262080701
10005040006000400000000000700040000000600000502000507060204000804060700070600070001
10602050763473704525267540278047208420203555403040668020844028662084842060504542421
10208060000000208000000020008000700030500000006070700070000040008000000020606080001
10508073388580207040752032802570557040876724752520606424436460806470623720807020401
10507050000040002030003050200000200060700000004000600000000000700020000050304000301
13602020747047777080702040607367307660304088604077658848286322228050526020604667401
10008000807000002030505080500000200050008000806000000000000070006060006040600030001
10488386503050606030408080506355807038236370808555207286756030204086407080202070701
10000000005050800020708040302000807050007000700000600040005060600080007050502000201
10468767754030752720705060254070404050562054823250404080206050404570767070258682581
10000000800040003000807050005020807040000060004000702000702030404040005060000000001
12362842805078507053206060707630208040764670502058584765708050203058847076335452501
10000080004030004000606060507000306040002000508000003070007050805040000080000000601
10564050467830788320702033605085653057784076803822204060562020602060636320782550301
10002000200000500020702020002040000080003000600080004000300080504030000000500000701
10306235834453805030705080385030567340604580886780436527203520502020285334406834801
10700000000000403000302000700070000050700080000050006000005000700040006000804000001
10277527566260705352806225607737604030457076755080384080826070223868637066804036831
10500000800000700000200000004000705000308000000030500080200070700000004000007000001
10502073703054442740776485586260702724505034544720806633606464305654305520454857201
10605070008000300050500000000000806000002000600060500060007000205000700060003000401
10706770508460208060703035625726704030563847708020667030566080653050302026427070401
10800000602000405000408000000000600030700000008080003050000060002070808000600050401
10347763244085407648407775776440707070708857865344505034343572707320708880607338601
10000000002050006000004000500020306050700040000000004000008000500000702000200000301
10853854806830543035442050605230806880787060202735224448803030646857323020622640401
10300000406000500020008020300050500080008000505000000060500020400000000080002000801
10204080507088806560307830808050838072603062855026346030502280204023786060206027701
10002080204000002000600000603000300080407000600030000040300080004000008060804000801
15783350607438658020534756804477605660305650605630385620666574483638407038605050501
10000060804000000050400000207040006000300020700070000040200000300020002070005030001
10776030603070842870806880605070447065555025203080376050308420403040567750203077231
10007060308060006070003000500020000070007000505020606000405030008050500000506000001
10208430504050805060586033743527782640707470562060208056303072727070807752608842701
10400000302070605040006070000000000000700060000020003000704000007030803000005000701
10335836505060802040207080203337333674228072724087887750802587602024308027735030701
10003000006080800060704000400000000070006000005040004000806000002000007000002060801
12444082534040224280707063533666523030706742307080767040504035367047455048605030201
10000020000070600020306000003000800030700040502070000030700040008000007000600020601
10258840202780366030306646506050407720802060404852545730524470403737602526384458201
10700000800050000080500000803050300000502000208000000030200040400000500030007000001
10704064553038535460557420336050605452206322502020477020403020744240405020507046421
10005000707060000030006050004060300050005000400060700020406080005000403000402000001
10228640408050505030605030403580564040648070837270604368408056332084408074408230801
10006080002000505080200080600000600080000080300030300000002000600050005000500030701
10304060868654805083634632702075324550744880407070286836287850802332746020542062201
10403040005000408000000000203000300020200000808050000000000060002000002070002000401
10306068783040605527638840407277403083308743403040844385486083782244304630605730401
10402000004050604000000000800020006000407000507050400030003000500000800080600030801
15308854808084204068348425385070504560845070307087803020608560206640606020422020201
10002000003000003000200000800050400030006040003000406000300070303000308060700040301
10238043608872202550306620422480476066507063472450607075385350405038554028706260301
10005000500000800040700070003000805070004000400050706000200000802000005060005000801
10805780408520358470528022703070404070705760404020602230504436407058806070664023301
10400000200070500030002000300040700080608000205000603000702000602000308040004000201
10522268375240405063502070434380276420604038406047606834302030307788204086223770401
10000080000020403040004050600050003000602030006000600000006080007000003000000000401
14863040827023402084428730202053206038635040877543533875525080346072253637863375701
10000070004000008000000000803000006000000060000000000000000030005000000000000000001
11111111111111111111111111111111111111111111111111111111111111111111111111111111111
