11111111111111111111111111111111111111111111111111111111111111111111111111111111111
10200000000020000000600000005000000000800000008000003000000080000000000030000000001
10203048672030455075807033803827403750605036405062303733503064558080682030753535601
10005000003070300070005000700000003000608000600030300000007000000060007000400000201
10668462808035807870204630306883546723503520407820306454225432482538302262705067401
10000060404000400000500060802000004000003000502000500000000020000000708000708070001
10628030304760862282608430207050805047584063247024333053723060502440702040304070321
10007000700050000000703000206020200040005000000080008000002000705000400050003030001
10707264663044325840625042844060536860407232558845402030402275422030765048686087401
10200000003000000050002000700070000050600000000000802050500020000020004040000050001
10357333807773854086406750402624283080402027444660204078827040744224406060887450301
10000000800000004000500000500070005000403000600030705000005040004080002070006000601
10605620807747204460664475458070367270507887503080602035407073805040666055307043501
10500080300000203040000000000080000070300000206040203000507070007000500070004040401
10857660883234207020544875438248522020265220302070406880604040662262404080745040701
10008000700030002070000030006000000050000050802000300080307080700020006050500040001
15703042605050605060477060766020338787347080203388656070806020863070846530804783871
10506000306000404050005000500040000020000050400000000080203070008000700000302000001
10807040408362453043804228706047388450704460253242738666507037404875306078604070401
10002070200000008030700000602050002000800030200000700000005020002000802000800050501
10505050353086202020582850406050603075472080704870307482758070507050704040207786701
10204070007000600070000000406080400040000050200030007000500080408050605030707000701
10266045605760462625527747603350223385228560346073803030706830304020307760552070601
10002020004000200000000000400030000000300000806000305060302000507040200040800050001
10807070882734607353628860746036402320206562302070745070778075462083756050406527331
10806030000000805000000070005000700050400000004020600030000070005000000050407050001
10804063447860306070425083302370754050533632684840702542746720803360478620804050801
10304030000050004050006020500000300040300000002000500000000000400070000070208000501
18305060336034566050304070702327407550407066704066724344863485624060334070704454701
10003000506000008040305050300000500080007000704000000000000020002080005020400040001
10852623708080702020606060208353508042387550203464506358447060502086802030706060201
10000000005070300070505020807000404080008000700000200080002040500030004040504000601
10475488474040722230304050876080405020747083425550205060303030706270622030554856581
10000000700080008000808030003040305080000050004000504000804030306040003040000000001
14233487202033403063506040802360304080543450804035565365407060707052782044277234801
10000060006050004000308040803000506020004000204000003070004030506040000070000000401
10858020887840253760803065306055447065384058504762503040282050807050588530765270801
10006000800000500050707080008020000070002000800040002000700020703060000000600000601
10707288734724404050402070463050864580406560227360776528205840704080273385208627201
10300000000000507000307000300020000070600080000040002000002000800040008000503000001
10643685772580605543607744707254302050327023475020662070763050465685828025608072381
10500000200000300000600000005000405000608000000070400040600070800000008000007000001
10507067602053837880276588875370307884502077575380507246404588803273203430848263201
10502050004000300030600000000000507000003000200030200020008000508000400040002000601
10506880504470406040604084874476602040882375803030286080246050262040306052228040301
10500000607000506000605000000000200020700000007080005070000050004050404000200060301
10658346438043503748302485432740305020505287683653507075635243307430707430704247301
10000000005050005000008000700060207060700030000000003000002000300000206000300000501
10844732406780766067272020808740703430727080804526674872608050548574676070248350701
10800000203000500040007020700030200040008000403000000050500050300000000060004000501
10404020302072303370804620608060638074303036653053724020307580303042646040308042501
10005080302000004000200000807000600040506000500060000050500040002000002020602000401
13653440503643768040672334407743402640707240302750632740267362653457504074408030201
10000030707000000050400000304020005000400080600020000060800000800020004030003050001
10352080208040728730407740607080665073878085403020465080506840508050867830702026261
10002030404040003040002000800050000020003000402040505000304020002070300000304000001
10806520206080306020453037255844556820407840462080504087604042626020608747802245801
10400000205040504070005070000000000000400080000060004000206000003060702000008000201
10883343808050804030703050702276846724453076843064473860407642403084408035835030801
10008000002040700030403000400000000070004000003050008000808000007000007000004030201
13342078426030738420806088857844377080402753606040247050205082546036726036704060201
10000080000040700040302000003000400040700070703070000080300060006000002000800040401
10248740604680675040208235208020405820607070703654328320536460702274605777737363801
10400000400050000070400000704060600000306000302000000060800040200000600050004000001
10504027882052483240554630343040402526507758703070667060703080554480304050502054341
10008000204060000060004070006030800070007000300070600020706040005000308000407000001
10887730605060507020803030806440236070434070858460704438402063544022306057503670701
10007060002000404060800060300000600030000060500080400000005000700080003000700080501
10307070673376803064574728205075377220828260704020446573327520502253642030846033601
10403050008000207000000000405000500020300000802020000000000080004000007060008000401
10503086372050205658847650805352505065707588802020654837347075388676408530502650701
10307000005040402000000000800070002000602000308060200040008000200000600050700040301
18206654608055205036527887747070504680266070408064308020704830706780803020237040401
10003000005000007000500000400020800050002050008000705000700070504000806070600040401
10653034205353206740708730426270823028704045547730505038258770306046582053502780401
10006000200000200050400060002000205030007000400020503000500000605000005070004000501
10706840606740255350222025403050303070208630208020204360604664406022706060867072801
10500000600070500060005000500060200040206000507000508000703000205000603030003000701
10676886873540605034602040432840866580303075607028805733608070602885308047644570201
10000040000020302060004030400070007000704080006000700000004070006000005000000000501
18756040742086204025788870702085708047365040745337225373346030482027476888782666501
10000040004000003000000000706000002000000060000000000000000050002000000000000000001
11111111111111111111111111111111111111111111111111111111111111111111111111111111111
