11111111111111111111111111111111111111111111111111111111111111111111111111111111111
10400000000020000000300000006000000000700000004000003000000020000000000050000000001
10308083285060258066807077703825208260308086308043307747804086552020465060885775501
10006000008020300040008000800000005000506000200020300000005000000040008000700000501
10343437408083506750302460403848387763804770407570302884484544724822803332602075201
10000050206000700000800060304000007000003000506000400000000070000000306000506030001
10744070703550563743304730207080706027658025364078755078733030502250404040803050671
10007000600060000000507000702020200060003000000020007000005000204000700060006040001
10203664655083637380565047788040632870806232426247507060605458728050645045488043701
10200000003000000050004000400030000080500000000000807020700070000060006030000060001
10335382705755385055606470803246634050406087324360405035323020232538402020858280601
10000000600000003000600000700050002000706000500080506000008040006070002070004000201
10207750604777203730625863248060224840505743703070405076607086205050687053305022401
10200020600000707030000000000030000080300000808040803000302070008000200070004030801
10653650885253706070664824775285643020268470604070402650307060425265603070668080801
10006000600060006080000020003000000050000080207000600060304070300060003070300080001
17807062502030803030386020336070234332845040404246588050305070532080236460608278861
10707000504000507020002000500030000020000070700000000060508060003000600000408000001
10604080702645785036702672204036477470408630288864546477303058502327603084806040401
10005030500000003030300000202050007000400060200000200000008080007000807000600030201
10405060465023302040232880204070605034887040303730507342885080202020707050807822401
10606040006000800050000000302050500040000020600080005000200040607060404050505000801
10778068705870268425485357705350235655667480227074403020404550306030208420738020201
10008020005000400000000000200070000000200000407000408080407000806080800040500050001
10802060426243606758857720658085305570404438804070265080224027756077462020405766531
10607030000000604000000050002000800020700000004080300040000050008000000020804030001
10706034882250208040352044602640238070826673646320807373826630605630477760206040201
10406040000050006060002020200000700030500000003000500000000000600070000030705000301
18702070422034568030303070605643704340308036603045878288867774544040538030402282301
10005000204000004080303070600000400020005000706000000000000070004060003050600080001
10364326306080205050306080802824505066284630408472706488325050806078202070305060701
10000000008070400040806080803000306060002000200000400060007030500080003050407000701
10568548767060776280704050332030703040262076446460806030408020604650432070555382621
10000000500050008000306080002070706080000030008000503000403030802080004040000000001
13423337405085207063505080402760506020487680705034864373308070406026778047586462501
10000070004060005000608040303000608040005000507000006020008020704060000080000000701
10532050878770355270407086705054487045782033207262405060848070406060568860744640501
10008000700000600020404030002030000070008000400030008000700070805030000000500000301
10403276327447805020608080485080285730805740425550253664708240602080473272806235501
10400000000000402000302000800040000070300020000030004000005000700020002000507000001
10746265834240704636604224508826703040226072674070247070822020268288675045406034621
10200000700000200000600000007000202000403000000060700050400020700000008000005000001
10802044608083556460658765838270505636406067274550802852406565304673407730482844401
10704070006000600030600000000000402000007000700030600060002000404000700030004000401
10505420808220505040608082883576506050726574506020347040244020457040407056283060301
10200000503000802000308000000000500030800000005050004020000080004050703000800060801
10626886836077407424405233444250302070807487277545506075767232506660203720708535701
10000000003080007000008000300070507060800060000000002000007000600000802000500000701
10444784308570856045864030507570508650645050505775377354404070658565547060724680401
10400000307000500050002050600040800050007000206000000050400080500000000040004000401
10805050703047305870605340205070733052402068873028863030408450302045264070605025601
10004050803000005000700000507000400080708000200030000080300060006000004050806000201
12768750204333243020747474507455704830807380702330282380228347284827304086607080401
10000020507000000030400000706080002000800030700020000030700000600040004040005050001
10437080806030228830307640708040553046847033806020265070704420304070628470407026281
10005070807050008030005000600060000070007000608030707000808080008020700000606000001
10702750603050305080755066383268886220405220466030408076206083852020202357708665301
10800000806050708070005020000000000000800070000070005000307000004070606000003000801
10757356808020405060405030805456232534867087472077538360202442604035808086776060301
10002000008040500030605000300000000020003000008020003000505000004000008000008080401
12327052676020825250303058442276253080505437305070657080603028823057854077606040201
10000060000050600050305000008000200020300080804030000060400060008000008000600050601
10475580204850568070702477707070702440507080603866873820243270606446506556477874201
10400000700030000050200000806080700000408000408000000030600020400000300070003000001
10403048832065454240384240384020502877708845508040228080703030645560702080407087361
10005000802020000050006060002040800060007000700030800030802080005000607000206000001
10555240308060604050302080506340682080484020852460802342606088368062307025707570301
10004020002000502020500040300000400050000030300030300000007000700080008000400070201
10208020426428506086468654803054786220823830603080782826846640202763644020378068501
10707020003000405000000000602000600070600000804040000000000060004000004050005000701
10207072547040202734836430308252706073803776603020548452225073787622504270405430601
10405000004060402000000000200080008000802000403050300060006000600000700020500040701
16407876408052806034376746273050804430324020407032302030305570708330604040538070701
10002000003000002000500000400060400060007020007000404000600030307000305040800040801
10758055304885303450405250677280654033202085867730205042435840608084344062708730501
10005000500000300030800060004000708080004000500060602000600000505000007050007000801
10302730608220647720486088308020707060603560406070406620707585302044708070788084701
10700000400040800030005000300060200070504000707000306000203000307000505070002000401
10727438255760806066205080584460888720204087402075806256303020205776708047328670501
10000070000080607060006080700020007000703050003000700000003050003000005000000000201
17887030754052806088478550704087602052642060265862548863663040382047485822845653401
10000070006000002000000000204000006000000040000000000000000080004000000000000000001
11111111111111111111111111111111111111111111111111111111111111111111111111111111111
