11111111111111111111111111111111111111111111111111111111111111111111111111111111111
10400000000080000000300000006000000000500000006000002000000040000000000060000000001
10303043232050823078608042807224805470302062407026406268404035726060758080264658601
10008000003030300080003000800000008000507000200050800000002000000080006000300000201
10254544507028603330703780807745433357504470805280604522375632826875304786303038401
10000030303000800000500050607000007000002000403000200000000080000000505000706040001
10738070208240655575804620705020607083656077243082433056523020202820703070208070621
10004000500050000000603000707030400060003000000050004000006000406000200030008020001
10203754632028578540484076488030783570206864526467602080308745262050625025552083701
10700000002000000040004000300030000070200000000000704040700040000030005020000080001
10765376403552435023604850807252688050803043562320508072776030454764508030546270401
10000000500000005000300000300040006000402000700040805000002020004020002080002000401
10605760308878604830563828548030252330707837606020308024502068507080745035205035301
10400050200000208030000000000050000060600000306030506000403020004000500070004030201
10244430273856408030837524837452578070486420606020508380704020428885706060326030501
10006000400070002020000050004000000020000050804000300080207050400040008050500080001
14302064608030308060788020856080234324675070304233885040305040252020478670306462521
10806000507000606040004000600060000050000070800000000040808050006000800000205000001
10607030405326456058702554705057664520308580375373584745807072804342703056305080401
10003030500000002050400000202070004000400080400000800000004080005000606000300080401
10807050548056504070525580205020803046673030505580505552456080705080603020604278301
10507030004000800070000000607020400070000050700030008000300060203060502060705000701
10432036804850735433247473208770636456332320866037606020505340802030704620375020801
10004030002000200000000000800080000000500000707000507040804000504060600020400040001
10403020677333503226525340728073404440408554708070353050343084784088435020204456381
10503060000000202000000080003000800050700000003070800050000080007000000040706030001
10308062755660207070358088703330776020266384463850305544655220506840668840806070501
10202070000070003080005050700000600080500000008000200000000000400050000080506000301
12506020836086766070403020707362205830306027605057233568678837766040483060605644201
10006000206000002040306080200000700020007000805000000000000020008030008080200020001
10777356602020803060606020703556802037762820805863806283624070606058303070802050701
10000000003060800080702030308000306040002000300000300020005070200040007060205000501
10778862762040236750605080548040607050475035688520302050405060203760733060843257841
10000000700040005000703050007060204020000080004000502000708050608080008020000000001
15668582803075605023502020506780603030873440306087268247602040705066483068522287801
10000020003040003000605040804000708060008000605000005070005040808050000020000000301
10823030784280887740707047502084738057777026605228406050885070307050663550527880401
10002000200000600030408030007040000020006000400030007000600040503060000000400000601
10807425566772308060506030838020247850208450637760624774808740605060467458406277401
10200000000000206000404000400070000060400040000040002000007000200060004000203000001
10675778535220703253504464505253304070478077723060468040655020265863445043403085871
10500000700000600000600000005000502000507000000070800020400050300000006000003000001
10507085403036377850367746544420202485302083454250304247207557503273705560847445301
10504020008000200040500000000000507000005000200030700040006000704000800070008000701
10604370402880706030506063238384302020728883704020336020866020623050502087557060701
10500000407000304000507000000000600070800000004020007070000020008070208000700050201
10443388388053608445604377878770804080507723836757504078577725808520408680507338501
10000000006070003000002000600080706050700080000000005000003000300000306000500000501
10557585604470645078856020504340802780667080407854288488807060745258457020652420301
10800000207000800060008060600040700070007000507000000040600040500000000020004000201
10206040208052208820404770706040348084706044365026645030702560807046272060506078401
10005020802000004000200000806000400080804000200040000040400040005000006070507000501
13477680705426384050466282607332404380305850504440524380756235684666603043403040801
10000070607000000080200000504030004000500070500070000020500000600030007040008050001
10622030202060432680408420703050683076587056806050684050508370802030572220306068271
10002070803070007070002000800050000030002000203060402000702040007070700000202000001
10806860202050203070474035273586464760704460337030602027408024844080703534505423401
10800000302070705070003020000000000000700080000030008000804000007040302000008000301
10575556207060403030502070703755446762464082344068882470802448808024808042248070401
10004000002070800030207000700000000050006000004050005000306000005000003000002070401
13786025733060825350307053732653622070405572607050334020702056833047876087606020701
10000070000080300060803000007000300080500050508040000030600060003000006000700020801
10884720303230787070802282704040807380306050807347236770662340203254402678588322401
10700000200020000040700000403020500000605000303000000070200060200000600030006000001
10508086854033482680482650845020405282805537407040625020308050227240804040503027371
10004000803070000070004070005080500050004000500050400030407050006000808000806000001
10534430206070807020805050308880625080465030874840305577202043236054703087304770501
10003060002000406080500030600000700050000080500040500000007000400060005000400030701
10704060444436406085777487206045323250662250707080887728387670208454238020656055801
10208040006000808000000000702000600050700000405080000000000080008000005080007000501
10602034846040603264536830702222308025703222506070358636436043286678505360608380501
10705000008050608000000000200050002000307000604020200040008000400000700020700060501
13804334507077408064428242883040207830326080503025703020308720808760402060228060201
10008000006000004000300000200050400040004020002000403000500080503000307020600030801
10333022403328304860307860547570877074203054445520405026855670208034537083403440301
10002000500000200080800040002000303050002000700050504000800000708000003020004000801
10305230204630745860335038302020204050305480207080608570704668403044704040738056201
10300000300030200020003000800020700080303000806000802000603000802000603030005000601
10337827782480504086405020628780636730506037703047602228206070804536603025775240201
10000050000070606060006030200050003000204080003000600000003060004000003000000000201
17224050468067506083822350802028307028672050365378426578787060873053754667682432401
10000030008000002000000000604000003000000050000000000000000070007000000000000000001
11111111111111111111111111111111111111111111111111111111111111111111111111111111111
