11111111111111111111111111111111111111111111111111111111111111111111111111111111111
10600000000070000000800000006000000000200000005000003000000040000000000020000000001
10704046283080233036507028706586306520205084504068302368806063455050766050835564401
10004000005080400050008000200000006000302000300070700000007000000070008000200000301
10734648408067807360404480702387456384208750708460204387578778435785405287206067601
10000080704000500000500030803000003000007000508000400000000020000000203000702060001
10884020402380585527805860405040708046237088623065858046528050208550204070508050551
10005000300030000000305000303080300020002000000050003000002000304000200020003070001
10305458836072873620443073266040377650607382684743705080608525278060646078762047601
10600000002000000040002000300080000050700000000000606050400020000060006080000060001
10334764402425744083802620707574774060203083453750303027336020386558404050457840601
10000000200000005000400000400080003000403000300070206000004050007080008060004000501
10806780804883704320688523355080536260505568308060802054804085606050855087504053501
10500070800000707050000000000060000030300000405040505000704070006000800040005070801
10643720634265307030783323285536386050286360406070603350307050236738307040744030501
10002000300070005020000030002000000080000060206000300020208020700070007040400060001
13704025607060508070655020433060683254856030705233358040304080343030366340806625771
10606000407000507080007000800080000050000070600000000060508070005000400000202000001
10506060304528336075506346403082654530507550764246745532807087208265307064404040701
10008020400000007080700000705070004000600040300000600000008020005000804000500020301
10708040584063508080844770703060608056588070608830303786222070808030404020707728601
10602040007000700070000000408070200070000040300030002000400030407080408020408000201
10442083503820328488458384603250562653643260653058407040605450306070506530475070701
10003030003000300000000000300060000000800000405000608030608000803070300040500020001
10807060485465507745533440438046804230607747404070786040358044227042476080805537741
10606050000000604000000060005000700050800000004030800070000080006000000020803070001
10306066355850504050822087804520734040456383465640702652525220804260757830703030201
10207040000030004040004060500000500040400000007000800000000000500060000080402000201
12303080338052253030703020807282207740407077304035826884657585846080544050402855501
10004000306000005040703070200000700060003000208000000000000070006060007050600050001
10327478504020208030805050805887202044637880708336605652733070207036507080208030701
10000000005060700020408060203000608070004000300000500050006060200060002050203000701
10256857472030426230303050256060706050225035443430204040502080706840225040443276261
10000000600070005000308060003050506030000060006000307000205040404060006080000000001
16278275403035403028404080606880202070575350807075684424802040306086484067854338301
10000040002040006000805020704000808060005000405000006060004030608070000080000000401
10556080256620354280607057507088264073472076205823803040367070706040555750423420701
10004000800000300050302040004040000030005000800030007000300020206070000000300000201
10302873236866802040705020732070537660802520534740424257807330504040626324503226501
10800000000000305000802000300050000070500070000080004000005000500080007000204000001
10636273448830302736202535702286203070524066767040734030663070342452673083704036771
10700000500000200000800000006000806000706000000030700070600060600000005000003000001
10305065803068524440764247565650207366706067728320308346304428403237304450726388301
10805020004000200020300000000000607000008000400050700040005000505000400060005000201
10406370304640704020804058537878606020425376705060852080856060367060608073336050701
10500000307000208000706000000000200040700000002060005030000050007080707000700020801
10778654458073505664605438323330408050405546685335206087535537204380804540503568301
10000000002020007000005000300060502050200070000000002000004000500000604000600000701
10656444303750733083225030404840503770437060608678472334802020472542542070346240601
10700000305000800070003060600040800050005000704000000070600020700000000020003000501
10503040502085505340502580208020842056502068368052767040307860608066653020707042401
10002050307000004000400000602000400020507000200050000030600020008000006060802000501
12226360407482535070523532507248702340308480207230366320435883844322406048202060501
10000060708000000020400000602020008000600060800030000080200000700060006030007050001
10873060202040835820605220508070645046647038502070274060302670804060623230506084841
10006020408020007040007000800030000080007000303050606000503050007020800000302000001
10507780304060805060652073437682473720703230777030608033208086464030803877804243801
10500000502050708050008030000000000000300070000050004000505000005040303000003000701
10765237202020707020202040302564362868577083844027864860706372202022305077438070601
10006000004050700080504000800000000080008000004030008000808000002000006000006050601
17845026565040662560608065736627575020408784704030273080306024887074526062205030701
10000080000030700060707000003000300050600080307050000070200030002000005000200080801
10865650606770856030508324206050705530805050607762673570535840507783408277323327701
10800000200070000020300000705060200000606000506000000080600060300000200070002000001
10708056574043375570464770734040805444508625406060736080505030856660304060807024851
10004000304080000080004050008020300080008000500030400050508060005000402000406000001
10352570503060207050305080704630572040834050367720205345503026236066402087708570201
10007030004000703040200060800000400020000060700080400000003000200080002000500050501
10808060774465707066232565803034363640858760704080825658476540402444478040853052201
10803050008000402000000000804000200080200000208020000000000060007000007080008000501
10508082538080504586567240802873306054402638403060672266572085558843704860504480401
10603000007030302000000000400070002000603000408040500040002000200000800050200070201
18807546407033606036542724743070807270346080206072602030404560506250804040383020401
10003000002000006000500000700040200070008070005000506000200030608000506020300030401
10866054602667605560202430564640636055206026855470405073237240804064586037705560601
10003000200000500030400060004000605070002000600080505000300000208000006060003000701
10305230407760448260334036205020305060703660808080502460807326207038404030825027601
10800000700040600060003000700060200080305000707000406000308000203000804060005000301
10287678745540606053407020748830878670207062803046208637708060306348405026263240801
10000030000050602040004040600020005000506070008000400000005030004000004000000000801
14434030882038808065634720303034604062623020546486586526384030426043258455625667701
10000070006000005000000000702000004000000020000000000000000060002000000000000000001
11111111111111111111111111111111111111111111111111111111111111111111111111111111111
