11111111111111111111111111111111111111111111111111111111111111111111111111111111111
10000000000000600060000000000000005000000000700000000000700080000000000070000000001
15307366222520208023307045407850833044307540504352744240803030277278775080332658501
10007000300000506000302000600070004000800050007000000050005000600000008050000030001
10808040307764456850802060305087305680208068727040338046776348302033263030247060581
10200030200000000070604070506000600040406000008040004000800000007000200030300080001
10557270803267264060806050378260472080566320604022302430305776463520805322703672301
10300000800000004000206020200040008070000080302050006000200070000050500000007000501
10205758628433607242404070404040734073788070202053547080262050327020476464478750301
10708000800000607000004030205030300060000060406000002040500020004060000000500030301
10705050304340685020425460502040606560307520307435408088306028208083773280505040601
10500040007060000040002000803030507000300050700000008000006080003000400030003000701
10883687328070345045807064406030204028705050424527565227605540202540805057787067301
10000000000060008000204060003040608000703020500040002000603000708000807060003000801
10376486333068502530704073343028808670605030406020407080575075406087404088805660401
10000060008000508000307000007000300000502080005000600040007020005000002000003050601
10554020606755406087802425707680843857602065772372787668807035838643608523733050601
10006030600000002060002000600000400000803000000000600000003000000000300000008000801
10605020634788876040582030466642806080487525374340303532854338878470508522603034401
10507080300000006060000020005000005070000000000040400000500020000080800000502050001
10208040405052605886422724306052603023764884677034753470506070805060436020507020781
10505030007000700000000030407000207000000000005000000020004000405080008040404070001
10608072588720542384588020406730507422674325603438825050335433748073504040507840301
10804000003000407000007030600070500000000000600000803020400040005000008070800050201
10508046607032205057803040587020506426372320702840407068302030204334383020746038801
10802030008000007080407040005000800000002000400030703030002050600070000040003020001
13206330675450552030404078303038588832404045832520505030604077346060765827868020531
10004000300020007050203000008000800000706080300000803000302000002070800000000040001
10828066304025525080207267364440205320605070404755708082304473708084403067223045301
10705000404000005080207000300060202000704000208000005000503000400030007020004060001
10507050602858405050804060505043405083606455405030487450205870778480475560206850301
10006060004000700080005040005000008000300020800050000070800000308000400000708000301
13573047736070765736763074442786383470826080443438802040554838505082504063606084851
10000050000060000000005000006000000020400060000000406030600000003000203000407080001
10345540205073646273808578807074578040205076757250604070704575646570503320203038501
10000030402020000000300000500030004020007000600070304060004000000050002020806000801
10346050203350303330308470326630705070722435503070405055554020802070457040502680501
10202000300000406070700030000000505020004000505060604020000040206030003000205050001
10802036225375803040334477832662806033342050252060826020506280526032463235404030801
10008000002000008030000000000000205000000070000030006000400030003060000040003020501
10382860302074438070726550473780306856872735764036403557256020806030364030666060661
10200020802000500030600020006000500000400080003030008000006040505040002000500060001
10203056402330508080207033255083225760303040408880224024736040706048805535504472501
10008020007000503050606000300080007000304040700050300060000040507000500000008000301
12277080566043306070605760703773804057305080707020708730348370208620605476256860201
10003030005000807040500060007000803000007000707000400000400040500050704000000020201
10303064302640608380265054565040402052464754607057684486602020422020627035648040801
10608000200070007000707000000050005000000000705050003000008060004040002060008000201
10807250504077453085207072872468236577384660204450804070536528207024208070705074601
10607000605000007070006000003000000000000040200050600020800000802000800070605020001
10536023404032607080506870506086854225572060738070383846602860243260528327803530301
10600050007040602000300030707000700000007020005000500000700080008000500000007000301
10607364308080707560425060708250507445608022704664606030804058803080307667258080501
10804000808000600080003050400000305040002080400000003080608000800030400050008030201
10703040726072785030402080364324304050264030542086564880502770443020437060803040601
10007040006000004030402070000000403000400060007000004000800020003050606000700060801
10204035803722346050403020667648502785708365807037234065637025404020507042265230301
10306000800040000050508020008000200030007000003080000050008000502060006000000060601
10826020733060406260206033534070364040534030467620223760704248408077588768777460801
10007060202000400030304000006060000060002030008000600000500070004000600000000060401
18606080202678475070507243305022463735204080608025206688833040305480702657803070801
10805050008000800050200040008000005000800060707030007000808000700050300000203000801
10202087476860834570805030225456406082265650506040874050806480425040667070864056301
10506080000070400000506020000050006000200030707060003060400040008060004040007000601
10702050704020705887444022254070257870303250502075608330856074707023706025705032801
10003000606000400000004000004040007000400000407000700000500070005000303000708050001
10756762207684265373502284402053202020288353403060458763206882266230506777805080751
10700000400000000000700000502000007020000070004020000000202000000000306000002070001
10703030755773872050253360807626654020624040268887562820204075322247805046384020701
10003040000000008040800050300000000050006050000070000080003060000000002000004070301
10375037668456804750302040608633702226733040484063728075275350778623357026803057401
10002000007000800030807000804000402000000050006000000070008000600000005000807000601
10405737308060253070404373847060248053537546258457837270503083807835708040406820401
10300000500060800040202000000060008000000000000000000000408060004000008060507000301
12845386447680302360403863376586402088524023202753534557408050426080483550305772801
10000060000000300070500060000040007000004000300000600000808080007050002000500080001
10483080736558506030627030784040585235808520668540705625207065656053802073757080471
10200060600000305020004060505070006000500060500080400000004000700040008040000070001
10307020302280384050284080205057605040844050734070402558622220502838465070838363201
10307080508050000070800060208000006020000020004020603080000060500000003020005000201
10608440702072286450607780706736354084883467303060506040682650208444207238808078701
10300000400050000000800000800000000040000000007000600070000000400000500000003000001
11111111111111111111111111111111111111111111111111111111111111111111111111111111111
