11111111111111111111111111111111111111111111111111111111111111111111111111111111111
10000000000000200080000000000000007000000000200000000000300060000000000030000000001
17707386463640507047606023206860844042406850405567527720203020686844536040224528301
10002000600000508000804000600020004000800020003000000030003000500000003050000050001
10708050404234633270703040307056608220807065765050765068778264805056868030446060781
10300080200000000080708030603000800060507000008060005000300000005000800030400040001
10686270307384858060705020833780824080648770702034304720807855353560206543804456401
10500000400000002000806030600030002080000060707030002000500040000020600000004000301
10302248362553508443804060307020536035457060505023836080586020727030444263636840501
10705000800000505000004050304040800080000060807000005070800070007020000000300020601
10603030406570826070648570408080302730608770604842804073606074806075885440708040601
10800080004030000050005000402030606000800070500000008000005030005000400030008000301
10348842734040237083203063308030404044706030727263242526805850508320707046787044201
10000000000030002000604030003020802000605080200040006000803000205000304050004000501
10538357667088607520802043723054305440208050305040807040857048403027404047308370401
10000060008000805000804000007000300000502060003000400040003070003000004000007060501
10236040608845208087804425602450872327506034533265248842707035773884407258568050301
10005030500000007070002000400000300000407000000000800000003000000000400000005000401
10703040728763575070288080366855803040448654544370204262654433864370206626402073801
10504020800000007080000030002000003050000000000030200000500030000080400000502080001
10606050506063405464736738602074503027858472757088228860503060608070348020703070261
10708030007000300000000030702000702000000000006000000020003000603060006020807030001
10704033655740647847734040308530702233475483605747276070225282275077607040603870801
10304000004000707000005060500020800000000000200000704020400060003000005070800060801
10807075405073305052603070255060505862687830607440504057508030702565554050885087801
10703080007000006040608040003000600000003000400040306050004030700070000080005020001
15406580242230362020708065504064276562603058338580207070402087655030327528552040871
10004000400030003070504000003000700000404050300000408000605000007020700000000060001
10842087502058265070306372233350807780205060205244308032804288407027302067563035501
10308000303000005060404000600060407000705000405000006000207000400030003080002030001
10503060608325604040306060302083703088405554304050368820508230844470764460708720501
10003070003000200060007020008000005000500070200040000070400000403000500000202000401
17567038827020225844788074572558228450744020455368807020542284408027702073603033431
10000070000040000000006000005000000080300050000000804080200000006000505000205070001
10374480506026356684207686805026747060303058433220404040705586653260305770704024501
10000060203070000000300000800070005030006000700080506060002000000050006060202000701
10726050603240404820203360244650207050582583305020202085587020304030663080602620801
10602000600000702030200060000000404070002000306020204050000080302040005000506050001
10605045687738408080374378332327503025872060583080376080807760253037785844707060601
10003000004000002080000000000000807000000080000060005000800020008030000080004070701
10472420204058374020236250235630704423625448664038203674758050205060452070553020721
10300060307000500060400060002000600000700060006030004000007080306050007000300080001
10506036604780206030807077426056528650304040206330548047575070207038808574606467301
10006070002000802070407000400070002000607060500070300060000070403000800000002000301
12483070284037705020204880704354808025504080407050705680558640308750308354232720601
10008050006000302050800020003000502000006000206000400000500050500040404000000030801
10305083304820604360453074862020406025484374603067363283705050885070736055647070701
10503000500020006000402000000070005000000000807030006000002030007050008080003000201
10204270708083356072703056466674376887584850508620707070473822606044508020506048201
10306000406000005050006000003000000000000050200040600060600000602000800020603040001
10427022607076803030807460708036664358866040748050878538307750873770563486706380201
10700020007060404000800020704000200000008030002000300000800080007000700000003000701
10504648503020502840756080205250608244706023706628304040205024304070405484748040201
10306000604000200070003040500000206020002040700000002080606000200080300050005040601
10503060243028577030205060836857202060328030343082432360303460328040375020402070401
10005030004000003040704030000000504000600060005000007000400050004050507000600040301
10803044808457742080608020264732808322806562703074538057847023303050505023845440601
10608000300080000060807060002000800040008000005060000040008000608040007000000050401
10434070277040303550208047836020865040388020677440668840308873407037448232364360401
10005050503000600030504000004070000060006080002000700000400070008000600000000020401
12203060304633424030303354504022578354504030402048802552373070307830607833703080301
10306070008000800080300050002000007000300070702070004000603000600070800000403000201
10503066865770382330407080876784605035525840607040823070603520677030827040772087401
10504040000060400000802030000060008000600070603020003020600040004030003060007000201
10708060203050308385232078535030778420503380402028503770357026205076406037307048601
10004000305000200000005000007040006000700000707000200000200060008000302000707020001
10378682303345436337806672805088405020876653404060872227402842764460305832308050521
10400000200000000000600000304000006080000060006080000000802000000000708000002040001
10208040284384285050453430204542866060828070568542573850408088255282705074325040501
10006060000000004050800030400000000070008060000070000060005050000000008000007070301
10586036768278304220802040803686702842372080556023235058546870547878785026308056501
10005000006000700040607000305000507000000050006000000030004000400000004000706000401
10406482406070244030302248437050284082482638445447688560806056205342707080608530701
10400000400070700040305000000070008000000000000000000000406060008000007070607000501
16535853442440802640704743245733704028436056504326775843208080775080643650405257401
10000080000000200020200070000040003000005000400000600000802070004050005000700050001
10525030875277608060437040633080356533202880426270308487407068635083402085826080251
10600050800000305030003020308020005000200070800020600000005000200070005050000030001
10706030806580226050423040303062706070384020244030206255238770505856686030246345201
10605050208080000050200050508000008030000070006080604030000070600000005030004000501
10207320508064775730705550503538463065247232205080302040558760306568706276202054601
10800000400080000000800000300000000070000000004000800060000000500000500000004000001
11111111111111111111111111111111111111111111111111111111111111111111111111111111111
