11111111111111111111111111111111111111111111111111111111111111111111111111111111111
10000000000000500080000000000000005000000000600000000000600080000000000020000000001
18507288234780606033308056402560574032505360608377628540705070666244323050437488701
10008000300000406000808000500050006000600060004000000020006000800000003040000060001
10203030302548682260406040807065506420606027562020663083373354407077328020553060371
10800020800000000040605020803000400040708000006070006000500000003000800060200080001
10373460606583827040405070322380385060266460404066404420404353253650405825403527501
10300000300000005000405040300030008060000030606060008000500060000040400000004000401
10508872724322706745403050605080476048665050605023876050845020378030443764557380401
10207000300000604000003070406060600060000060505000004050700060005020000000600070301
10405020303580437030362430708060508420402720208887506026603042202077657870603020201
10300070004060000050006000305030506000500020300000006000003040008000200080004000601
10354545585060546026808055303060502078205020865237332664806750706570208062563056601
10000000000040006000508040008060203000403060500040003000708000403000507030002000301
10643653586077607520202084853028708530804020305060203020876054406026702072305420301
10000060004000805000806000002000600000302060003000500020006020006000006000005030601
10754040508364602052305857207820644686307083475862222554503084832748603234685070801
10008040600000007030008000300000300000206000000000200000004000000000200000007000801
10503030836386746030423060278885504050888743837470805432778476488660302678703087601
10403020200000003060000050007000008050000000000050300000600080000040600000804080001
10207020508062403744227667404035802023833345848088488430204070408060887020807080631
10203040007000700000000060804000308000000000008000000080007000204060006040507070001
10203083753470373384722070402870307445468427707335835080428473586062408080608680401
10402000005000303000004060400020600000000000500000706050800040002000006080700040601
10806055307023403023203020253060504845867240506330706058403050405766284040577083601
10802050007000007040702020003000600000002000200060506040008050300050000040006020001
13808220373730452050406025207052837636705067653380508070606085386040328424272080271
10005000500060006050507000007000200000803040500000703000702000004020700000000070001
10843023404027875050506455625830502280705070508573802086606355605053607067335077301
10707000603000006030605000400050806000805000602000007000207000200070002080003080001
10502050403586702070702050407067604063408336308020567650406860624340384760204230201
10008040008000200040007020004000003000600020700030000020200000502000200000403000601
16656045567040542374372053846332585380285040265822703050247546604048704068502073321
10000020000020000000004000006000000020300050000000206030200000007000804000205040001
10575280406064738374603234406077446050708078288880504070208288363580804880408084301
10000070308020000000400000300080003020003000500030502020008000000070003070803000701
10476020702830607550508240444420608070755786503020307067382080602040725080302270301
10206000300000704020700050000000603060002000308080504070000080707080004000804020001
10603085366385802020655835365823204086374050386050766050802450828038275448403020301
10003000005000008080000000000000207000000040000070006000600040004030000080002040401
10627340608066438080645630334470305532762667557062506634772030706020345060448070771
10500050207000300070600060006000200000300020008070002000004060402060007000600060001
10204026306860504040803028638055787680307020608870534047683050803034302827605362601
10006030002000606080703000500040002000504020800020400030000050606000600000004000401
18225050788066206080703460406883605042506040708020604470377750706520803674653580801
10003040008000805050300050003000306000003000602000600000800060500020402000000020801
10807085708720603630353087722040605028757348402028333735207040588050638053773020201
10806000600020007000703000000040006000000000308070008000002040002020006080007000201
10606270704075248022408056628633887668345730303280305020787238204078702020405035401
10304000604000007060004000003000000000000070200080400020700000505000800030303070001
10587065607085705060608760304047475627628050757030577863305460447620547823603730501
10300060002080402000800050707000600000005080002000400000400060004000800000006000501
10604284705030402650668030806870403777308026408228207070203086807080202465362030801
10306000503000400060005080200000704020002030700000003060307000400080400080004030701
10803020838046666080808060265735708040438020532076662460608650352020633020802040601
10003040007000008040202060000000807000800080008000007000600040003080605000600030301
10802056702456862050702040724653402432503828305035788027227078607050603055347380701
10806000200040000040503030003000700030004000006070000070007000808040007000000030401
10866030226020704330504046348020382070625050648340884350205732308044323776576580601
10002080504000700070502000004040000070002040008000600000300030007000700000000020301
17302050508478348030308366308087422322407070205036302484267080203670508566304020201
10705080002000200050300020007000004000500060407030003000405000200020500000805000701
10308078336550366270202020842347503048564650507050567040808260526040735070582084801
10403070000040400000604030000080006000700080403060008030500050006030003020003000201
10507050803050508852684064578080323760805270803028803280552032803038602077303084301
10003000707000400000004000007070007000300000606000600000500050003000802000808070001
10222524506244426367406388803035806040723867304030762332207225424220205625304040531
10300000200000000000200000403000003020000070008080000000708000000000504000008040001
10304060857683454060886750604835427050736070273245855580503038756258305026534060401
10003060000000005080200080500000000030004060000030000040002030000000003000008080801
10435034546453603360707070607368803348865070623073742072285820532448554044806042601
10007000004000400080207000407000206000000030008000000030005000300000006000602000201
10208642802020353050607674835070748024582677728533342520207088206276703020804350801
10600000800060200060407000000080008000000000000000000000306050007000006020305000601
17866344434550507420602224365877603046378052302642762744208020268070628620408684801
10000060000000400080700080000080004000002000500000200000404040004060006000300060001
10842040443783703060347030722060333673506350853830802682203073632046802067527040421
10300040600000507030003060805040003000400040800020500000005000600030006060000040001
10802050302320724040227030602054202060342050272060302228447380704562357080458442401
10708080308080000080500040802000007020000070002020703080000060200000006020008000601
10808750707027643570604340303423345025654226202020404080538270707587205354208084501
10500000600040000000500000300000000040000000003000500060000000300000300000006000001
11111111111111111111111111111111111111111111111111111111111111111111111111111111111
