11111111111111111111111111111111111111111111111111111111111111111111111111111111111
10000000000000300080000000000000006000000000400000000000400020000000000080000000001
17508622555540706087406048606680734056305520407465354260705080282385227080578847801
10005000600000503000606000400020007000200050005000000080006000600000007020000070001
10607040203385577560606050507087608770408055825050377038442388305046684040748030781
10800020500000000080808040302000500020506000005050002000500000006000800070200070001
10367750808472786020202050872480574030865650508075604880802726583330206252803864701
10800000800000003000302060200080005080000030205060008000600050000080600000004000201
10706658457574503573404070505030862067557020607048723050755050367020387686648830501
10305000700000807000006020602020500040000080807000002060300040005070000000500020801
10505060507750362060752220406020204380303770406765704083205023304088242630505050301
10800070007080000080008000503050408000600070700000005000006050007000400080006000201
10328247653040628058302048408040307042606060372534345265305340702230702024646026601
10000000000030008000304030004060702000808060400040004000206000207000802070008000801
10372668336082603440803065288052302870206030707020406040222065607023708035705620401
10000020007000702000302000002000400000208030004000700040005030005000008000003070201
10384060603668302076605483407840883375707083478758252553802026463374402538582080201
10003040400000007020004000800000500000205000000000700000005000000000200000006000401
10402080247723372060547030645722805030435227357780706876665337846270306685508072701
10805050500000003060000050008000007020000000000050300000400070000030500000307040001
10605030407074303385355556407028307046837348322022738630406020504070238050505030731
10405060006000600000000070702000706000000000002000000080004000705070003020305020001
10202043676450552458754040304780404336335833606384824050844682443062403060504320801
10804000003000502000003080300060600000000000400000406040800040005000008080500060401
10303044605066504034304040674040602753436760804660604056204070405387567040333045501
10803060008000004020407040006000700000004000600070605030006020300080000060006080001
17303450662530867080808088508082472442408047244780805070603038252050725675388040561
10008000400080003080705000003000300000707060800000202000408000008070200000000040001
10532036207078768070205255872260805420302060607387505023302544807067802043365064601
10208000706000005020202000300030208000704000705000007000502000800040007080002050001
10203050406524604050704030803044508082705464307040838530205460865660627380805850501
10006030006000500030005070006000003000600020400020000050500000205000800000405000601
13324066465020783356835045844585488520748020583274704020464645705087607053208022321
10000020000050000000002000007000000070300080000000305020500000004000606000305030001
10288420307062853554605467803063643070402078334530507040602443265430803580705087801
10000070408060000000600000700060003020003000200060805020004000000080005020804000301
10466060703220705230407380625280207050424387507050807024824050807050344050206740301
10507000600000508020300050000000506060006000506030604080000050706080006000805080001
10305066422487504070587772628766306053343060755050744040408720577062587533804080601
10003000004000002020000000000000606000000080000040006000200080007060000080006080801
10562770805045736060488240868520803335387262688068306338648070804040326060775040761
10600070806000400080200030005000300000600060004050008000007020306050008000800080001
10508065205480806040206032538063648670208080205660323055664040504024605342205834401
10007060002000402070404000200070003000406060800060500060000050303000800000008000701
14723060242058204050603620308685405068805030202030202740566680207270507466577230701
10005020002000205060400040003000506000004000406000200000600050700080802000000050201
10604087602430207250365085845080705088638687202036643868307060244040254052667030701
10202000800020002000203000000060005000000000607070004000004050004020003030007000601
10706250507056648067506074227683533433426250205760207040837586705052704020605027801
10808000302000005030003000002000000000000050800060700050800000707000700080807070001
10584086505072305040206330502062382748735060486050375786508350866630635643708880701
10300030007080505000600050504000500000007060005000400000600040007000800000008000301
10805252604030808880372080702460603472807044202642304060205028503060305746733060701
10805000205000300060007070700000403070006020800000004030606000600070800080005020701
10505070882037257040406040856577606070737080353023324440704860645050655030308080801
10008050008000008040307050000000205000500040005000006000600030006080303000600050201
10403038205627872020206080756777302885402252606056623026328036602080403058244540401
10804000700030000080307070006000600040007000005020000050006000606080003000000080401
10284080534040705330408084632040574080684080566430762220308823205088883828578270701
10005040507000400020806000005050000020003020003000600000400070008000500000000050201
14204040607773887060408867308045784843308080408066208568262060304840503772205020801
10602060005000200050800040008000007000600070204030002000307000600020800000507000601
10207084528530482650804050762353806027553650206040726020607320384080462050636045801
10503030000040400000702050000030007000800020405040003030300050003030007040003000601
10504030708040805787447052856060424520605450307088805770726064508046503028204037501
10004000804000800000006000005080002000300000306000600000400050003000405000305030001
10326237702534753573206386506028604030274372602060447282506327882770706847303050661
10400000800000000000300000507000003020000080003060000000206000000000506000006070001
10602070524684358040532620404673747040664050223787345650604033666458602058682070801
10005070000000005070200030200000000080005060000050000040007020000000006000005040501
10355038644548703480703020304457608352475070874067288064474240324726763058308022501
10007000008000400060704000703000702000000040008000000060003000600000002000203000201
10306773606070723050404263545020247052652573447288763620206074806868705070606220801
10700000400070800060707000000060007000000000000000000000307060006000005040305000401
12388657636620602440408826267634806055456045304467855747704070686050274370607332501
10000080000000600020200080000040006000004000500000800000608060005040005000600060001
10227080758635207020865070272020336668307330627850503438603086332025507048726040561
10600040600000306080005040506060004000200080200060400000008000600060005020000080001
10202050505280444050237020604048806070246070334030606774687540404435576050482452801
10505080303040000080300080506000008050000030004030304030000040500000005020004000301
10504760302056638230808820304372857063554857205080608070576240207856304583604046201
10300000200060000000400000800000000070000000002000600050000000600000600000008000001
11111111111111111111111111111111111111111111111111111111111111111111111111111111111
