11111111111111111111111111111111111111111111111111111111111111111111111111111111111
10000000000000400020000000000000003000000000300000000000700050000000000020000000001
14606783545530405022302027302640565083608650204468435260808030563375648030434733301
10003000800000505000203000700060003000500030004000000050006000500000004080000050001
10305070504358442680503050406036604830508062427060256037648455606064555070786020771
10300050600000000040504060605000300060307000007080003000800000007000600070200050001
10662340206238266040703020374680724040358760303025407670206342677480707586604648301
10200000400000004000707080600040002040000060302050004000500050000080500000008000301
10403724782243705574608080308060442033388030206085322070573060887020377247265270701
10403000500000206000002030305060500030000030205000005030700030004020000000700050501
10305030203270666030374820504020405370208380703744704022703032606077266880602070501
10800060004060000040006000606030603000500020600000007000005030005000200020002000501
10554275637060837024803077302030702024806060833442675555405880306360308058663045201
10000000000060006000303060006040305000805060400040002000406000304000205030007000401
10488472487084207260208082582053803750407050307030705060774073306047407072304470201
10000070008000606000604000002000600000205060004000500020007040004000007000003020501
10582020202387307075507286508420262458507085873237433628206038835458404875638080201
10004070600000003050005000800000600000705000000000200000006000000000700000002000201
10607060222477567030837050467726302050247448467630604355247447474580802634308052701
10608060800000006020000060008000003030000000000020200000300040000070600000207050001
10608050802062308377337663503035408056752688363078575550202060604060486030606080841
10702070004000300000000080503000605000000000006000000080003000306050004070302070001
10704056467440664258338030205740608627625465403745384080242724866057207060704540301
10606000005000802000007030400040400000000000700000706070800040003000004020400030401
10405056208064405037408060856030606853372440702380403036204030507737867080764064401
10504080002000008070604040005000400000005000600060305020007030600070000020005080001
14806440757370838060804078208024388253508055725870508080406085727020775823476040381
10005000600020004080505000003000200000503040300000708000408000006020200000000020001
10544026405062273030705254546750203580505050806432806064407532705057703026676077301
10702000603000006050505000200030404000504000404000007000605000500040008020007080001
10302040802722504070202070808038408077204547303070456460408350273480288350402750601
10003030007000200020004060004000008000800040400030000070400000704000400000607000801
18623074866020535645282047463566538850388080442647803020657423408024607055305028441
10000020000060000000003000002000000080400030000000802040500000002000605000807060001
10552760602026886477507564604077755080206038385550807030706872477370302280606054601
10000030305070000000400000400040004050006000200030305080003000000030007020406000501
10644080204420808550602220874630207080723447204070506056864050304030242080505520801
10608000200000405070400050000000307070007000306060406040000060307030008000804030001
10806066727625702040657744628842703088272070644060242080703820857085758545804080701
10002000002000004060000000000000505000000080000060007000400020004060000020008060801
10522670605046773030865660624820504465623228733024402578327040606020378070237020571
10300070608000300060200030008000400000200020002070008000007060203060002000300050001
10303086403560604060705066764038878650707030702720777045462040508065502733504336601
10005020003000205060304000700080008000705070200020500070000040303000300000002000801
18572040734022407050202870808286404086406080406020306850445620707520203347242840801
10002060008000705020300040006000307000004000308000300000800070500040402000000060601
10804065706340606450757055462050505028668534803073533436405040578080747024555060601
10808000500020005000604000000040004000000000406050002000005060007070005020004000801
10307250606064375045508073536668584533546620406670503070454872702077202050705055701
10506000708000008020003000008000000000000070600050300040800000505000700070307080001
10577032303088206050706630804027487483632040756050457665307540463560243653508330301
10800060005060604000200020307000500000008070005000500000300070005000400000006000601
10403627604070708320826070406660305678408065502545607080608037208040608352877030701
10403000306000700080002060200000607030005060800000008030407000500040300080007030501
10604050683078487050403080654344708070282080624073245760808450346050738030605070601
10003080008000002050605050000000503000300060002000005000600050008050504000300050301
10806043804434755060702030465644306827402228707022243067744044503060608087848220701
10607000700060000060206080002000400040004000005060000040007000307040006000000050401
10686050335060605860808035343050723050565080844620247660407338808075867785747620201
10006030204000300020208000002040000050002080003000400000800020007000600000000070801
12208030808737575080406577802064776645208080804043305625377080507260804348608020301
10503050007000700060200080006000004000500020403050002000708000400060600000806000601
10308043872380338230605060667276203055236670708020788030504870327030875020437065201
10302020000050200000506050000030007000500040607030007040600070005040004050008000601
10306020707050505877383027483080754780402570406058702880285052208068706064805067201
10008000507000500000005000004060006000500000807000300000700020006000508000408060001
10853672304774424454408674602053205030872223402040638388704233244270408743205070251
10600000800000000000500000206000007020000050008060000000608000000000607000004030001
10704050228887333030686420803774448030457040366862375820507078657545808065757060401
10002040000000005020600040500000000030005080000070000050006030000000007000005040301
10328065884287203620803020206454407475483080265064435068538750654486476045708084701
10008000003000200060406000205000302000000070005000000050005000500000006000706000201
10204775504030833040702366234070543022853744568643368480806028303323705030402340401
10200000600080200070703000000050002000000000000000000000702080004000002060804000801
18244725884240605630403548447673604067734066603383755725807070248020524530303525501
10000040000000200020600080000080004000007000700000400000604080002030003000500060001
10424050278454307050642080333030853854204550776570802462808066537034504057452020561
10400020200000708070005080506080002000400060600060500000002000600050004070000030001
10707020204650677080448040505086707070448030648080605642753350306623837030672473701
10204030606070000080400080202000008060000060005060502070000050400000007030004000801
10503270308072447470606370505655887067348357705040804030553640602478706285202023201
10200000200030000000700000400000000020000000006000200040000000200000500000003000001
11111111111111111111111111111111111111111111111111111111111111111111111111111111111
