11111111111111111111111111111111111111111111111111111111111111111111111111111111111
10000000000000500030000000000000003000000000600000000000200030000000000060000000001
12302366573370403026203087202250367034303570305232447550303020726475465080875755401
10005000300000406000408000500070005000600080008000000030004000700000008080000040001
10808020203864736650605030402057504780407077438070454047867876706033474080268080541
10800070600000000030607070304000200050307000006080002000200000006000400030500020001
10267530508533482070403030282420567070672870208036703460603885848470806557403552401
10700000800000008000205050400060008050000060804060004000200060000020500000005000501
10206322285753807257404020702050624064787030807024344020258020553050753845338680401
10607000400000602000007060303020800050000070602000003070500050008050000000400020201
10307080706650422030478430308050507620707580208545703026707057307058675660505070601
10400060007020000050008000607020702000600050700000002000007040008000500080008000301
10633237643080274054504068608070808063402080372273487762305720405880506035253077201
10000000000070003000803020006050206000407040700070008000602000404000808060006000201
10773263573026306320808084883038805450702080503060602060734062507077408065803850801
10000070005000304000502000006000600000606040003000600030002070002000005000007040201
10588070605784208076508625302750587286707087534348484855708058742644404847334060501
10006030200000006050008000200000800000307000000000400000002000000000500000005000501
10308070576363348030335050358554704070533378764740206748374582835570606634603072401
10805080300000004050000030002000005040000000000050300000800030000080600000802050001
10402060802082502273267478706077602063834458727066466720608070708050352060503050861
10207070003000700000000020206000606000000000007000000030008000407030004040703070001
10806026437560846488486070608650707835287443807247748060884373842058606060208420801
10708000005000708000003070800080500000000000700000505050700020003000006040300050601
10803038408082602057404040567080207328252780704330405027606020204566873060764036401
10402040004000004040608020008000600000007000700020503020005040600020000070006050001
13603480863220767060804082305062274373804068677260704030504063784060573363736030571
10002000300030006040505000008000400000603040300000403000503000002030700000000050001
10354086608057343080807222378660606820608020607757407083408627207055305057576054501
10203000208000002080403000500040704000807000603000007000207000300030002060008080001
10507070506468207020808080507058708053706467207040247380208870288450834760402880601
10003020006000500020006050006000003000300030400080000080500000602000700000603000401
16473082634080633563687064822587377540525050324545506080436658606072307048407072351
10000020000070000000006000006000000040200030000000506080500000005000602000705060001
10228850604024473842807283707036642050203038537720303070603232624430502820205072401
10000080606060000000400000200040002050006000200050303070006000000020007020302000801
10743080807580404280306220687530507060555633408080605075853080304060725040207770801
10304000400000405030500070000000308030002000306050208070000070407060006000808020001
10602037238833603020876445626726204076373060365040847040607730275072375435302020301
10006000006000003060000000000000504000000050000030008000200030005030000030006040301
10488380803023286050586380822460403743636467755047504887568030503020843060285030371
10700070606000800030200060004000300000800070004030002000008070206020006000500070001
10504057206770307050305052532034468430806020608740464057874060605048504284708875801
10007040006000702030707000300050006000502070700060700030000020406000500000002000601
14348050323042703020306240505227806046208070807030707270544550303480306643342870201
10003070006000204020800030002000208000002000604000400000300050200030202000000080401
10205078803770302420383063376040403054472675702072367447202040885020348065878060701
10803000600050004000407000000050007000000000707040007000008030002030005060006000401
10203560704056485072606022424343667876287360204220404020274288605084807060307068501
10605000704000006050002000008000000000000050300070600030800000607000300030205040001
10233057306053606040204880802024448358478020278020553372306640244860857486307350201
10700040005070204000700070505000400000006050003000500000600070008000300000002000201
10602686804030308420878020502730703428603085607585307070604067504020506265354060501
10804000708000700080007020200000205040005020300000006050402000300030200060003070501
10408060374068774070706080327638202050468030627067775630808230727060244080303020601
10004080005000004050805050000000802000800050007000007000700040008020303000200070501
10207034406676752030207040242638507287505423402035762023723084205050504076454280601
10502000700070000050504070003000500030007000002070000080003000303030005000000030801
10343070386020302660607068652050277040643070424330755640707725708042772268767640201
10003080403000800050803000003070000040004020007000200000300030004000700000000050701
15608080304428827070308622205066766232703080707072704545884030807240606745202060601
10203060006000500050800020003000002000800030303050002000408000800030800000802000601
10508067746550683870503040544234303043856480408050328070605270365030465030572037201
10606050000070300000308070000080006000200080202040005060200040005070003050005000701
10402070405050303863344072288060655670308640308076508840755033403046507047804023801
10005000407000700000004000007020002000300000607000300000600080003000306000408050001
10556243306767273583408832307073204080485624208050674456503264546330607836202040881
10300000200000000000800000203000003020000060007040000000602000000000202000008030001
10805040837865265080425780505682852050568040478437423320305052286683205026725060301
10002060000000004060700040700000000060004030000080000080006060000000003000003070801
10243087735243408650302070605866305888555070572062386048777360277642265073804083501
10007000003000700020508000706000402000000070006000000060006000600000007000205000801
10402663808060468060808638632050565066585462537737782260604088707735408060408250501
10500000400030600080702000000040003000000000000000000000502060002000008050505000501
18754658254650303770506286454425805067428032603525286348304050778060543640707455801
10000080000000800050700080000060007000004000200000300000306080006030002000700080001
10787080286726704070346020267070746552404270527470707677403065527058308066378030351
10200040700000604020005060706050004000200050700020400000006000300040008080000070001
10605050805470334030286080605023504050366060448070603552745880606572324020843784301
10502070403050000080600060307000007050000070004020703050000020800000003020006000201
10805280307057426770802880708382683052825627605020605080868250508357803675703073501
10300000500030000000500000200000000060000000007000400060000000400000500000006000001
11111111111111111111111111111111111111111111111111111111111111111111111111111111111
