11111111111111111111111111111111111111111111111111111111111111111111111111111111111
10000000000000500000000000000070000000004000000000000000500000000000000000000000001
16606476326470472670804262474057603083805560203065308540273020806522424753545723501
10007000000070000080400000005000207000300000206000604000800070406000000000000080001
10508548386030737020348687207830303650778854565880203052606550826050736873765040621
10208000500020207000500000200080704000400050002030707000006080007060000060002020001
10405050702020404662204020758020408067603082206030407376845020407083477420805060701
10600060003060003000007060407070006000006000406000400000600080500030000000700070601
10234043683270727060725080302085783520467660802663273570708684325450257735724060401
10002040000070200070004070003000000050000050405000000020300000000000400000007080501
10307540704066307052403062362867553060468020308030722070384737834837504287705740701
10800040503000008000406000000070000040005060008030007050003000400000407000700060701
10678020205834626260304234455650605672306083523087605078307080203620503060725088601
10007000607000000080800000007000600060006050000070204040007050007000204020007000001
13606655402050306047858675373067527070405050704650202070652020324027453050208842301
10008000600060803000006080002080500050203000700030004020006030004000003030300000701
10483370505820885064608030802030403760206854648856754070808080507776306060824530661
10000000600030006000200040800020008000300000000060000050608020400000700060000020001
10746567403062804557522580652560836050325388472050343425705025244640563735348780401
10000000707000500000004000500080700030600030800050000040006000500000500000000050501
10665770236670673682608022438080508582507020406573766020746840702582603325427085401
10000040300070500000007000000060800000004040006000003050000000407000805000300020001
18766550502040305068745473708733507320585046274055546030743566667070207060402650801
10000000305020506000000000402000200070002000007000003040000020006080006030600030401
10444383402060306366706780823040632037764860708288804075567060402057485060334070251
10200020006000300000600040700060002000000020400000505060000080305000000030300050001
15404030206565585340353820305355307088535067702230803024345270602853774727708063301
10002070705000000050000070308000007000006000804000204000000000300050005000002050001
10424050622036663027276076202050774347207830402033408673204576682060402040566020721
10006000700080008080008000803050000070006020804000808000300070003000500040004030001
10404488407060604020642640535026637050228080587230804040655058805027388234202068201
10500060007020400030000080002070000050800050000060007080400040008000000070003020701
10884070684030857463846060508060828740704542783077236520402850405456427070377030301
10207000700050000000000080407020300080002040005000000020700000607000000040002000201
10606234702025275633224870204080402057477060203043558080472764343038573680503834401
10600030305000000000000030500020005000003000603060008070008000000080000040200000201
10202060202024443774862030802048853560204353303050407034602832275440583080625440601
10707040004000005000003060304060000060700060008000608000600000000060300070000050601
10687060544777208047807040802080683072722050537787706580508655284080207066383020301
10000030008000202000600070304000400040000040000000603000500080000040502000005020201
10858825205028402060684770505334635250804355587830806046383670508456305854642030201
10800000705000003040008000700020000000200030000000407060000000506000006000700050401
10207340508687824583883023554070667454766730482544408060403454208033755020603820801
10004000703000400070006020008050400000000040006020005000300050602000008020200070201
10378078705040802050808050254050206038667084302060403830475020806344208084355080201
10002000700030705000700080002060006050002000008000400080306000804000407000002020301
10408380525880305543288425705064775220203387728738824040307060504020704566507040701
10700070700000200000200070006080000020200000200030008070704060406050400000400040301
10824030607722528320804080436040242060308750607050606030504044508060428850834030701
10008030208000300050306060000070002000404000404020500050502000703040000080003040401
14878040607050302060604027674644804086205075808060452360803760308023753087202060801
10004040708040003070503000700000306000405000705050800060006000202000603000402080801
10402050208020468440208360804740706360602840433070462035585756605570606050502340301
10200060706030003000803000707000706030702050006030002000000000300060607080700050301
10658270204073206037805027808028207040207060605073408663646350504030407040688030501
10600060705060004080007000003000008000304070400030400000000000504020503040008000701
10703060406074546080503838503527662868305030333420502645782475603060508076802244401
10606000404000007080500000500040004000007050000000200000003000008050203000600000701
10506556405827406040607280745030306024422037583740702573576023846020807622447080801
10504000404070002030805000300080403040007000200080306000004080600020700000003080301
10408860703060425040204024803230805030605740606040843027703030703880406536804060601
10807000800020000030708050002000703000400000705020600020005040400000500000203020401
10305055863387854830502027627080704838233765208083205730406070844224855470202740501
10500060003000000000705000000040300000000000205000005000207040000000003000500000801
10623850806020342476805632656572554545336260383657766020703076474734702086566435401
10000000600060600000200000800000200030000080000000005080807000000000804060006000501
10483444536770406420704660806780805080827082667360408070806876468830308062305030501
10000000000060208000700020008000707070300020000030500080500000002020002000008040001
10428430574830803048487025765020473020202270286048453240208572803050464784682032421
10000070004000708000008000200070400030800000700060000000600000802080000080000060001
10325062404044306247705564306872303840878730705770552243325580608068476040742280401
10003000705000705000300000400000403000200060707000200060000020700030000080000030201
12303850205860406030688860662370405080405047602065828080552220433740508272865067701
10002000500050504040000080000040808040505000407000002060400080006000800000008000001
10704023377080608046602037248060208085704850207056507060702077506037353420503232601
10205040006030008000306000006080005000600070007000507070507050006030000030600000301
10886075504032652670403848888088788250574056588530303040208080648050437043785060321
10002000308060000000304060000050003000500020006020205050503080500050300050003040001
14804220207030402827306070388650706050405575606020608070203070772220206370608057201
10002000608080700000200050000000807070500000002000800020002020004060300000504040001
10682087802020205640547586778823605020623323833844327533563085708070408478503330401
10006000007000400020000000000000700030000000000000000000006000002000500000200000801
11111111111111111111111111111111111111111111111111111111111111111111111111111111111
