11111111111111111111111111111111111111111111111111111111111111111111111111111111111
10000000000000400050000000000000008000000000700000000000400040000000000050000000001
14502484355570606052604055504460268068304460408224526250603060457648287070658376201
10007000800000603000702000200050005000400080005000000020007000700000003040000030001
10802060307767735760305030408075607530202034736020558078735472807073786030538020371
10200070700000000030502070406000300020707000002020004000300000004000500050700020001
10468220806553668040704040658640646030376220405075302860604338458360705338502874501
10700000700000006000606060600050003050000030703070003000500040000040600000007000601
10705455758552804742605080303040328056222070206056556040656060273070772533462470801
10608000400000204000002070303070500020000080206000006080600050003020000000600040201
10608080308250836030225740807040806520207420803572303037204022503065645650507030701
10200060008040000080003000702080606000700020700000002000007060002000700080006000201
10276274828020256046604045502030405033803050245228347527208280603620802032463044501
10000000000060002000704080002030808000805030700070006000402000806000804080004000401
10654658354027306220404046248058308620202030306080406070742055608088804028504470601
10000060003000804000807000002000500000402080007000200070008050008000005000004030501
10332050203872204084403447603860623546808044567682877455807087544636203466438080501
10006060500000006070005000700000800000303000000000700000002000000000400000002000301
10607020874524325050437020622682604020833865642220808235376563264880506575803088801
10208030600000008030000050002000005040000000000040700000300070000040400000402020001
10605080806077502465626857708066702086822266262047887670206050506020257030503050581
10204040005000300000000080804000405000000000002000000030006000403030004030502040001
10306076766240242246752070806450206827447342408565845030755266426022808020705740301
10802000003000507000007060200070200000000000400000806040200030002000007080800060701
10304074707034406045206070678020207276756440703560808064802050405243668020272072801
10403060002000005040307020005000300000003000600070705040006030400040000080003050001
16708630362330287080508028608026767442403043272620306040707042547070677524223060851
10006000200070008070303000008000300000508070700000506000506000005080200000000040001
10528078802055653050808845883750507250407030304632305084408542703024507027374025801
10702000803000002080304000800020806000607000604000006000407000800030003080002050001
10805030706833208080202030603088702077707533305040788870503550338640482460502720801
10005040003000500030008080006000005000500030300060000040200000808000400000505000401
13627042346040324823824084543284726540547040374442305050582828702065206066705042731
10000050000020000000006000008000000050500070000000707050800000006000503000608060001
10737370204087224852806538704058834080303033644480204070408775276520403680703078501
10000030508070000000200000400060007040003000800050707060003000000030004040505000601
10666030208780807670404440836640802060574873703020308057246060205070678080603440601
10605000500000408080800080000000305030007000608040603030000040505040005000703040001
10702065224647802030242858382326607088573060864040885060603640885058738658307070401
10004000007000006060000000000000707000000050000020004000400040004080000070007070401
10486740506066825060647680668270306873248745546037703334435050408050226040426070321
10500080503000700050800060005000700000800070005040006000006070805080007000200050001
10204075405760805030205026252063546830205060404820835063328050702088402367506847801
10007070002000202060308000800030003000204020500050800040000080405000200000006000501
16884040426074506050205280407777602034406080403040606320522840306530507847365240801
10008030007000703060800050003000703000007000402000200000300080800060204000000070601
10605057703670406630787044732050805076563634406063226862404020846060537037253020601
10305000200040005000304000000050002000000000706040004000005080007020002080004000801
10203850502075486065602082385785432765633740604730803030355788208045808060403036801
10405000307000003040008000003000000000000060200030500040300000806000400080305050001
10422034604042506040308440402025326737674060823060587525302340877620682578308660701
10700040007050305000300050803000700000006080007000200000200080002000400000005000301
10708686508070202780426070204570408874804043708776803040605043204070604655473070201
10703000508000800070002070500000204070003050600000002060705000200050400050002060201
10806050572036634080505020288422504060378080558047728470407540726070534080403070301
10008080005000007040502050000000802000600050005000004000600050004030603000800070401
10402057306764756060403080526646302648205856402076775034527066807060802056368730801
10506000400070000040208020008000300020007000007060000030006000508080006000000050201
10386040383030503860404032655030888070635040283450785540605475608052868757526420301
10002060308000600030504000005070000050004080003000800000400020006000400000000070801
15503060603645567020705468507036324544203080708034607734278030604360503363202040201
10707070002000700070300050007000002000300030608080004000407000300070200000305000401
10307066657870672770406060657347607072337460603020768020404750242040678070632057801
10504030000040500000507080000050002000300070805040002080600040005050004060007000301
10208040306070707242468043482040433650603850506072806580858044703073503027703024701
10004000403000700000007000008060008000300000808000400000700030002000405000508060001
10787562706287826848707865603087803020427736405050552384804865637540402875707050821
10600000500000000000500000303000002070000080003060000000407000000000604000007060001
10206070626342486020247440306552247060774040725544542440405082354826404073645050501
10003060000000007040200060200000000020002030000060000060006080000000005000005080801
10865032376438807730706020203775206873334080244032664045428830446735255034606072401
10003000006000800020505000205000504000000070004000000070006000800000008000308000601
10402387202040465020508422455030285063824237654358523720302062303573408080805780601
10200000800030500070503000000050004000000000000000000000607070008000006040406000501
17655768627660306740307662256328305048353025604334856732608060485080676780206243501
10000080000000500040600040000070007000002000300000600000407060005050007000200050001
10324070858736706020677040445070627245207230322880502247804023625068302082724050531
10800060600000502020005070305070006000300060700060800000005000500070007040000040001
10507060706460748040686050805063703020836080837020305653434340607482626080782753201
10503080603020000030200020404000002030000040005050705060000060300000004070005000501
10706240408067467760305740607776267072247876707070608040876380602668507473703078401
10500000200020000000600000200000000070000000006000600040000000200000600000002000001
11111111111111111111111111111111111111111111111111111111111111111111111111111111111
