11111111111111111111111111111111111111111111111111111111111111111111111111111111111
10000000000000400000000000000020000000007000000000000000700000000000000000000000001
17205668386350468750307276548026802022708540706087403320656020807878727424243824201
10004000000060000060200000006000406000300000407000608000800030503000000000000030001
10602443642080683050364626202270308620257342287330202046402270285050643636566060661
10405000400080206000600000500020302000500020004040603000007070002020000030002020001
10504020205070406742603030573020603046504085702070503446877020306053673240702080201
10600050003070007000007030806080006000008000407000200000200080300040000000300050701
10445085625580864070456070305064526320226640202267562280405843678360728656634020701
10007040000030200060006040007000000080000030802000000020300000000000600000002040501
10405650803044407083503077528445657020466080603040865080855468634847607687705740301
10500070205000007000803000000070000060004060007080006040005000300000805000800080301
10388020204837855660408878323220205353703032578067207074507040408340802040256077701
10006000302000000070700000006000600080005070000030404070007080002000408040004000001
15202722407030703024546785263078566080706060506430605020682030624078868030802258401
10004000400080304000007050008050700070704000500080008080004030003000007050700000701
10278260603680674074807030702070708830308647457532868040404060803533707060684850751
10000000400020003000300070200070006000700000000050000070708060200000400070000070001
10777555808044504288584750774530674050654868486070583752605065244740854322784570601
10000000208000800000004000300020600080800020400060000070003000400000800000000020401
10684350445460226337606067778080408543807070706668327060686840506665306785452037601
10000050400030300000008000000040500000005080002000004060000000704000202000500020001
14363650506080407082646585505274405430885068532074467060764774352020208020404750201
10000000403050707000000000304000400060008000003000006070000050003050008020800030801
10334452408030608665405480878040662085227660405582404023485030803084464060446050621
10400050007000400000300050600030002000000050300000307080000050203000000050300070001
14807060205683527450583850804276503042836057506360304033385860206247455678206073601
10005020807000000040000020303000002000008000706000707000000000600040008000007030001
10577030536083584057684052306060243282608820308037702875508644237030403030584070361
10006000800040007070007000804050000040008040804000204000400030005000500070004060001
10805575404040204020284380763035758060466050347420506040736068802022765366303065601
10300060006040200080000040007030000050600060000050004030500020007000000040002040201
10454060773050735722464040207070854370204754577042438350407630708332668080425060801
10606000700030000000000050505020700050004020005000000040400000407000000060008000501
10405242606077536365354640304070703026582080305035772070226868387084522440605847201
10300070803000000000000050400040008000008000708080003030004000000020000020500000801
10608060207037268354854080208042332520206843407060705044404572747750624020675770701
10802030003000004000005070608070000030200070005000507000600000000050600030000040201
10722050725367204033808070802020464053435080564666507320408377526020606088385050401
10000040002000702000300040704000200070000040000000208000400040000030504000006060701
10635626405065208050668460705432724820802864435740705056725640307747304875586040501
10300000305000008080005000300030000000600070000000606080000000508000003000700070701
10505280607426653228574086334020256524774780437845602040603225702047325030802870201
10004000704000200080003080006060500000000070003070004000800050702000004080400080501
10757027202020208020308040537040206084626077307060404570523050407488402024326030701
10003000400040204000500030004080006080004000002000400080502000603000407000006080801
10505330487430407587572572502057363640204442637745827040207080303080607652507030401
10400070300000200000400080003080000030600000300040006020702080606060200000800060701
10772080805635544270705020767060427080504740506070307030508047602080583450385030801
10008060802000600020807030000080005000408000607060700020308000208040000070008020801
14675070206060603060205043842862204033502066304020225770208580204085882027703030201
10002040406030005060702000600000206000203000802050400080005000605000307000503040401
10708020408040422460807880406780804520605560627060745022473728202320607030802760801
10400030603020006000208000406000407080704050006020004000000000800030204040400080701
10843250504048305054604076605074205060805040705063803347844320503050602020453070201
10800040606020007020003000004000005000406040400060500000000000502030205050005000601
10506060507063855050502364705364434732807040857670803636428658507040706082507335801
10804000305000003030200000800060008000002040000000200000006000008070503000200000501
10204744404475202030503640856060604075584067622280708375238086468080403847583080501
10304000808070004030305000500040408080007000700040702000006060600070400000008070701
10704730403080546080206025704460206060804540804040628032303070502480802636504050201
10605000800080000030607050007000702000600000405050300060008050600000200000307030201
10703057348575357750608037563020303683263425308074603380207030876857874770403520501
10400040005000000000602000000030800000000000605000008000308050000000006000800000801
10667530603080885364503823543762755656864650836445786060204037766834507048664262701
10000000800050600000700000300000700080000070000000004080205000000000806030007000201
10764543662870402620202330808730804020558068228350503080404258323740408088404040501
10000000000070806000800070005000403050300040000050500080800000003040007000008050001
10663540223680507068873042452030626040304830755052332830205227207030646672722085851
10000030003000403000004000400020400080500000700050000000600000503040000080000060001
10782074605027608682506865806726502670684770504680628648826560208024328040352470801
10008000806000206000600000700000708000400080803000200050000050300070000070000030301
13708550407750306050275860376530307030605083204084555080478320558750505622548063501
10008000500030505080000060000040804070808000308000005070300080004000800000002000001
10204078854030804045705027833030505085304370304078208080603042605047283660206722301
10203030007060007000208000005020007000500070005000307060604070005070000070200000801
10824045507087876760208285324035452250225022568230708070203020255020855053655060831
10008000506060000000308020000060007000500070002070606070605060800080300050004050001
12603340808060405552206040544230304060704762203020603030802070475340206860707042701
10005000608040600000200070000000406080500000004000300080007070002050800000705080001
10727084203070603250866235768422402060435354744826547654848035407020802564505640801
10005000007000700030000000000000600080000000000000000000008000004000200000800000801
11111111111111111111111111111111111111111111111111111111111111111111111111111111111
