11111111111111111111111111111111111111111111111111111111111111111111111111111111111
10000000000000200040000000000000007000000000700000000000400060000000000020000000001
12202323266520803026402048802540747064505640705577775760402020326235434050633553801
10002000800000702000502000300080003000200070002000000020003000500000007040000020001
10403080506555328870603020406075208730303064243070658083347567502026385080445050261
10300020700000000060208020402000700030203000004060005000800000004000300050600060001
10228540704685336070402070575560536020236580404082805460206758547440305542303825801
10700000200000004000605030200030003060000080407060004000200030000020600000006000301
10703658374482504686307040508030676035788080702085356080875070573030674758225280801
10605000500000205000004040303050200040000080508000006070200040003080000000800080501
10704070403320843030678850207050705250504720402765407033304048604055528220606050501
10500070003080000030006000508040308000500040200000005000008030004000700020003000801
10358672785020758046804028206020208022702060255452522365807520305580508055762086701
10000000000080004000404030006030305000202040600040004000205000408000704080004000201
10533783366065408680206025788087306480403020406080403020758026708045204042804680701
10000020003000805000704000007000600000602020002000200040003060006000004000007070601
10338020803475605074806258808450542552303088363826873347204033852772508866655070601
10008040700000005020008000500000700000708000000000600000005000000000700000006000201
10203020344662572050333050554383806070484325287270607764886357755650507476303047601
10302050400000004040000040005000005020000000000050300000300060000080700000702070001
10306040206076302463268668406075402076327675653072453260406040708030225070606070751
10306070003000300000000070702000607000000000008000000060005000608060008030606030001
10606063838830453242626030403440707238683524507666487080432557838025207080404460301
10705000003000506000004060700040400000000000200000602060500060003000004030400030701
10306058308043802035803040645060308855632380204670805023207030303824666060575084301
10508040005000002070503030005000600000005000800050608040008020700050000030005050001
13306880677420787070208044207033678578508083724820704030304044278050542552734030341
10004000200050006040805000004000500000208030500000508000505000003060800000000020001
10457085706043674080403675327730407330703020203324607078505448406087304068624064401
10207000608000008080602000200070405000606000305000006000604000600050005070003050001
10708060405673402040403080205057506076703448708020568420403570782870487460304860801
10006020005000700050005040003000004000300060600070000080200000802000300000406000801
15273073634080432752827075323355463630475070636766808080456657307042303072706077851
10000030000040000000005000005000000050400030000000608050200000004000605000606070001
10256280405083785245602678508028648050204078586770507030408778778240704530504068501
10000040704050000000700000500030003080008000200080302030002000000040008030404000401
10435020203660805550602340842330302020475784402060706068856030803070865080406870801
10605000600000404070400030000000706030004000807030806060000060504080002000207070001
10305043257387605080245682242783707052827070852080662030502370723024334253504040201
10002000002000008080000000000000706000000020000040008000700040004020000020007030301
10286640304026832030464580662880403532427754683044508868642070602050767070363040271
10800020203000400050400070003000400000300040008080005000007060207080007000300020001
10403085202630404040402025564036268230505080408760465065643050305084803354205353201
10007040005000205050404000800040003000207050300030700030000080306000500000003000501
14748060435032608070506820503485205036506050406020706280736250502380402862738860701
10005080004000603070700030003000208000004000708000800000600040800050508000000020601
10604084303730804380563087864080607036253525503084357324407040256030855076257070701
10306000200040005000404000000070004000000000407080003000005040007040006020003000701
10308670803064484024202027787555644334363650804560203070324525604055207040603084501
10604000704000005060008000006000000000000050600070300020500000504000200040708070001
10265087306037507060703860308032478428226030638040864677704320755650434774802320501
10600030002050805000400050302000700000005040008000300000300080007000800000002000701
10607758804030508430338070407520708248705036708472203060303058503060403847532020801
10302000802000700070002030800000504080004020700000008060203000500070700030002070201
10802050862073372060706020587458306030366040554048426530708760544070262030208030701
10005060004000003050306020000000203000800080007000005000700030006020406000800020601
10204037202884645020203030555324303855603227406044483037365085602020205086454760701
10205000600020000030806030002000800070005000002070000030002000306070004000000070301
10337040435020806330408036257080757060483070476770456230208555608025288276468380601
10003020403000200070506000007050000050004080007000700000600030002000800000000020801
18207020205365852080603434408066655528608080808035705232332040803770502352403030401
10206030002000800070600070004000004000300080307020004000503000400040300000206000701
10302066274270727250605070835883608084622250407050466050307820385080558030832063301
10205020000050600000606050000070006000600050302020006040600070004030008080008000701
10607050806030203528666054575050678870708780804085508860556027405078705034206065501
10008000808000300000008000003070007000200000808000700000500040006000605000707050001
10443737807664474788506386405083308020788732602080534226205876323850605558608080581
10800000300000000000700000802000002040000080002030000000405000000000603000004050001
10607030782244737020455630805242785080444060258867446260204062343384805063854020801
10002030000000008040700050300000000030008040000030000030003040000000003000007030601
10348074465384603420505050403337507725775040547033244052285380354673685087707085201
10007000007000400020504000504000705000000020007000000070008000300000006000404000301
10808384504080358040806728448070548022678546266235773340807064707482703080606850501
10500000300050800020703000000070002000000000000000000000802050002000007050804000501
14367287726370406870807253533858804058357062505268328656408070355040773720803288201
10000080000000500080500070000070003000003000500000500000506040007050002000700070001
10284030442363505020576080627060745664704730584880407667502027585026407073778020241
10700060600000205030007020707060005000300040400030500000005000400080003050000020001
10707050305360726020477040402055506060254040458020405463335570808276288030266458401
10804070208040000060200070802000007060000050008020705040000050200000003040004000301
10303320505063663330306720502644446048583853706020803050466860405765207656507082401
10600000300030000000600000800000000070000000004000700060000000700000300000007000001
11111111111111111111111111111111111111111111111111111111111111111111111111111111111
