11111111111111111111111111111111111111111111111111111111111111111111111111111111111
10000000000000600050000000000000002000000000400000000000500040000000000070000000001
14307747827760803033606032506580838075704450503847225380702020245753244030875773801
10005000700000205000806000800050006000700020003000000060005000300000006070000030001
10508040204445745720207060607045504240304086427030827052254536503067765040535040341
10400040800000000070505070303000800040205000006080002000300000005000400080400050001
10575370602442722050404030548620438060346830308038603480707247283860506777704646401
10800000300000002000607030300080008030000070607050004000600040000080700000006000301
10408754862864802657407050208050572073362060202076585020388070833030445572743720401
10503000400000807000004040606060500080000030506000006040400020008040000000400070501
10302030304730832020378620805060707240603820506878504057703025808046652460703030501
10300020008020000060003000802020305000400020700000002000002040002000400040005000701
10422267658060746078805047303080508076406070783272574352704840706360702076443067301
10000000000040004000504080008080504000505080700020008000302000402000704040002000501
10488336753063708680307053664064803720305040707060203020574068304052307058508470701
10000070002000804000505000007000300000502050002000300030004020003000004000007040601
10447080703627204058506224607770475548404046558463685586604082442582308385676030801
10005040400000005080006000300000400000708000000000400000007000000000700000003000501
10803060227335682060584080483352508050566555237740407658365578587560607487806048301
10206080300000007050000070007000005070000000000060200000800080000070800000706070001
10405060304024808887333886702073607087278448588088865630306060803060867050403050841
10208060006000400000000060202000503000000000005000000040002000207050005080407070001
10204045362840623734543080705880507375568482202273655040682257826026206040504880401
10402000003000806000004030400050500000000000500000707040600060002000006080600040801
10408058704077604047204020257030805833343340505360204062703040202856757050548063201
10406020008000007060306080003000600000005000300020206080002070500070000020008050001
14405750733250662080808072802082735886808058288280508070506022872040365366348070451
10008000600080005030207000002000400000704020400000707000505000002080500000000060001
10572084604035823040707272688420208650808080803556702025402228304084207026688045401
10505000203000005020307000200030305000708000302000003000606000800030005040003030001
10207080802565604050207030604074403052505344805060388720604880454780887620402420501
10008040007000800020007050005000004000200060300080000060300000506000200000704000301
15725072847050763562727075772856282350745040745383606020358862304065204035408038881
10000020000050000000004000003000000050800070000000802040300000006000606000804060001
10255320802055547823602854603082767030603085672230307040802748346440502770303077601
10000030604060000000200000500070007020002000800030508020005000000070008030502000601
10848030503870706250304270865530203060847242805030608088247030405050557020708750801
10204000600000404080200070000000302050007000705040703070000070606030003000803040001
10208063788842607060526684363272506037662030235030564030506250477022668547607070801
10002000008000006080000000000000206000000060000040007000800050006080000020008050201
10652580403025275080773330687770706337523874557083402487582070407050285050228060361
10200060804000500070800020004000500000600060003030002000008080808020002000800050001
10606038806620603040802082253087787720308040406470672076574040807047802625507332401
10004060006000706060203000600040008000608070500050500030000030607000800000006000501
17244080782058402070404720807383802086405020805030606360633370307680602487553330301
10006070006000402080500060007000306000002000708000200000600070300080803000000050401
10804035804650804370485032862050707036688883506075346342707050752060447025433070501
10305000800030006000703000000080007000000000304020008000003080007020008070005000201
10408220402083738034305044582634842855423660503640304030883588705033504060402076301
10506000702000003070004000004000000000000020400080200030800000506000800040804030001
10748022407032703050704280605062322662243040787040573734508540285360667683605870201
10300040006020306000300070302000800000007080008000600000800070003000600000004000301
10706522807040202580673040605840703875804063607627705070303068708060603543553070501
10203000503000500040004020400000806030006020500000005050405000400030800060003050201
10202050523074886070207060457862805080486070488035835280604640357060556060603030401
10005080005000003030307050000000807000400050004000008000700070003060608000800020601
10206076807664455080205050862727605253705684606024767045422063203050302044858880301
10807000700080000060804040008000800020006000005030000040002000808050007000000050401
10343060848070804670403065454080885060222040857550288580404785308026754287724680801
10007070606000800070403000004030000050007070002000700000200080005000200000000070501
14303030305633573020807745202033785748604080704057802354725050805230506475202060601
10502070002000600060400060005000005000200050607080003000502000500040300000408000501
10303055528330755860506050857452405048782530305070755080305280725020564060535036301
10707070000030700000502050000040007000600020506080004050300070006020002070007000801
10508080408080803565675056367050482740605480403028306220728027704066503024403086301
10004000308000500000008000007020004000500000202000600000300050002000506000808040001
10737238206655664745205672506047703040374755702060667437304768324560805823603060871
10200000600000000000200000706000008080000070005030000000807000000000802000003050001
10402050626887632050238440406634533060268050685232634760806064867446304078854070801
10002050000000005020800050600000000060008060000050000030008070000000006000006050201
10228065572484605540606080602845608547668060452065523072365830444375637027308022601
10003000006000400060702000605000403000000040005000000050004000600000008000407000301
10707667204030466030205826828030545082652584652627284280208065605727506080206530401
10500000700080800020705000000040007000000000000000000000508050007000002080507000801
17255375562230602280203674546286705076627038306465656776708080588030837550307282701
10000020000000700070600050000080008000005000800000700000305020007080004000300020001
10244060758238202030768040567080882653505850273640208734208052748088705058326040871
10400080700000404040008030805060006000800030600050500000005000300020004040000060001
10404060307220567040623070206085305050826080655020605522534580808744226050755378601
10706030202070000030200020302000008020000030007080408050000040200000006060005000801
10508430807038542820605360702245764027565255304040307050373420404263804287802045201
10500000800020000000400000500000000030000000002000600060000000700000600000005000001
11111111111111111111111111111111111111111111111111111111111111111111111111111111111
