11111111111111111111111111111111111111111111111111111111111111111111111111111111111
10000000000000500050000000000000005000000000600000000000200080000000000040000000001
14507723757530203053404056406270555056203240207675862760805040464772475020647632501
10006000600000406000707000200060005000400040008000000080008000300000002070000050001
10305050303765675370408020808066307320506022443030437074872525403036687070268020381
10200040300000000040807030603000400080407000006060006000600000003000200070700020001
10443840207527537020405020864520763060488640606073303340204564356370706585304548701
10700000500000008000307060500040005080000040506070003000300040000020200000007000401
10703747425875706425808030704060737034462050408088338050868020786070887272745740401
10708000800000303000003080607020600020000030403000007050500060003070000000800060601
10803080604220255080568260302040608220405580806245503072802046305072748880205040701
10800050006030000040004000802020308000800060400000002000002060005000700040008000201
10657525373030225038307073307040802038706020376744362272508630405230702076235055701
10000000000050006000602060004050506000308060700030002000505000707000804070008000401
10774482344074705680508084868076505820708060606030508040233027606082408022307740601
10000050003000708000706000008000500000404050007000200030008080003000004000005070301
10444070707584306047705362603720445756808027273885438324407088552633405475873080501
10003070800000006080005000600000400000303000000000300000005000000000300000005000801
10304050358326228080752070823744204050257472325570805844755622875460204264506074501
10204020200000008050000060004000005070000000000060500000200030000070800000508030001
10604060408062508757542638802073707035838757525046385280304060702040348080807040431
10303030007000500000000040502000806000000000008000000040004000707060006070605050001
10704048587530227262368040604570304537356344306288443080786442282076504030202880601
10404000004000808000002020600020400000000000600000202060700060002000002060200070801
10307048606036203088403060277070404582227320404320208034305050704822533020237064201
10503060008000005080508070008000800000005000600050203080008050800060000070006020001
12804440858220363020408072608026348426608064575840705030502047685080455326648030871
10003000600020004030405000004000500000604070200000805000307000004080800000000060001
10245064506052853030802266666570705770706030607357803088307467702058802087846048201
10705000806000008030702000200060203000508000808000006000408000700050004020007020001
10305080307574603020408070506028406086607382205040468640203530428530243230705820601
10003050008000800050004080004000005000600050500030000020800000405000700000503000401
17438064758020564573642022247327526750388020635666706070248572404035403033805088221
10000030000040000000008000002000000060500070000000308030200000004000405000406050001
10268850603083257554802487407088746050202055533660705080304455668580507820302027801
10000080603070000000400000500070002030006000800080202070004000000050004060602000701
10564070708570203740406540775350207070382636708030505024657070503060882050803820401
10704000500000203020200020000000402070004000507080205070000040507050007000306040001
10504063525468306070755857845674803022874040642020443020604480546058874467702060201
10005000008000005050000000000000306000000080000050004000500030008020000070003070801
10266460402033428030275460346450202542237346328037206385836050708060857050785050841
10500070704000700020200070007000600000700060007050002000007050206050006000400060001
10505044607650408050606053742035268730704030505880773086747050803033303566705824301
10005020004000603080207000200070006000604030500060200050000030206000300000003000201
16622040688076308050706630705572204068408040705080605830335340203480606248863450201
10003020008000605060300050005000503000005000408000300000400050400050303000000080301
10508042506320806680383032535060806078864464204087244783204080376050564034856080301
10507000300050004000702000000070002000000000302040005000004080006030003040008000301
10803860708057665077602076533367577337743740205650204040778745806025406050408076401
10506000607000002020004000008000000000000050600050300020700000205000600030603080001
10254077707063507050308580306074334676326020784050477483606550544250557377202550501
10600070005030206000400050607000600000003020006000600000200080007000600000003000401
10508378303070605650585080705740303238506054306724608020608077202050807876282050201
10408000204000600080003020400000807050007070800000008080504000400020600030008020501
10606030885054485050406050723556308080635060788073766650503360532070457080206080201
10006070006000003060507020000000507000800050003000004000800060003020206000700030801
10607052806825777050305030543786605858702246602077725035526067805030806088528250501
10208000600030000050402040007000700040002000005030000070005000507030005000000050401
10752050257030505470403044872040683040336080446320246330204532806077254824543460601
10006050802000200020202000004050000020008080008000500000400070007000500000000030701
15805050502726357020705485608072735553306030407038405453858030407580604223406050701
10208080005000700030700040003000004000700040303020003000406000300020800000807000701
10503088737350487520604020485238505058662250604020225040603830763060584050536083201
10308080000040300000206020000050005000400040405070004070300070003020002060007000201
10808050207040208448285027424050276380602330705028404570644043602035406028403077701
10004000703000800000004000003080003000500000805000800000200020007000206000306060001
10774863607268658785408328707077205050552487602050342537403388474250504554205070861
10400000300000000000300000203000004070000070002020000000706000000000403000002050001
10207030868666334070353220204544355020323080538625622740505084767284707078625050801
10005050000000004080200050300000000030002020000030000050007070000000008000003040201
10867058767563704670706030605338306467435050287076476027632650828674436037405067501
10002000006000200050406000602000704000000040003000000070005000300000005000804000201
10804427608040277080205875452020762028223556686283855870302056608563605040307660301
10400000200080200060804000000060007000000000000000000000603050005000006070504000201
15746734638780805640805782848838308088822087207465428428808020782040787480202785501
10000020000000200040700060000050003000008000300000800000608080008020007000400050001
10267080725838702050828080343020835765304470447620406842805077838082204027685080381
10500020700000608070008070805070002000200070700040800000005000600080003030000050001
10703080303230367080427030303045304080442080846040404738748830506646758060234376501
10608060207080000020800070406000004020000020004060508020000080300000002060006000201
10603570603056568740306860308743466027882828403070607040874270208686206776406022501
10800000600080000000600000600000000070000000004000700020000000400000800000006000001
11111111111111111111111111111111111111111111111111111111111111111111111111111111111
