11111111111111111111111111111111111111111111111111111111111111111111111111111111111
10000000000000600050000000000000004000000000600000000000200040000000000060000000001
13205345375650705058706028605450525054706570606266655650305020454446874040847825801
10006000200000503000607000400050004000400030002000000030004000600000007020000060001
10602060207432455720804080304088404840202054825040554048536484702075842060887020351
10200030200000000020306080207000500020407000007070004000400000005000500020700080001
10535470802882356070604020737850368020337850805037505370507256486240407537708537401
10400000200000008000205050500020003030000040207050002000400080000040300000004000301
10505382222476504278302050708080555036388030306085354040685050433060855345665720301
10403000700000604000005060405060700080000080207000003020600070008030000000500030701
10808080203820533050336620204030704730803370605584305062707053606085242630206030501
10800080005040000080003000507030505000800050200000002000008020006000300080007000401
10357546887030265065305058207040505027706060483764277324602740407450304063738064801
10000000000030003000506070003080508000707050600080003000608000306000605070002000301
10233743673076203870804088223024202560808080802050202050244072604077508056704270401
10000030008000303000505000008000600000407070002000500030007020006000004000003040501
10283070303755603078203347406280557487802038232544462354505077552727705224842060501
10008060700000007040006000500000300000806000000000800000003000000000400000007000301
10606030522374677050843030636776203020632246645450503444573846626760502625403088301
10503050500000007040000050006000003020000000000080800000200030000070200000202050001
10206030605064702435473358504025803032457732225044765620602050304030833060202070551
10205050003000200000000060606000705000000000005000000070008000706040005030508050001
10407032767780762563355040708480605836778637706648458060347727223027505040504360301
10508000004000506000003020800080600000000000600000808050600030005000006080400040701
10808046805085206046505030445020305522346750408840207022204050404338546080572032801
10602060002000006030406030003000700000002000200040304030006040300070000030005070001
17405450555660787040506037202066723483407046267820606060203084222070252776646060681
10003000600030006040705000007000700000803040300000604000805000007060400000000040001
10648084806072755030607878832640702470204020803566208045506368803042308062873074301
10703000307000006050506000400070807000803000203000008000207000800030002020004070001
10802030306733204060705030707023607063608577504050535780602470826750555570506570601
10006050003000500020004050007000002000800060800070000030400000704000300000408000601
13783035627070437243666078457753322840578080227382602080648888406037806076604035531
10000020000080000000008000008000000080600070000000508070200000006000204000203060001
10326530703045777233606574807078286030405047656660306020302633843750402230508067301
10000050205060000000500000700080002080008000500020506080003000000020003050608000801
10326060504440606540808870337840606070576347708080503085364060603040576080206650601
10806000300000603020800020000000603050008000403030304020000050808030006000606030001
10406078224658808020274743576558803058826030634080767040704730823056557587404030701
10002000003000002020000000000000805000000020000080002000400070004030000040008020301
10483730207027244020863340678220302523354248547088408586232050507050734050864060831
10800050402000300070200040003000500000600060003050006000004040702070007000400030001
10407078807640806020804026732084555680705080202540373058363030206035707636207732801
10003070005000505040304000700050006000306050600040800040000050503000400000003000601
12634040458087802030808280203734407025608030405060504230445620604770402583744520401
10005070005000603070800050006000203000003000703000400000800020400020506000000080401
10304027808520604460257084768070307033652468603042546328707070483030632042484040401
10306000200050003000704000000040003000000000605020003000007080003080002060004000201
10502470804047484024503063366735345272456770206850406030575852702082607040808035801
10606000702000004020005000007000000000000040600040300040700000708000300070406070001
10686064208028202080405650502062437733832050625070754887806350653530274243703360601
10700030008040703000300080308000400000005070007000800000800050004000800000005000201
10708828702030202670426020405530508477308038807754305050805066207070408487473070501
10605000703000400050006060500000403070004050700000004050205000400050300070005060201
10602030458053865080602020778655502020648040836054476570207620838020532060804070701
10005030003000006040606040000000707000700020003000006000500060002050305000300030501
10307085807358243040804060627642603743706687608088384064234072206030804053257370701
10402000300050000040206080003000400080006000002020000080007000603080002000000040501
10763070587060806420307058527020535040457040434350444650402444508076662644837270701
10005070305000300070203000004040000050004080008000200000200070008000300000000020401
18604020205532626040807724202067452768505020505038508827688060602230407378303030801
10808030006000800030200080002000008000500030303060002000608000800040600000205000201
10808045687280428240508030544537507034735340508060564070407670435080284020588083801
10802020000040300000808040000040003000600060304070008060800050007070006060003000801
10202080806030302637832085675030673740805850302055207480663027306037506074303088601
10008000407000200000006000007060004000200000205000500000500080005000605000404070001
10738675202874435245708486604084502030335425804040568736602766556770308776204080271
10200000200000000000600000406000006070000020005040000000708000000000403000005050001
10505070233658684050668230608566584020746020785558775780803056282423304057456020601
10005040000000005040200070500000000030008060000070000040006050000000002000007050701
10286054654382802820203030708264402783355050247036237055377440387583354027208063301
10008000004000400050503000503000607000000020005000000020007000400000002000406000601
10308227608070236020304587827040834042688764255673823730608023407726804050605330801
10700000700070200080205000000080007000000000000000000000402030004000008030506000401
18644285342250302380504667355837204044688023208422287478302020444080484450204226801
10000030000000300060800060000020003000004000400000700000603060003070008000200050001
10872070633856502030646040443020463234806280833260303754503058454056808072775030741
10600020700000707060002040303040005000700030400040200000007000300070002060000060001
10405070304430557040853080307025405060646040267070607783664520803722666050236225201
10402040804060000050300020603000005060000060008030803060000020600000003070006000801
10305740502032787870208320603542357067374676408050208070432650404676303643305082801
10600000400040000000400000400000000040000000008000300060000000600000300000007000001
11111111111111111111111111111111111111111111111111111111111111111111111111111111111
