11111111111111111111111111111111111111111111111111111111111111111111111111111111111
10000000000000500000000000000040000000002000000000000000600000000000000000000000001
17708827824820328380804582785036207063602270806023608270543070705433424246832347701
10003000000070000040700000005000504000700000708000307000500060702000000000000040001
10406246275020233020547265207850408370326853234480406053802880862020686367853080841
10405000800050302000600000300080803000700080002080403000003060003050000060008080001
10306080608060204464708020277070203054808058404050706388876060407083558430203060501
10500070008030005000003040306030008000007000805000300000600050400080000000800080701
10756065653730326050233050304028474730722820602773288340504465746780755376245050201
10003040000080700050006050004000000040000050408000000030400000000000600000006060501
10307260703033706062206075445833228050445070703020636040782245833228305526803740501
10800030804000003000806000000050000020004040003070008020003000200000607000300040801
10432020505884684860704673245520706287302055836033604027802080503520603060587075301
10005000603000000080400000007000300040004030000040708060002050004000303030008000001
18205543207080405042722824876044326030504030507480702080428020255078765070304485801
10008000400080507000008060006080300050607000200070003060007080004000007070800000401
10378870303830323043803030203070205220406222252788432040403050702857607050652550561
10000000700030008000400030700040002000800000000040000020408050700000600080000020001
10663453503022705484587430362320886070577747733030522684306058645450546538765480701
10000000204000500000003000800030600040800030400030000040004000700000200000000060801
10542550438830745424304062574040703437802030704488444020836280207835608742262085201
10000060200060300000003000000030400000002050006000003060000000805000604000700070001
16288680203080707074582287806845502770585053772068356030625525757030705060607330301
10000000508080208000000000407000300020006000002000002070000020007060003080400020301
10646836208030207727407320684040453076675530302534406068524070507054782050472050381
10400040004000600000500040800020008000000070400000303070000060508000000070300030001
12402040703748235650435320705854802036542067208450808085285450303664564374804055401
10006050706000000030000080202000008000002000307000203000000000600050007000003020001
10372080832076888034468054504070463583606280304088802263503642646080202080678070441
10007000600060007040002000503080000050005040302000805000200050008000500020008030001
10406388402070802070853850634027378030828050746370608020763027605043563284303023801
10400080004040700060000070008070000050700070000080005080500030003000000040005080801
10686060764070888244775030206030484780205488462028566260603430506244268040485050301
10506000600020000000000040604070200030008070005000000050800000606000000070002000501
10804724803042885645267720805070605058573070207033783030236344322065242870608253701
10700040608000000000000080400070004000008000308080005040004000000050000080400000801
10708030502022558588284030408033663270407524706020504042208784354540243050254270801
10505060006000003000005040708070000060200040002000606000500000000070400030000080401
10424040363536403024406080807060566078766080478758302880406353527060504077225070401
10000080007000705000300020207000500030000040000000407000800030000050608000002080401
10626257502046708030378660807543866230404526483760805068574380303522307733334030401
10800000408000005030005000800060000000200030000000807040000000508000008000600020601
10807520502778873734645088736070333336374540283837502070307776707035464080508530501
10006000807000500080007080002080400000000060002040003000400020608000003040500060601
10588036802050507030408040826040608076467065708030605340226030302322307057846080801
10008000500080506000200060006030002020003000007000200030307000703000502000005070801
10604740483670805657667675308062523220707866655766876050706060302070507462402070301
10400060200000400000700060002040000020600000600080003070508040507060700000800040701
10648070302888865470405020458060254080703840603050303080405028806030628830645020301
10006040208000800020806080000080008000504000807050500040708000705080000060003020801
14553040304080208020803056288276403076407038205080637880805860508068338056207030401
10003070305040005050507000400000307000504000203070600030002000507000405000304060701
10606070704040485430608350603520708620607830632070838073872272706630603070705420501
10200020804050006000505000508000404050605050003050007000000000800040508080200070401
10834780702077803088703046403034604080703050206077705223542420504060607020683030801
10600060505030004060004000002000007000503020400080600000000000606020504070004000501
10806050708032234050304663308842756252406080776870208224285476607030705063502478801
10504000706000002020700000200050003000002030000000400000004000004020605000400000401
10307445305388704070506560562060502073786073375670603655653052352030405662448070401
10204000803060003030502000500080302030007000500020407000004060500030600000006080801
10402340706020788060702027804570202070607760204020277058802020702870802665306050301
10607000400070000070204030008000302000400000707070500020004050200000700000706050201
10608086447842855220204058858060502572473282708065206350602080848322652270406880301
10200040005000000000308000000060700000000000208000008000305060000000003000400000301
10835560508040732238204483678588688875573560873887223080407068553383506023484875801
10000000500060800000500000300000200040000030000000004060508000000000208030003000601
10742646433840706250405460808370503040723062875730405030706578833320206083806030501
10000000000030203000500020004000403050700050000050500070700000007070003000002080001
10325530228730302028688043526070478040602640637057536760405584305050742745267087641
10000080004000502000007000400050400040200000800040000000400000304050000020000080001
10386068702027303582502768703263208680826550206730363486873370504087735030764720601
10008000208000507000200000200000404000700060806000500050000050800030000080000040801
16808570603380508070487860436320303080204087306023734030352460842470308263726022201
10007000500020808080000020000070604080402000706000008070400020004000800000003000001
10404037666050204084208053728060802073404460806073505020504067203066484680407867701
10206060004050007000207000004050007000400080005000602020204080003080000040500000801
10655077604046822480208836375047757280843086458660203020402080283040855058332070721
10003000407060000000608020000070008000400020002020706070407080600040400080007080001
13804420606030504225305060757320807050507355705030506060808080538630807660504082301
10005000805050300000500050000000402030700000002000800020003040008020200000808050001
10278078704030704760326665272442606050346628434522325662786078704030404474604480301
10002000008000700080000000000000800040000000000000000000004000007000700000800000801
11111111111111111111111111111111111111111111111111111111111111111111111111111111111
