11111111111111111111111111111111111111111111111111111111111111111111111111111111111
10000000000000400000000000000050000000003000000000000000400000000000000000000000001
12205382243860638640705376574024707063302720203068202330456040207527772833752252301
10004000000070000020800000005000606000700000406000504000500070205000000000000030001
10305765347080846030275532507550604660587685677580503038606540244060546755224040761
10607000500070403000400000600060606000300070003040702000002020006080000030008070001
10506050704070708424407030643030804058807043406020306576873060607046448350506050601
10800020006070002000008080707020006000003000207000600000800030600040000000300020601
10827062657480754050464060404076423330866240503823754330306544757260676367867040401
10003040000030300040002040008000000060000030807000000020800000000000700000004060401
10303380602048604054602067466855646030384080203020848020488287463726504666508270601
10600080406000007000805000000040000040006070002030007040004000200000707000800040801
10433020502842644220407878524770405558406022276045603066408050702630406060382078501
10002000707000000050400000004000200040008060000060208060004060005000205080004000001
18806227307050202044564537265063885020304030507740205030664030785025488040604648301
10004000400050706000004070004080500070307000800020005070004040007000004020200000701
10522480304680273078403040403030403380206274457462263080405070307666603050765550571
10000000800040005000600070600020004000200000000030000020708030500000500070000020001
10432583702066404428283730264820775060453265382040647345708077527840854332326830201
10000000502000400000005000800040400030300070300050000020002000600000500000000020401
10544780272870384784602078263050803763507060702522753020524250602223606325754028801
10000040200080600000005000000030600000006080005000005030000000406000204000800070001
14365660704070204024642235405433404880625087375047672080844257243080507020208660401
10000000508060207000000000605000400070007000004000002070000020007030005060500040401
10776546407070507337204570688070337065255380708425304078536030404065665050333080751
10300060006000600000500080800060005000000020300000603020000080708000000040500060001
17805050304683736740276830706482606052662043306250508053224370408433283323502035601
10003050804000000070000060803000006000004000804000403000000000200030004000002060001
10772050355088526038223024602050238324604440605047706523503545448080603040264030871
10007000500020008050008000203070000050003060503000507000600020005000600050005030001
10402328707040702030786520375086785040356050333720205080566022305072232277202064201
10200070002050400060000060007020000070200020000020006040500070008000000050003030601
10372060886080263766633040305080247250607677638027642420606520708552466020568030801
10802000200030000000000060205020700020003030003000000080400000607000000030008000701
10504752303028568322375230702030507084525070802034227020843676385054488580605655501
10300050702000000000000020500050003000002000503080008070004000000080000080200000201
10206080707064876685727030802024633380607558707050807065808652232740654040486540601
10603020006000004000003070806020000070400020005000208000300000000080600040000030701
10433060757345603063704080707030786077235060646757204240404457845060402035784020501
10000050003000604000500070408000500020000030000000403000500040000030307000002040601
10734758403075407030587720503373667360305467646260605066657550208322604776282030401
10500000202000002040007000200060000000600020000000306030000000707000006000300040201
10408870303542337742627046666060676235677770278756307070705848802075336020407270501
10003000208000600040005050002030200000000070006040006000400030306000007040800080601
10852027606030503070204050728060706027366076208020808640247060204278408025745050301
10008000300080806000800070003070006050002000007000300080706000207000808000005050701
10406680252240308276554576506052858840406347865545336030303030304060406264408060201
10500030300000700000700070007030000080800000800050008040305030404080300000300070401
10875050704858445750307020568060456040807580807080302030204083206040232730383060201
10002020704000300050806040000040004000702000207020500060702000505050000040006060301
14688020205080303070204074675888708038708085803050683330206580807083758024205060301
10007020807020005050504000400000702000208000704020500080003000707000404000303020801
10707060503080725680804740504330807760403540362050278036664752205370803030806780601
10500050504080006000502000207000503050808030004070008000000000500030302050200050701
10687630708038703022202057404078802080404070308062807556825740302060304020448020601
10800020205080004030004000004000008000808080200070300000000000307060205040004000801
10604050505026462020604846303667655654308040685750502724253445506080408032404325501
10604000706000004080600000400050003000003060000000600000008000005080207000600000301
10304777406275205020702550727050202063826073665720404687754058764080705285358030701
10202000806080007040405000600050206020003000800060607000007030600050400000006080701
10704870406020264070705078504870305050802480406030655058607070502880507663303080701
10606000600050000020604060002000806000200000505030500070002060200000500000304060401
10805054276362746640208083676020607533785245306033605640608040656834233270204580601
10300070005000000000304000000060400000000000308000007000703050000000004000700000201
10433670708030888382803644452864835764386480356684685080604082476887208066558473501
10000000200060800000500000800000400080000050000000004050608000000000403040003000701
10524864764470502620503620707870405070667058725340607020808622578520303048507080501
10000000000040304000500050005000705070800080000020800080500000007080004000006060001
10648560222640408027854044633070228040504560868086688840604747605070682773335087471
10000020002000303000004000800070800080400000800020000000400000206060000020000020001
10877063504036408478506667802888703850658480305480423556266460507075427060234530301
10006000505000305000500000700000505000500040804000300080000080400080000060000040301
18506760207880706040533360537540705040707086607067772070337680576860604855568046301
10006000300060506060000080000050305020303000702000003020300020007000600000004000001
10407087452070506028207063374060408074303670502035603050204055506047263870403345401
10505020004080005000708000005040005000400080006000407070605040008030000050200000501
10474027602028426720508365666057775830355075287550302060505060425020225037754050771
10006000208080000000208070000050005000300030008080604030806080400060300080008060001
13405770708060304368707080736620307080505227803050504040706070557570407330608048201
10006000203050700000600050000000203040700000005000300080008030002060300000303040001
10556046407050204270224272478287704040778525563584435442534028608080407475808430201
10005000004000200040000000000000400050000000000000000000007000002000800000800000301
11111111111111111111111111111111111111111111111111111111111111111111111111111111111
