11111111111111111111111111111111111111111111111111111111111111111111111111111111111
10000000000000800030000000000000008000000000400000000000500040000000000040000000001
15506784356230708036705057305730455045306330203862746460805060527677233060582444201
10003000200000302000603000600080008000300020002000000080005000800000008020000020001
10407080306526787270208080304034203840607085783040342043445382804085842060842050561
10700020200000000030405040306000200070408000007050003000400000006000300030500060001
10273340205342855060707060562330843020534860308053706440305442852460302363605458801
10500000700000004000808020400080002080000060808030002000800030000030400000008000201
10703325367325402464802040806030355087826050608087525080243050564070472476628730701
10507000500000808000002060703030800070000070502000002040800020003020000000500080301
10506020604250222070525550703040306520705240305638506046205073207054523720506080301
10800080003030000060003000302060405000700060600000004000005040003000400050003000401
10635525846060766084507025307020405074205040222733276556305540602750506057284057801
10000000000020002000508080003040304000704080800020004000308000207000805030007000601
10387674837047206280506048582053806630406070706080407020666044204082703084807620701
10000060005000207000708000008000300000203060007000600070007050002000005000004070201
10772080605448504087407653804340438874302026868643273862408033786375805273365060401
10004060400000003050005000200000500000406000000000500000003000000000300000002000801
10403070266687387030823030348246805080665263484620402428352342655370604453806083501
10502030700000005070000080008000004020000000000070800000400070000030600000708040001
10304060506076203844655635805023205025665642265036648770805020605080442060305080751
10502070008000500000000020408000205000000000005000000060004000605020007040703070001
10504027834870827834348030405220704354645242403633833050242223845055606020206670601
10306000008000807000002030300070400000000000800000206080400020008000004060300060201
10406057203035505053802040672070608334555270304380403034408050506786447060555024301
10306060008000008040204020004000200000007000200050605080005050700080000060004050001
18805250334320724020307032806072327267608087642430203020604045354040357526344080431
10003000700020002070403000006000300000808030700000802000407000005020700000000020001
10647027502087276080607352723240304830207060408782503083605835604083804026488066501
10504000203000005070305000700070305000602000708000003000702000300080008070005030001
10406070207685306030606060508056808075804577304020846680704250474650333280303540801
10004070002000800050007080002000004000200040700050000080300000203000400000804000601
16442042628020862577426036276767225720553060885882707060228284202085508083508082731
10000030000020000000002000004000000020700020000000207030200000004000502000707020001
10653530506084627472603487208047722020305068475480507050703672575680608780802075401
10000080802040000000300000500080004040006000200060204050002000000030003030404000301
10628040303840206670204550623330406030648588202040204047226040605080723030802860301
10608000200000506030400070000000408040007000804040804080000020206040006000203030001
10708022723664706080624377348286203035332050237030288040606720267036843464704050801
10006000007000003040000000000000406000000060000050004000600070005070000070008030201
10586420404026363080726840325870708326567666357057508526358070308020426060626020861
10500020707000200050700050008000400000200070008050007000007030502070002000500060001
10605088807260606020704055235078764460607030608360722054366020206058503473702648701
10002020008000405030808000200040005000503030400030800040000050704000400000005000501
14845030337023702080304660604674407066608030504070602550425220407530204767353720501
10008040005000603080200070004000603000007000507000700000200060200080608000000060701
10808053702450708560565044434080205047332776505025456628603070362050836045542080701
10508000500020003000808000000050008000000000704060003000002020005040007040002000401
10807280703088264053205085756228282442577570302320703040824685805022207060407073301
10603000608000008070007000005000000000000070500080600040500000507000500080403040001
10822056504054205050806830306034724725883040638050878847402650365560577665608480401
10400040008050404000700040502000300000008030003000200000500040002000400000006000201
10704877202080504450225050703270302784804086804684607080506022202080207558442070801
10406000708000400060002080600000508020007080400000005020707000700070500050002060601
10605070332033538070504020845354407070548080248023767720802840484030626080205080301
10004050003000007070807060000000503000300070006000006000300020007030207000200070501
10506078302624424020707050777346502442803262208043422067686043807060508063827380401
10707000400060000070804060007000400060008000008050000070004000808060005000000060801
10288080642080607780502083773040564020633060654880758750208775503047475365375450301
10002080702000400080406000003030000030007030002000200000700020008000500000000070501
12304020606276353040804877403045252372202050503086507638485020506680406862504070701
10306070005000500050700030006000008000500040706050005000206000300040700000303000601
10803086747730686430302020682455404064475670204080542040203640372070473080627028501
10203020000070600000502040000070002000500030507020003080500030005020007080004000201
10206030204070707637662037364040646480307340404046603430738067204065407078505082401
10008000502000200000002000003050005000400000408000400000600060005000802000307030001
10353763606853585253708276302067404060255323804070677422206624624740505633607050341
10800000800000000000800000402000002060000020003020000000208000000000604000002080001
10208020724474468070277650204742423020778050532784778480506038674572708068275060801
10003070000000007060300060300000000040004050000050000020003080000000004000004040401
10352053487254208350203070505556403835485030244047354037227220724663672034404085701
10005000006000700060405000604000607000000080003000000050006000400000005000206000801
10703727705050465030606684657040768083336782347674838530305057307347805050202830301
10500000700060300020405000000070005000000000000000000000604050004000004040404000701
15668384245360705850802577665483604038358086207454366832603050234040356850507586201
10000050000000500070500020000070004000006000700000600000605030002060005000300050001
10362060277535405030344070725070868225207250736560804275802048363035403027582030481
10500080600000708080005080402060004000500030700080300000005000500080008060000050001
10707050604640842070262080308036508080257060747030404863764280504854467070356258201
10704040404030000070400030306000008080000080002080306040000020500000006060004000501
10402770507055457470604780408533678054652858804080306040358750402457603423802035201
10700000400080000000700000800000000020000000004000400060000000700000300000002000001
11111111111111111111111111111111111111111111111111111111111111111111111111111111111
