11111111111111111111111111111111111111111111111111111111111111111111111111111111111
10000000000000200070000000000000002000000000200000000000300040000000000080000000001
17507754282360607036306088707450785038603840508522725220508020688835888030527226401
10006000800000502000703000200020002000400070003000000080003000300000003080000060001
10405040303555852730706030803064206280702043622080535044873243508047336030642070521
10300070300000000030206080408000500050208000003070004000600000005000200060400030001
10365340506232468080805060738640424020227330403024808280603832583240503828804246301
10700000700000003000804060800070004080000040605060008000300030000080300000007000501
10408632883773403442802030803080263027563040706023743070286040553020554567224220701
10206000300000604000003040805070800070000050503000005060400040007030000000800040601
10508070507530666060588550204030704580406440706466704054804087208045786770605020201
10700070008030000080005000704050806000600070600000006000002050008000500030002000401
10383237785050778087603048506040604064207060727577387552504440807770802024763053401
10000000000030007000807050006020304000203080200040002000602000803000203080006000501
10226273367034505550606046554038407550505080602060502070766088308044304085306680301
10000020006000807000307000004000800000804060003000200060006030003000004000007040501
10374030202754202075403687508670328362706022648235243723503065777335205887225060601
10002080700000005070002000400000200000704000000000400000002000000000400000002000301
10204070866662744050874020738446808050474454778650308458373742773750502762305053701
10305050800000002020000060007000008060000000000070200000500030000080800000402070001
10403050707073404647722325806028303023577522372054223640304080202030575030508070861
10307050004000300000000020703000808000000000007000000040003000704060005080704020001
10606034768630686787284050602830203233745426804375575020226428384043204040306330401
10502000002000207000008030600050300000000000300000405080300020002000008050400080501
10406056307055803087508030236040307277752680308230708082408070502283738020638056601
10706030005000003030708080007000800000005000200070605080007030800060000070008060001
14808340782350453080803083508035444467603043654480706080206068435060828477663080521
10002000500080006040207000006000800000306080700000306000405000007060200000000060001
10454024506026525060406236667750603870402080407543606054703337207075805053545064401
10704000707000008070408000300080203000606000703000005000707000800020006050003020001
10203020706538308030803020803025602085804526403070547560607640734550666640805880601
10005040005000300080006040004000002000700080300030000050600000702000500000406000401
18543076664030426746835023863423755850865080367226808050872245805042602043704024831
10000070000080000000005000007000000050200050000000307030400000005000808000707060001
10475350608043837836206663407083335080602046426640207030308768264670805550805054501
10000030304050000000600000600030003070003000800020402050004000000030005050407000301
10567040805750804230808420553270406060538384603040307083852030307020685060607630301
10503000300000502060600040000000506050003000406020408030000060302070006000705080001
10203024876668507070427283244454707078455050335060353050805870563046252676602030201
10003000007000008060000000000000606000000070000020007000800050008070000070006050201
10845330807045642040374370264670604524653424563045703276878050807050855070677040781
10600070804000200030200020003000700000700060005080008000007040506070005000300050001
10405036507620303050805088464082267220802070207730444068462070505062203638607744201
10002060007000704060302000500080003000702050400070600020000050504000700000005000701
13454060223066803070705770405488406066706050804080404380253230302280306748684370801
10002070004000806030800060005000302000002000205000600000800020500060802000000060801
10802047705780404830583068854080807056267857204037343783205050334030683036532030801
10808000500020008000206000000040003000000000502080007000003060007040003040004000701
10502830404037648064403088764757424572544730604420606070523687606084507040806022201
10805000502000003070002000002000000000000040500020700040500000208000200020607070001
10726052508046705050407330603045352527346020667050685227204420844220336433708230301
10500080003050203000600040303000200000006060008000300000400030006000200000002000301
10805368404030307630636040807540604558607033704683406080703047308080503457323050501
10202000508000700060005060400000604040007080700000005030402000300040600080004030801
10603020872026337040508020636455808080225040538027766460608440434030684070708040201
10008070008000007030804080000000606000500040006000004000700030006030505000300050701
10305045505263585030702050455342802626506273403038554086564026802070407023287650301
10207000300020000080305060006000700070007000008040000020007000204080005000000080801
10327080888080806430307033684050727040277030556830568830307535207064646475625350201
10007080408000700030502000006060000070004030006000800000800030005000800000000050601
14303060705585744060206286806055658744703030402024808423847030503450402285605020301
10603070004000200080600040006000005000800050504080003000406000400040700000502000301
10504082387230335270808070545728604046533420505030327070508320754060347040683033301
10604070000060400000603050000060005000600060708060002030400070002030005050002000501
10402050202050602668375037868030448240808370205075802780663075507073704083608062401
10007000503000200000008000003080002000600000704000500000600050003000507000202050001
10328845706578863668706328702078504020852352703050545257802272877720703884507060481
10500000600000000000200000805000004080000050008070000000504000000000205000008060001
10504070464478352080683360502627378070862060855584376520203078377248605073774050701
10004030000000007020400050400000000040002080000040000070003020000000003000008030401
10374044236846302820404020503487206663432020864072735054887580832356462062605063201
10005000006000800080708000702000306000000030008000000040002000800000008000806000701
10308277604050876050308644324040428052858527676777635580405088703633703070504720501
10600000700060700030602000000060007000000000000000000000504060004000003070407000301
12858328373540205470404586434572508055463058503686247867603040743070677520504273601
10000060000000700050500070000030006000006000800000700000503030006020002000400060001
10574040588565805080475030588020336534605770834750605253504085525076808064546080231
10500040700000607030005080708020008000300030600050200000004000700020005020000020001
10408040805320387060573040206032708060673060835070307382832340307443585040876382201
10802080805050000080200050204000003020000070004040804050000030700000003070008000501
10304880505032657450806830804468463068825684308070304060833870302236503387706076201
10500000500070000000200000400000000030000000007000200030000000600000200000003000001
11111111111111111111111111111111111111111111111111111111111111111111111111111111111
