11111111111111111111111111111111111111111111111111111111111111111111111111111111111
10000000000000300080000000000000002000000000300000000000300080000000000030000000001
17302422673570506047503028502860324064805370706886354320806050675774524030757345501
10005000800000404000708000200030002000600030004000000050008000300000002070000050001
10206030503345242520802080804037202860805054772070574025476275407078345070224060261
10200050200000000070606060803000600070208000002060007000800000004000500030800020001
10722650704237785020205070443750633060263250506078208520604374468230504424506426201
10400000500000002000607060300080002020000050302080007000300040000020400000007000501
10805437662568207785305020807030455025474030704023562030876050454020562356725760701
10207000800000605000002030404080200040000070302000007020300020002070000000700070301
10306030803520876060682560203060704770306560205542507027208075807035625620602020301
10800020006030000020007000303050502000500080300000007000008070007000200060003000801
10575853265080683077408028803080207037603060878832378822308860702740203026477056201
10000000000080003000607040005030304000305080200060008000202000505000306020002000801
10732888883037503220802063338083605750707060608070204030238075303076602037603840601
10000050005000305000504000008000200000708030006000300040007070006000007000003070501
10226070408853204077707475206320264354202073675283248777403033724244408523522040701
10002020500000006030004000300000400000703000000000200000004000000000500000003000501
10802050875827278070648050442638807020665482338380302332243624484440603254306083401
10702080700000005020000030004000007060000000000080400000200080000030200000503070001
10504060204054807436266736803044704027257675827078585750805020505030375030602040241
10708080007000500000000020805000607000000000007000000060007000706030005050207030001
10206067337660587576434060706330304422883322503273763050622732348028206030608680301
10605000008000308000008040600040200000000000700000702030400060003000004060300050601
10603084803044607076804040387080305686752540205430505022302060304465578060773088601
10402020006000007040208070004000700000003000400080603020006030600070000080005080001
18503520375570332060608086402023643673405065785720806070605038553050358553683050651
10003000600060008060303000002000200000602040400000204000206000006030200000000070001
10332023802035433040607227758860306570806020506862706038508635704065703063525053601
10505000502000007030605000500060708000306000204000003000307000500020003060005060001
10703080304454307050808070705032303086504337405080863840707430622430368230708680401
10003050003000400070004070006000005000500080500040000080800000403000600000705000501
17623085584030825872772026436634884480454040824277307020433248708078405024508033571
10000070000020000000008000007000000050500050000000806030400000002000406000306050001
10374850506073234256205222302052368050805065852740606050605287255330707230408022301
10000050707050000000600000500050004080003000300020304060004000000080007020505000501
10253060504550704280805280762330604070624855705060603043678060306040248060808360401
10307000600000408020200040000000306020006000207080504070000070608070006000705070001
10403078534834405030663336378883805088285060653050627030802860443088658848602080401
10008000008000007020000000000000704000000060000060004000300020004080000080007040201
10472260204043346030857220575230208354837466543074808677748040508050287070378040541
10500080203000400080200080005000500000800040003020006000005020307030002000600020001
10503058304830808060602046233067442350508050605350266075757060406062202738407683301
10004030004000306040405000800020004000207070300040600060000020805000600000005000201
12868050757054403070708570703683404054206050806080308870528230704740207325722220801
10005060004000208020400060007000406000005000405000500000300040700080707000000050201
10606078504240805860344025472060707082383582708074548542806060336070474086722060501
10305000800040005000707000000020006000000000802030003000002020002060004020007000801
10602520305077253055402034845564882637552720307740308040472282303028306070705057201
10308000203000007060007000006000000000000030800040800030700000406000800030307040001
10454037304035305040804350605032882487647070663020546756708280645360256384707530401
10600020002030808000300070404000700000002020008000500000600040005000700000002000601
10708527505040704480822020406840806854303022307486804040304036408060308366723030601
10808000307000800030005030200000603040008070300000006060407000200030700020007020701
10204060753057338050708050832483808040472030828062746640507420646020274060702040501
10005060003000008060404050000000603000600050006000007000500020008050806000500050801
10506045305544652020708030747832406286703277302047547088435023306050504035634650801
10707000700080000080402080007000400050007000007030000080002000806070002000000060501
10438040277050405330805077366040226070253050832550386270808688604066354357386380301
10004040302000200020605000003030000050007060007000300000800020007000800000000050201
16205020504656578020204587502047236627608070506056206647326080806660803732306080301
10408080007000400070400040006000002000600070502030002000505000600060400000305000601
10702083876350577750704040537855702052562550605080355080806360663080567040433082801
10307030000080300000402020000080008000800080605050004020200070002060008020003000301
10708030507080604736654077367040323660302850307072204880822054206023806032407032401
10003000704000200000005000003050002000500000202000700000400070005000303000805030001
10565545808628386657702628502073506070524276206020883784402558774530602648302070281
10700000800000000000300000204000003030000050004040000000208000000000603000008030001
10608060363265462020252530302763654070572080374638658820503052642447302037488070401
10006050000000003060400070700000000080007030000050000040006080000000004000006040701
10326036465554506860305030304674204554656050648047284035723220635442563033302032201
10006000005000800060608000402000802000000060008000000050002000600000008000202000701
10702837505050655040802464832050765035525772855873457370505062806432303020808850701
10800000300020700020307000000080008000000000000000000000607040007000006060702000401
14358475265670603360806366686338504033627036706847436465804050478050453430807723301
10000020000000800030700060000020007000006000700000700000302070003040006000500020001
10355060225727802020857030258080426854505340456830503425304086836073505046824040231
10200070800000706020007030205070005000400030800040600000003000800060008070000040001
10807020507480772030265070407063706080278030427060408484223520304355374040336443201
10705020305040000080500060304000005030000070007050803060000060400000002020007000401
10304330605034347770702420603272888056534864604080406040568380608282306675407027801
10800000400080000000600000700000000020000000008000800070000000500000700000006000001
11111111111111111111111111111111111111111111111111111111111111111111111111111111111
