11111111111111111111111111111111111111111111111111111111111111111111111111111111111
10000000000000200020000000000000002000000000200000000000600020000000000040000000001
15608872264760302033808027405470626024402540803287247780606080543776852060824748401
10005000700000505000408000300070003000700080004000000080002000500000007020000080001
10605080304574428620402020607068407370307022537070285028852663803083656030574040861
10800040500000000070206080802000800070804000007080008000800000005000400070500040001
10462750704652357080806040275630343070437850305034402650607633886330203628703673601
10300000200000004000807030600070007080000040504030002000200060000060300000002000601
10802742455234806482304040702040857084264070502067528080623080425060864826856670201
10207000500000202000003020404020500060000040708000006050700080004020000000200040801
10403020204330522040858850506040702270803380202738704064504072805043422860805070401
10600080004020000050005000508020206000600040600000003000008030003000300040006000701
10884432226040276077707037406080806035604070765454684247406220602280802067442072501
10000000000080003000204050003040706000707080400080002000703000804000303080006000701
10733245258054706730308054252055608360204040308030306070763038602035207044802350401
10000050003000406000708000004000200000508050004000200040006020003000008000006050301
10383020802576703036405657406730477733304086236475787688508077886754203843836070801
10003040300000006030002000600000500000602000000000300000006000000000300000002000701
10806060488323273020772070782268205050243287244420703323348535526840405527404038601
10808020600000004070000030005000007060000000000030200000800070000020200000203020001
10302070807043606587326656407032507047436733447084246370707020607030342060202040581
10208040002000700000000030704000805000000000008000000030005000808020006050405060001
10302055338560858683667080502530302246322657402235622050655444383032708030508780601
10506000006000207000002030700030600000000000700000805050200020002000006070500050301
10608074603028802046408030753040408723865250304840202086407030202584482030422085601
10805080006000004050508050004000700000004000500050702080008060600070000060003040001
13505560257370774030804057808037452283506064575480605070207023346060562328822070871
10003000400080003070702000008000200000202080200000507000305000007030500000000060001
10855048207086644060804888827850208770603050808545708052806256402044403084237078501
10307000208000002020308000800080704000608000307000002000203000500050006070005080001
10403020304352408060503070807064702037203424708080388780203270547680726380706450601
10005020006000500050008040004000005000400080700060000080200000607000200000407000401
17362032858050863445545036523883244440656050683538203060482238604075708038603076861
10000070000080000000004000006000000030400020000000703050300000008000507000404030001
10438680308073588783808843403062774060805038262220805030603253738760504730606044701
10000050506050000000500000600050005060002000800070506050002000000030006020502000401
10844060406850602770606850587420407080847276307060208048447030308050434040704320501
10805000300000203030600060000000702030005000807040704070000060306060007000402020001
10403047283654208020222537483762307022764030547030877060208360485077355555805030501
10002000007000003080000000000000308000000020000030004000400070005070000080006040701
10732640803076357050236220735420805246337224733035308764556060502020582080872050271
10500080802000600070800070004000300000800030005050008000002050205040002000300080001
10308077708580704030605036748076375820203060803780662063523040808032707652507632201
10006050005000706070308000600020002000505040300040200060000060702000700000002000801
16554040445048407060406560703773506075808060606070806450753350607340203284437270801
10007050003000304060400060005000502000003000704000700000200070400070503000000020601
10403085208730805370362086844020206066588268504075582624507030456070362068668060801
10605000400080002000706000000040005000000000204040003000004040008070005080004000301
10505480606083748076502065468273585867454430804670408020345428802056805080406025201
10308000503000007080003000002000000000000060200080200080300000605000300080708040001
10222052206036708030405470803045756745842060542020328365207740535650675782602580601
10500050002060807000700020203000800000008030004000400000700030003000700000008000801
10605788803020704850274020702350302228806065307384803070805034304070406564537080501
10207000708000200020002040700000603070005060800000007050207000300070700040006030401
10807020835028835030806060432245602060757020442077736670808230485040244040707020601
10008030005000002040706080000000802000500020003000003000200020002080707000300030501
10704078408542577030605050638248505833602542808037575035665068205080505085855770201
10403000600020000050302060003000800030002000003050000060004000802070004000000030801
10328060342080305270205055288020728080266060353430854340206258402054842285525740501
10003070708000500070204000003050000030008040007000700000300030004000200000000080301
12605050808632754070408435207062744833305070805083505438885040508360602776406080401
10306070006000400080200020005000008000200030705080005000602000700030300000202000201
10402054547430335420203040786258305074444880602050888040303620342080342040633078801
10205080000050700000303060000040008000200050608050003060500040008040007030008000201
10202060304070805236545032836020325330705580305048304430758078405053803066805083301
10004000408000200000002000003080006000300000608000700000400030005000604000407060001
10236372308843228285307488806022306060584855702050278466206667544280408447802070651
10200000200000000000600000407000004070000050005030000000405000000000404000008080001
10606040858388264040844650806387737060283050364557576250403022423274603022672080301
10005080000000005030600070200000000020006080000050000020005050000000006000007050301
10383068258263506720203030702867308325354020448058364037224260686883277055704043301
10008000003000400040202000203000503000000040005000000040004000400000005000402000701
10207277203080387050606767535060264065622777488286264530502056508846607080608550701
10600000500060200060707000000050003000000000000000000000305070008000006040507000301
14785372336330206350805367286724403056536033607244372322705070688050665740204262401
10000020000000400030400070000050005000003000800000500000507080008080005000800050001
10844020644527807060765030332030432775403680273730404672502025484074305087476020671
10500070600000608060004050605050007000600080200060400000008000700020005020000020001
10408060606750626070284070203072705030645030267030205382745760203847662030322286801
10403040207070000040600040207000003020000020002080607040000040200000003050002000201
10704680607025823340303630307463835075323468308070405080576540507363805365804078801
10500000600050000000500000300000000030000000006000300030000000700000800000008000001
11111111111111111111111111111111111111111111111111111111111111111111111111111111111
