11111111111111111111111111111111111111111111111111111111111111111111111111111111111
10000000000000800040000000000000008000000000200000000000300040000000000040000000001
13503758643850207082303036306220757073707530206385872580307070763738284070226777801
10002000400000308000603000500070002000200040007000000060006000700000006060000040001
10702070403635663750507040706042407760503067355080586063444828603077344080644070281
10500070600000000030406040603000200050603000002030002000600000006000800060200070001
10362780706425457040605020742260645030265530508065406660302278636540404433205578201
10200000400000007000405020300030002060000060202060002000400020000050700000002000701
10807458732345708268808070504080423065587040605078588080782060236050756347755250701
10505000500000504000007080402080200030000020607000007020800060003020000000500040201
10807060206250478070535360505080508670308380505635802022205057708035855220605050501
10500070003030000020002000707080406000600070200000007000005080005000700080004000301
10253588848070737072607035604080403076303050355338228445707770802680603035336046201
10000000000030005000704080002030305000506070800060004000302000403000602060002000701
10857845275052307570603082438028803650205020507030504080837057606063702024407850301
10000060008000403000204000005000300000205030004000700040007070005000007000004070801
10433020405722306066703357504240384522602083256887445778607076437684307787626070301
10006040800000002070004000600000300000307000000000500000008000000000300000004000701
10706060672336435020565050853662403080383785383630502445584657723260802667308033701
10602080500000003030000030004000007080000000000050300000800080000040800000703080001
10804080402047605485757788803032402064766753263033637240605050604060486080203060371
10305080005000700000000040603000407000000000002000000050005000606050002060302030001
10505064383430237778255060406350403665772636705675345050756737536066805080803770301
10602000004000408000006020200060600000000000200000806070700020002000002040800080501
10206077403085706057805070268040202248253780203720203068707070204455662030687082301
10502020005000004040604080005000500000005000500040305040004070300030000050007070001
12702670477770325030205065702022253535404022554350706070603053853060427376527020251
10004000700070005020603000007000400000702080600000702000607000006020200000000070001
10472074706027364040705365586340802230302070307882808032307452504033508066252036201
10505000707000007070603000600050306000805000606000005000302000600080005080006050001
10307050206553508050206070404087203085602642808040364440203580782880773870404440801
10006020008000200070008040005000003000600080600020000040800000202000700000603000301
17368042758050322384364024476563353820465050554875504070377344803078402088508075741
10000020000030000000007000005000000080600060000000305070200000004000606000204080001
10486720303074378456803728605077762050806065538830604080704433557440307540308077501
10000060604050000000500000400040007080005000600030506040002000000030006080303000801
10453030605360607430507250585880408070647275403060605055862060604080882070805460201
10405000800000606020800060000000505040007000303020206060000070303030004000303080001
10703025478264603060463356842685604042647040562030484080702620342063527654804070701
10007000006000002050000000000000408000000030000060005000700020002050000040005050401
10225870304047838030827830663860807463227282674064403682244030403080857040757060351
10300020202000200020200050006000800000200080002060004000003050603050004000300060001
10805062302360808050307038456056733830307070202620348045576030204064502563502227601
10008070005000504060503000500060003000404040800020200020000020607000600000003000501
13547020376088205060504830308324706035606050305080507830236750405440304256244670201
10004020008000602070400020003000704000005000805000700000300070700020206000000080701
10805068304230805480636045334060205043735365504082777847504060327040622075562020401
10803000600080007000705000000080007000000000403060006000002040003040002050007000501
10602270702055788024407033527563885886278380808470306080654763804074306080308064501
10707000306000005050007000007000000000000060600030600030300000404000300020706020001
10548066606067503020508840206048732754884070276040822245603830525770762788406580701
10500030006050803000500020808000700000004060007000400000300060004000300000005000501
10303583305030807320333030308620708374804022703528605050604065702050804585658020201
10208000307000800080008070300000403020005060200000004060408000400030600030006080501
10703050842066336020502020456258407030874060727026542860208270563070554050708040801
10008050003000004050402060000000604000700040005000005000300020007020702000800020601
10203075302845373020602060262373703653702285403056423037234026505080503032877650401
10204000800070000020407020004000800080005000006020000080006000607040003000000080301
10485060385070303620608084547070274070472030746780667530304732705044748565434220201
10006060406000600080205000005060000050004030006000500000600080007000700000000060401
12608040702546483050205324404088347575707080504053708482758030206530205567205020801
10602030006000300020500060002000008000400040605080003000407000600040600000202000401
10207042738480458540208080567658204045342430703040425040404750326070873060525063601
10402050000060300000307030000040002000600040407070003030400070004040007050008000801
10802080608030407232445068532020833730508820302053704580437074703088806044306075501
10006000205000800000003000007020003000800000702000700000700040007000603000605040001
10482557804442275646507658204064605050876636706070546263304845722240308528808040871
10700000500000000000400000705000003070000070007020000000708000000000505000005080001
10703080543283238050722720804288477040455020365785834450406063532733705048857030301
10006020000000005070400040400000000020005030000070000060002070000000004000004050401
10524038535568705680402080602453404557578080672022247075242850584768423034703055701
10007000002000600020706000207000803000000030005000000080002000300000007000508000601
10408277702050623050607253766030842056887384438284832750808037507254505020308770201
10200000300060400060303000000040006000000000000000000000308020004000004070407000701
17356782276250405340802853854835706075447073503252625743207040863050224340803635501
10000080000000800080600030000040002000003000200000600000306050006020003000300070001
10858050655278303040486080752040233678806420227440503332608044534053307083847040821
10200080700000408080007070204020005000500070300070300000006000700040003080000050001
10503050504360327030686070508085404080272050244060803772456520408474756040262887401
10707020303020000040400030804000007070000020007040503020000020500000005060006000601
10804570605062445350303750808383837047348722507080302040354620403788706662304085601
10200000600050000000800000400000000070000000007000700030000000800000200000002000001
11111111111111111111111111111111111111111111111111111111111111111111111111111111111
