11111111111111111111111111111111111111111111111111111111111111111111111111111111111
10000000000000800070000000000000007000000000200000000000700020000000000030000000001
15605562367840208042202064703580733075505470705542342220406060766842253020745775301
10006000500000502000404000300080002000300070004000000030007000600000008020000070001
10306020508373368870404070804043205220406025544060577054657327403046448030666050651
10600050800000000020205070604000300060305000002060007000700000005000400030600020001
10345720604436787040404080383480622080745820306065208660606232648330205645704242701
10400000800000008000407070200040005080000080208080008000400030000070200000002000701
10808683476753808526407040702070828033282060706042887070668080384080334234784720701
10406000700000206000007020404080500020000060607000003050400070003080000000500040401
10504050408780573080342230606020708450205270404587705053208048803036474340802030701
10500040005020000020006000508020302000200020500000003000007060007000400030005000201
10677488357030525042202087703040302053702020283225765478704340808250504054288085301
10000000000030008000607030006030407000702080500040006000707000705000404020002000301
10855423856046204660507066468034207880407080807020505070654034405082607047206660801
10000050007000804000404000006000600000507070006000700080007070002000005000006050801
10455050403752702063405537502880444567408087566237222443602058775523705863368020601
10008020300000007050007000600000700000705000000000300000007000000000400000002000601
10604070662647885070587080786323705060667374337440804275748636575480204666804022401
10508050400000002070000020006000002030000000000060500000800080000030500000605040001
10507030508038602373246723603047504032638222367067356460507020706050564030302020321
10305050002000800000000020306000205000000000002000000070008000706040006050503080001
10703066454660273455626070203520706452872385205448357060784575345062405050505370201
10804000006000603000008080400070500000000000500000505040200040005000003040800080601
10604076604077403026407030575040404264743620607660207033406030807574487030328083201
10705040005000008080805080008000700000004000600050404070005040800020000080008030001
16204670472550574030403032705085745727802022757860802080704045476060245523548070331
10004000200040005070302000002000700000303050700000504000504000006080700000000020001
10753072702067666020204753835340506660405050505577605055303585706033608078756064501
10506000407000002050604000300060306000704000706000003000506000800050003080007070001
10708020502882706080404080204088508072803643302080732820408420842260525620203540401
10005030005000400030003040005000007000300020300040000060200000507000600000705000401
17886058822050554586866035754284646660573070226228503080746254204053805024302065771
10000030000020000000002000008000000050200030000000206040800000005000206000404050001
10862530406068674566206266304046335030408084748880407070504565323820807280602026601
10000070703070000000300000600050002080003000500070803040004000000060005030508000401
10353070803550308570308380767860305080585342508080806047872020704030735020706660501
10802000500000503070300080000000302030007000704070605020000050206050008000703020001
10302028433877507080224478683663707043726080748060863070802580854046656578605030501
10008000007000006020000000000000203000000050000030005000400040005070000030008060701
10646780408084843020338720568620208665475325338086204465726030802020248020577040241
10400060204000200030300080003000600000400050007060008000002050503020008000600050001
10605024307370503020603022265044883480505040202230378056753050503025604624302242601
10006030004000702050308000300030003000302050600070700080000020308000400000004000401
12375030787034508020508860505436502064205050808050705350687570805870808888677850301
10007050006000703080700020005000404000006000208000400000600050800070506000000030201
10305073705260606570276068286080802034485762605046822858304070486020848028843020501
10803000700020006000804000000030002000000000806080005000007060004070007040002000601
10203480502034525074806038674334343243872320205650208020283878706088308050705053501
10508000807000002040007000007000000000000030600060600030300000807000800070203040001
10477033205024302060407630403033855638537050328060457248605680753720627462603260301
10500070006080807000800070708000300000006020004000700000700080003000200000003000701
10206235307060606540837020408780605643802048306655802080203048408020808685385080501
10406000207000300050002080200000305030007070400000007080604000400050200060003070201
10508030846046687080705060574572506030734040884067248830502240876070763020704040401
10006030003000004020402080000000602000400020008000003000200050004040208000300030401
10507032708752556060202040284872308744804732506044443057574084507040402045326530701
10706000300030000030408070005000300070007000008030000070006000606030003000000060401
10375030552070707360402078585030346060536070445770258230408746303038665225256880501
10003050505000400080608000008050000050003080002000600000500040007000500000000080401
18403030305637837060304422208068376355707030406085703522546050604670504747808040401
10707020008000600070200070006000003000700020406050004000204000200070800000507000701
10208054666580255370407040724745404067426840305080364080304770827070827070422067201
10607040000040700000806040000070008000500080708060004020500080006070007020004000801
10707040706050405752845076668080478370306620803065706570684087606055308025202037801
10006000207000200000007000006050004000600000203000600000300060005000308000403060001
10258878406886382228405466203083404050857888705080753536603728563270305244604060831
10800000600000000000500000503000007080000050002080000000303000000000407000005080001
10606030234567652020555470704887576070455070557742256280406074533335605063384030301
10006080000000003050700070400000000030003070000080000080004030000000004000002070201
10527034234578803640403020705228402682526030265047734032534630762637676044205023501
10003000006000700020604000808000205000000080002000000030005000200000008000206000401
10603544306040682030502887586060557087544427364382456360405023706825305040402650301
10700000400020300080707000000050008000000000000000000000607020006000006040707000401
15338337358350708480706864343842705048462056205878767388208040686080232760703566701
10000060000000300070500030000030005000003000400000400000703060005060004000300060001
10836080844673405060535030557060453652607820233260204428308024358082204084485070581
10800050500000602050007040503020006000700030800080500000005000400020004020000070001
10203030402270227050856020507066402070387080685020507424253260204675758050655232501
10706080702070000060800050705000006070000070003070705030000030600000007020005000201
10606640302088737840603240502243777084336387603060202080424330803766402637702072401
10200000700020000000600000300000000050000000008000400040000000200000500000006000001
11111111111111111111111111111111111111111111111111111111111111111111111111111111111
