11111111111111111111111111111111111111111111111111111111111111111111111111111111111
10000000000000300080000000000000007000000000600000000000700070000000000080000000001
15407654655440606043706034503270454087408830303226445360807070533787478070323338401
10002000200000803000403000800050004000800060007000000060006000400000003030000080001
10404030505257757550205030407083406380407087753030722072824786208068536070687030751
10400040600000000080408080706000600020203000005080002000500000008000500080200030001
10625730404752227040305040875480842050568230507075404870608282234770305743608833201
10200000400000003000703060600030002080000050502060006000400080000080400000003000601
10708552747865603845407030403070588028573050405072225080873050672020247576844330301
10204000600000604000004020305040400030000020804000006060500060005070000000800030401
10402040503340342080587820807080605750806460803443207052808052206046666260504030201
10800030005070000070002000508070208000700080400000007000005070003000500080006000701
10876747352040684087504053603070505054607080628656448778706370605320705066526042201
10000000000040004000604040002050506000804080700060003000606000203000203040005000401
10847628256075303870604023733023606550308040207020702070447074303033308083702640801
10000030002000504000205000004000200000405030008000700060002020005000008000004080301
10226030604745406087707474303530786278303088227378876286407074443568502544825020401
10005060600000003080004000800000200000402000000000400000003000000000300000008000601
10406070424385238080267060784742302050656322634260803732872876665220608554702022301
10608020300000005050000030007000002040000000000020300000400020000060800000808070001
10804080403048406258638333507033607044354534572044847270804070805070237040304050651
10603020008000300000000020804000403000000000007000000020007000802040004030508080001
10407054468340435734655050608430504337768347502675784060462882347046506050703280601
10707000004000406000007020200080600000000000300000802060200040005000005030400080601
10605076605088308032702040583050408573254870306530506037503080307687288060462042601
10408040005000004020602060005000400000003000300070602020003070300080000040002060001
12404870563520483080806042608056434728408052645260502040604026857050736455558020431
10005000800080006050704000005000800000207070800000406000704000005050500000000040001
10848037506086345070308866258760504470606050802878605073705855208068803023885045401
10204000802000008030508000700080306000208000806000004000806000500030004080004040001
10802040304756308050403060705054402052307858405030835520302360586640284880406760301
10008060005000200030008080007000004000500080600020000060800000403000200000803000301
16837045332080357565328045336488267220634020742485203030262373806024605088208085281
10000030000020000000008000006000000080800020000000605070800000005000805000703080001
10226730704075762346704676808053383030304047384350505040805366634270406780704028701
10000080208080000000500000700050002020008000700070502040003000000060004060206000401
10243070607320805350605420862750707080735667408080203085436040802070435070404280501
10606000200000207020600030000000503040004000407080602080000060605020008000602070001
10406025558457208040883563252354308078567050766070834040703880736085452323802060701
10008000008000006050000000000000408000000060000050003000300020008020000050008080801
10382320702036582040227830247530508335686338436026705483232080704080867060268060471
10700050402000500070600020005000700000200070005030003000004060402040004000700020001
10808053607420802040803078377084432860206040603570732053244080803064605866606377401
10004020004000207030506000200040004000805060400050600080000070504000800000006000601
12747070533085603060203570603732708042306070704070702570457360502220205266524620501
10002030002000405020300050003000606000005000504000500000200030300040608000000040301
10205057507550802220378064734030503088274585502033737838202030856080228065265030501
10808000400020005000307000000080002000000000402080007000003040006070006020007000701
10505830204074364062605082757332854445232320704870505020322246303037206080808042201
10703000602000004070003000002000000000000070400040400070800000804000300030502060001
10564038308068308040704750504024423532566020355080654523506380646540685648704540601
10400060006020608000300060304000200000007030006000800000700040006000800000004000601
10308488202030504730454060206870506832802038805648403040407026407020704788652040401
10506000204000500050008040300000504070006030300000002050402000500030500020003080301
10405080823064872030206040865234806060884060453025577270505750263060843060504050501
10006030002000003020808020000000307000300020005000003000200060005060804000800070301
10808083503582678030305050234883308474507865704058473043427036608060208075488840201
10703000400040000040603050003000400040006000006060000050008000408050005000000060401
10867030822040306270207054275030885080362060247450827270207472807023633353627440301
10008050704000300070808000008050000050007040006000300000200020004000600000000080801
13308050303338365040603425602045833566407080405083407385433080505840204236604020201
10806030004000400080200020002000005000400070203020003000708000300030200000303000701
10504084743360532420403040855623206047843620508070475020308250252080535050788063701
10708070000080500000308050000070005000500020402070004040400040003030003020003000501
10805070205040502687633065562050384620706380204053303470577034504078408077406048501
10002000602000400000006000002040006000300000406000200000700050004000505000804070001
10385634506258522442608542606034206030525836608080657478804862742460503453807030671
10500000500000000000500000407000003050000070002030000000702000000000802000008070001
10708060743735343020838470404875322060534020572263565580806086728844705053564080801
10002030000000003060600050300000000070002020000080000060007080000000002000005020201
10454077222383304280506060705668207658242050545067226022735560456367332027705065801
10006000003000600060305000403000502000000080007000000040003000800000003000603000501
10303524207070282070507243662080584062875247687477387840604067502834605080802320601
10300000200080400020406000000040004000000000000000000000204070002000007040407000801
18656388276240406560206327426544206076838042803656454748502020658030282860305285701
10000080000000500020300070000080008000005000200000500000403080003020003000400070001
10836080782647202060837020528020857272708780574640506678702033636083404067277040561
10600060200000404080007050707030006000200060300070200000004000700020002020000070001
10208030508440488040688050703027502080674040658070306288423270805762342030362685801
10203070408080000070600040607000006060000050003050503070000070600000005080006000801
10503450305033746330505520302364874057447774404030403040673360403625702448204068501
10800000300030000000700000600000000040000000002000400050000000200000300000004000001
11111111111111111111111111111111111111111111111111111111111111111111111111111111111
