11111111111111111111111111111111111111111111111111111111111111111111111111111111111
10000000000000000000003000000000500000000000000000000000600000000060000000304000001
14207248886837278020843050608538406065346772305044304680406772502040506060806030271
10000000000000002070006060203000702030000000208000602000806000605030503060306040001
13652852548585502067208070305060203080444340803060504076308076202050378070202056301
10002000000020007000400020400030406070003030006070407000304000003000500080006000501
10423020556040205870873560444280202288402060434050864350808762306736803054836836201
10000050005000806000700030405000200000400080405050005000400000300060005030500000001
10486368406730438030856060505038525040655050405064205065424070505860607070302036681
10006000700040600080400050004000005050004080006000408000002060205000607000502000001
10502024738030505730307058662428205042806650367625304087202570303054884763204073501
10208000300040200030407000000000708000700070003000008020003000802000005000002000601
14304830407374857088608744464880808763626040508028846440367020805834606074585230301
10003000800000503000300040008000800080000070805000200000500030600000305030000070501
10678050728020204670448040706050635060464880507630802788207270503483308050606480201
10000050003050003040002080700040008000800070803000400000806000300060006040705000501
10488343203578423060608020706887304260504480302048786760205775876060438080837088301
10004000300000200060800070800000800060500000605000200030003000008040000070000030001
10408030273850206053863020422340877020246852706040702082483055406575702743645880301
10700040008070005080003060200020700080005000007070005000000040704000600000007000701
10244460605070664550203360506020608635572078244870364832582780605030603386206037621
10000060300020500000508000704050300000007050000070200000000000507040500040008030001
16282060842760504228402030338050738262808050208045702623456033508670874030708070201
10200040800030700000300040400030000000306070807000302000002000400000500080307040501
10504440402040778450585777305288234283605080706230303053502060227776203850505080201
10202030004020000040000000008000000000308030200070008000304080000000802000402000801
10507055583060465038873435506074254840406050403036428230304820224578408028308485701
10003000200020700020000000203060000060006000503000000000800070006000507000600000701
16225520308830202070203850756075774035607342307254263738354033326030303860568560301
10000080002000504040400060006000004000300000800000000000008030000040304000200000501
10637026245328608830304060302836403640355080337885274878702060705370585028576628501
10004000003000600000706060200020300020004030005000000030005040406000400080000000401
15205534506060843724603044654020467066608066703047276220555030422037202083337740501
10004000500030000000807050000040803000008080706000005000306050006000008080008000501
10286020846222308230302050432730503075246070503440606060606065302268546520507085801
10000040007000502000805060000040504000004000300080600040703000208000700050502000501
10876478256050558020203042607080404023502255852070322547607043605030306080608550801
10000000300030005080806000407000604000700000003030400000005040002080002000800060401
10463644702035505020705540804243306380804637408062404383237050677050657460286080301
10006000405000305020600060804000007000702000307000600060004060000070000070300050501
12257030704250607065857060674074283870508080603060827034502056405526336040303650501
10000050700050503000004050003060000050306050008020007000703000600000400020200000701
10305320737080504485204068503077736073804028266788302540402520825720808020545724201
10408030008080800000203000602000003000703000000000300020300000800000608040000000401
10803030408040777750802440207360405570402550652850462060804285705665506035356885701
10300030400040500030004000500060704000500020008000305000600050005000507000000080001
10302840378870305082536047425035804022543060603046507067485780324670407780246050731
10700070006000608000006000002000002000606020203060007080000000200000800080003060001
10856663304058604063308884208374788730304030705050456020547528204084377030746070201
10005000706000008000505000604000000050800070305000700060000000305030000040700050801
13602020408080662450205070203034435050223685807450708447434080504020238268802235501
10003080006070400060600020404040002000700000300040500080003070002040000000300000201
10363028858054205020302250404020406033402470873067267066305083787060638520453760301
10007000003000806020306000400070305000500040004000800070005080007020000040600000801
18403036507430603740532026424036605250863077706640207750803020302056353820305574701
10003000700070206000600020006040005000400020005000700000202000203000004000304000601
10805240305060805075503053704050485077506030766085368764604276204828702083704070601
10205000705070002080008020002020003050005020000080000000500000700060002050004040001
10736085505085223030453820604047404270666063845230342740402460323070464084456032441
10200030008040000080000030405000400060800040000000404000200060500060500060000060001
10406560462070553880834060403420387060405840204350702022522620404080304250507280301
10300080400070400060007020700050005000400000800080600050000000703050700060703000201
10354060607586502026554070855078408028487682722030254560856463604080367050645070501
10807070800000204080005000300060003000600030002060000030700000003080007060000050501
10307030882680404420304452672240522050305070307085354080403337373587604025233233801
10200040000030400000500000000050006050302060400020003070700000300050005000300000001
10604386265640207856865685334042807030446040235587206030578234305020474750604843731
10800000500000405000000000600060308030000040400000400040000060002000800020400000001
10204580402448205050533650507840305036507540803670806866568060456243404020286688301
10500040300030008070000040603000404000604040307000600000008070008000806020000000601
10302080728067374035804060302088204780208060706025742468258063204070606050723720801
10605070006000005000807070404060003000800070003050500000004000800030605050002020201
10405062704523502640883060605020372080623764283060608033507060642840305026507060701
10604000700000400060005040006000300020000000008000508030004020002050606000700070801
10807270335640364076603058276875202266635573805045402080777837406080707780802720201
10703040000080004000007070000000300000002040008040602040000000600040502000700050201
10802040404027206325248320773680282536506070672070408757427570373420608055757030501
10600050504000500020000070000080000000408080008000800040000040000000804070000020201
10358770725330274050688030528074445824202048202672687050242056255376702085243240401
10200000600020006000400050002000000000004000006000300030008000000000008000000000301
10834785606082252466574826367447572355233883734080837366386258866426253385365542701
10000000003000000000000000000000000000000000000020000000000000000000000000000000001
11111111111111111111111111111111111111111111111111111111111111111111111111111111111
