11111111111111111111111111111111111111111111111111111111111111111111111111111111111
10000000000000000000007000000000400000000000000000000000500000000080000000502000001
12302647472253625060842040602255202063643668208042202860806374404080404050205030841
10000000000000006060004020706000302050000000304000205000305000408020503080708020001
12654863354623507078408030608080707080347860502070607037804026506070653040203048301
10008000000050003000200030600020704040005030008040706000606000004000300020008000201
10858020276080707730357830383650502484608080373020732220603347802474303024282536601
10000070007000405000600070205000600000700060404050007000800000200020006070200000001
10372363805680246050684080405078453020465040704068403058482040805720403030306032861
10004000300040400020800030007000007020004060006000506000004040502000505000705000001
10702053682070404660804077626553408075206230822658706066506770606056477237607086301
10704000800020500050607000000000603000800020003000002050007000706000002000003000701
13808830304545327067408574827730807265683050708067684530666040308268407045682470601
10005000400000804000300020002000700050000030503000600000600070400000304070000020401
10526070653030708670278070606050578080267840506680703637706270607245502060606820401
10000020008050008030006050400030004000200070807000400000203000500060008070404000301
10572537704228552020402040806844604560203240402068768880808628683030455030536074801
10002000800000400070200060700000500020200000603000200060005000007040000080000050001
10607030237520303036345050885750437030335645705020602066366076303547205747678750801
10200080006070005030002020300070300020003000006030003000000040307000400000002000801
10473430703020664780203240405070407773446082466770844446766680303070703623703074841
10000020500020700000507000203050800000004080000060300000000000202080400040008040001
17643080833330303865704080546060566834703020305047504755727026408870623030402070801
10600060700020600000400040800050000000404050805000608000005000500000600080508020601
10207680708080552830448887307662362856303070508640302073607070238773205630804020301
10807040006030000060000000003000000000803030500020006000805030000000703000807000801
10702084354070453025473468502074774270407040704088885750304380333874702065306347301
10005000700060300050000000506070000070007000506000000000600070003000708000400000201
17263260607320607050808850437027834025707454204372356672346064887050506320547260201
10000050003000405060500060002000007000700000400000000000006050000050303000600000601
10338088543625806420602070605543304450555030745358584426607020808270435023583557501
10007000003000600000705050200020700020008030003000000060002020707000700040000000401
13505855704070648358802073253070726043406055407024825820256070853066403053225740501
10006000800080000000305020000030502000002060406000005000603050002000002070007000301
10435040543354502240307050338740602035374060607580306030803034605236262880806055601
10000070003000605000503070000020205000002000600020300020802000408000600050705000501
10245762625030822030703074306070703048607832335030363234304052307080205030306450301
10000000200030008030603000308000207000500000006040400000003070006030003000600050401
10855672308084302050808250507652304420206554806086208443583080522030546470677020501
10003000303000405050700070306000006000307000806000400020007020000030000080600050701
18557030508250302076555060556033535420205060604070328073807043305275433040308640401
10000050400060803000004020005060000070407030008060003000503000800000800070700000301
10203350737030508435805022508083782044506045333885407360608440683660505030835288501
10203040002040500000302000506000003000407000000000600070500000400000206040000000401
10508070502060548650203240402350505760808850838870525050706344707323603057265534601
10600080700040800080002000300060308000700070007000806000600050005000408000000060001
10305470228530702088828077465028706028338080402076702083677830255580702770234040421
10800070004000705000007000008000005000208040206070004020000000300000400030005030001
10483353708055508067204233808872827330305060602080262020554764704055366030874080301
10006000304000003000506000706000000050800050603000400020000000805030000030700070401
17604040703070768750302040302047236040256538607250704265832050603070536254705784601
10007080008060800030500050805050004000700000500020600020008030003020000000700000201
10437087447072208040806730303050403033604830832048878034502034354060445240288630501
10003000003000208080406000400040805000600030005000300080008030004040000060600000201
14705024706640503650438088728034404440646076308240303270703030706067777670205348601
10005000800030208000200020002030005000700080005000300000805000306000005000608000401
10705320507060802058405028705050453033802080354025286885607665804228308043407060301
10302000603070002060008020007080003080007020000050000000400000500030002080005080001
10383063402025787020463830707054502680837086777240583470304730638020466088388025521
10800020008040000070000080705000400030700060000000603000500060500060600040000060001
10207820486070323370458040302840744070504240803540307035687750408070208720704760301
10300020200050400040004070500020005000300000200080700040000000302030200060203000201
10674020202486807072475020555085808087264848376050366680734474504050237040288070301
10305060700000207050005000500030002000200020004050000070500000004030006040000030501
10304080866830304740404547863540357080302050603032574050208468428625608085676672801
10800060000070500000300000000070004050505020700080005030400000500040003000300000001
10402668235630703566275736728048708020832080676538404060754853605050575870602257341
10800000800000805000000000300060305080000030200000400080000070008000200030300000001
10603760606356703070583770307740507052307230803230502422472030886285207040448434601
10500060400080005040000040602000506000303050606000700000004060006000406050000000201
10603070423084524043508040308087202820706020608037826438243075804050206020536650501
10508040002000005000404020708020005000200070004060600000008000600040405070006060501
10507048503476506780473030707020667080257772676050403048406020282360307085405020701
10806000200000200060004040004000500040000000005000202080002060005080307000400050201
10806670867830343033804053442742608522335633607086503080667778802070404650303240401
10504080000060007000005050000000200000005040005020704030000000200080407000400040301
10208030506084705547674870635250735757303070273080605673773350652760405076636040501
10300070406000300030000030000050000000405070004000200050000030000000706060000080701
10874450542580885050538020674036665827402035505564384060553065888757505045337220601
10500000400080007000400020005000000000003000006000200050008000000000006000000000601
10523632603052865366865477462232665626223335267070752888652586564582626336436272701
10000000004000000000000000000000000000000000000050000000000000000000000000000000001
11111111111111111111111111111111111111111111111111111111111111111111111111111111111
