11111111111111111111111111111111111111111111111111111111111111111111111111111111111
10000000000000000000003000000000400000000000000000000000600000000040000000606000001
13304257844876442080686070404838602086258627507025603560807333702020405080706030271
10000000000000004060006070405000508050000000308000502000205000504020507020208020001
15828232762865405044804040802080302040333430302080604028403077506040548050608037601
10007000000030008000500020700030206060003020002080705000304000002000300080007000201
10373050887040403570828230222670406888305050345050575580806777705564504056348627201
10000040002000703000300080505000500000400070503020005000600000400080007080200000001
10782833805620627060242030602035284040854030404028303062582040407480808040705072861
10005000300030200080200070007000005020002070002000604000003040408000307000708000001
10208048237080205580307073464888803073705320775746708038606260202068582877305066601
10702000800030200030704000000000807000700030004000007070004000708000008000007000201
14703580208852752076305678426720308348355080506046227740347050706464502065676760501
10005000700000405000500060007000500040000020802000700000800020500000606020000050601
10476030256070203880472070304030386070434630305240405742307750408824302020705820201
10000040008080004030008070700070008000300060808000300000707000200040005080505000701
10556353507565754080203040202688502220807870702077638870702424574070462030237035701
10006000500000800080400070400000200060800000703000200040008000006040000080000080001
10704030466380603028475080363880858080837876403070603054473087402368606576386550701
10200060006020008040006070400070300040008000003020004000000080403000700000003000601
10436860805060838570308430205030603547647084327240787758843530703060402648702087281
10000080200050500000607000203070200000008060000080200000000000803020400020005050001
15642050285840205448804050568080774684204050304048308787858043306680446070206060801
10500020400060600000800020500070000000408080202000408000007000600000700050405080301
10808860303020255740434856804265646646304070607360206026802080454867803240803060801
10307040002060000080000000007000000000202060500060008000806060000000204000507000301
10606065578040383057788477206053636840506080704073365780203230335438505047504248701
10005000300020500080000000406040000040005000707000000000500040005000306000200000801
16337550404650707070807480765073386037407842705566225436227055885050404740367560501
10000020002000503050600030002000006000800000400000000000008050000070206000500000301
10323055784864204550706040807535507370823030227884768656605050304570563037777424801
10007000004000500000807030500070600060006030005000000040008020503000600030000000401
16208564804030833573508036627040487023804056604054383470434020852043606086584680501
10007000300060000000507030000070204000006050205000007000406040004000007060003000601
10266050462566405740705060683440508042458060608520608030302074603576277570806062801
10000020008000607000805070000020306000004000600070400060408000308000300070408000301
10648672886050432040206058703050606027706648646030475345804075408030704060804480301
10000000700040002030705000708000806000700000006060800000007040003030007000800070601
10833372703063305070602850608364803840304356802065607378848050522020634460758080701
10004000602000306050400060405000007000205000507000500030006050000020000080400070601
15656060607280708052556040474024328730406040608070578025807052208544268020706740401
10000020200080605000008060004040000030805080008070007000702000800000300030600000401
10407820763050804328303083404057338043803058778746607370604220856640703030836723401
10203030002050500000306000305000008000306000000000400080500000200000506040000000301
10208060703020476830603680505720206380302360473870558020706534402722605047382384401
10400030800040200030007000400070306000600040005000505000500040002000803000000080001
10706830862880707075358066488037804032577070703028605055762660886430606820852060871
10600050003000203000003000002000002000207030305020005060000000700000600080007080001
10773437704063204064802433202443588570202080205050574060486384206058426070772020401
10007000508000002000202000205000000070800040808000300020000000505070000040200020601
16705040407070637670206060404035476070262228706360608825525060304020383276605658401
10004080005040200050300040706080006000400000600020300040007030004080000000500000701
10684062572032408050603850605060704032503270457066345042406068784070684880626850701
10003000007000502080804000800030304000600060005000300030007070005050000030200000501
14704068305620306460375045738042307570484038205650802230502070803072426340404752301
10003000200040303000200080005050005000800050005000500000507000702000007000708000201
10204280805050404054408025605050632043305050786033258734704668808536806024603020701
10806000605070007050008040007070008020002060000030000000600000600070008060007020001
10568025707048374050587460506063208660557048648460858230203680644070764024243023761
10700030006060000080000020306000700030500070000000705000400060800070400050000080001
10207280223060262440665030805720663040306550306480804032466880408080406460308320301
10700020300050700030008060200030005000200000300080200080000000305080800030803000301
10563080706436705047623070533066608084424746422030257840872486705030584030533040501
10208060300000802060004000400030005000700020002040000050400000007050008020000030801
10407030466580507680804228544330572030402040703083657050206475647723403022722243801
10200080000030200000700000000080003030603020600060008060400000400080003000600000001
10506648757750305248853224547066804030453080357823808080874722208080487270304348451
10600000800000202000000000300040708020000070200000400050000040005000500030200000001
10303440408753702020338830504640208055605780402470705583283070824786203030427388501
10400080500050006020000020807000308000204070407000200000007040005000206020000000401
10507080236056354042803030404052305380304030304025535282858053603080306050588850301
10405080002000008000807040602080006000300030003030700000004000400040604060003050401
10808036805463204260438060506080678070875262478070306077408060652460505052702080601
10203000300000200080003060007000800070000000004000306070003030007040503000500050501
10305860727870362044502075643586806853428474407076808020733245205020404250504680601
10503030000020006000008020000000700000007020002070705050000000500060704000600040401
10505050707065604288222870828380473584802030584020708454755560776750603052346030501
10500030505000800050000040000050000000406080003000300070000040000000306080000050401
10637620722360885070255060373052686722707056708448628030736044856834307084448320301
10800000400050003000200060006000000000004000003000700060003000000000004000000000201
10565453206046443344376624886225862862728786323060253343262653423747836533785873701
10000000005000000000000000000000000000000000000070000000000000000000000000000000001
11111111111111111111111111111111111111111111111111111111111111111111111111111111111
