11111111111111111111111111111111111111111111111111111111111111111111111111111111111
10000000000000000000004000000000400000000000000000000000300000000020000000603000001
13307367823432652040462080506753204062364424605072306820303333708040805070508080531
10000000000000002020002080705000805060000000808000502000403000403030705050804020001
14788744422234306055602040706030804070785240803020604035306075305040436020505042301
10002000000060003000800070700020307070003050007030808000705000002000700020007000601
10587080258080606450843660678250302348804060667080642850806222502782704053426564401
10000020002000303000800030707000600000600060603070005000700000400030007040700000001
10577334704340622030248080602058787050656030303063807056464070608750702080203047481
10006000200070200080200050002000008030002080003000602000004050203000502000607000001
10308068648060305280707052678253602036505840557362203045402320806087688233203048601
10302000400080200050307000000000207000700050004000003070002000508000007000006000701
16605770608535478025706865774850603532754060708042274350768020808238806025284460201
10005000300000608000400050007000300060000020403000200000600030600000406080000070401
10744070548060708650537040606070332030826680202780404475408660705682806060307840401
10000050006020005080002020400040007000600040608000300000503000800050002060303000801
10767645605477837070503030707485407760704870506062656280508852836070653070745075801
10007000600000400080800040200000700030500000404000300080002000002020000030000050001
10606060847420503087652040534730528030836223802020403053252066603876705375375220301
10200040006040005070005040800050400050003000006030006000000030506000700000005000701
10227480803040853840503530406020806558642028678570772747855280404050704686605058441
10000020800030700000505000806080600000002030000060300000000000504060300030008070001
16662050625630605354802060345020838468306020208063807328835034604260526080208080301
10800050700070600000600050700060000000802020608000802000008000200000200060404030701
10606260608060267830442866204344562773805060802660702065408050288352605470708030301
10208080008080000080000000003000000000505030600040007000508020000000503000807000301
10602035575070575026345562405082365570208020608085545830505820346566604022305438401
10008000600070200020000000804030000030008000304000000000400070006000703000300000501
17855320308560502030502430363055823077504637303734584737453034358030307670765350201
10000050008000203020500060003000005000500000800000000000007030000040802000500000401
10764048466765305340308040507745703770338040843328623776508060808820363085274257501
10003000003000400000802050700080300020008020006000000060003040708000600060000000301
12806836803080275663403046784070846025606023807056328730787040273036205046437360501
10006000500060000000607030000040207000005050203000005000305070004000008030002000601
10246070465663507750208080383850804032644020404740504080803046303458867250702046701
10000040008000505000306070000040606000004000600070600020808000808000400020504000701
10572227252030883030607057203040202088302837255030324842304064202020505030402550201
10000000700040002040502000502000302000400000006080200000004070008050004000700030701
10342586203035706020508350702467302520607278602053708574465060532040565350832080201
10004000705000207080300050404000002000804000207000700080007080000080000070200040401
15653080704260207066327050364053778450308080507030573044308085504445442020707370501
10000050600040803000007070002050000080405030007050002000305000800000400020400000501
10305580372040708266303032302036223074805043727242503620806480866420402050246458201
10704020003070500000404000403000006000806000000000500050600000200000802020000000501
10608060302030653750605520805470804850603650333520667050503746804374606036266786501
10500040700040700030002000700040203000400060004000705000800020008000504000000070001
10408720563470207073784086237032803078373060208064308076855540673750504240338040241
10200020005000202000005000002000008000408060305050002050000000700000400020007050001
10367526404086605038504865802368575660208080805050255030787622203087374060335040401
10005000803000005000803000302000000060800020207000200020000000806060000030200020501
18805050504080378820705050705046453020487824406360602443335020308070873878802377601
10002020005040500040400080506080007000600000700080400070003080003060000000300000501
10742025563046602070203280308030603055807620748046452067602024466070556740853660201
10006000004000402050702000200050503000800050007000200060007070003050000070700000201
16605053804220703350466044642062404550663048602240205230802050207035243870504274701
10007000800060706000400060006070008000200070006000300000706000708000007000706000401
10402240806070808025503033806070438047502050443024548472705545606325503077802040801
10705000503050006020004060003080007030002040000030000000400000200050008050006080001
10874058606077725040237760207046206660576046784340345720406250483020576074277063651
10800040008020000060000040808000700070400060000000805000700050200070600040000080001
10402580676020387480835070707470834040705660404350208072372370808080207330403760301
10600080700080500020006020400020006000700000200050500030000000407030200040805000401
10564060604685204045644060484087707074887266877050488470784335603060845070865050501
10705080600000604040006000700020007000600070002050000030600000004080006080000050401
10304030682840508430702576523280376030305030802024854040507233277344705025664382701
10400050000060700000300000000040008040606080600080006060700000600050004000800000001
10608652852230404288743885353073506080458050358567304030773464506030377850807564381
10200000800000605000000000700030304070000060600000700030000070008000400070500000001
10205830303358203030746550702630604082302540807250605263554030452428708070368764201
10600060700070006040000040504000208000205020806000600000003080008000802070000000501
10308030757048383037307060408026406730703040806036226328482034502050806050585550601
10304020007000007000604060802060002000300040007060200000003000700070306040005030301
10202076406646703670423040208060626080338738243060804074208030757350404025808080701
10508000200000600040005020006000500030000000002000502050004070007070807000300070501
10605740423560222073804068563736602382478636203085603070266788508060407350705350301
10206070000020008000003080000000400000006080003040403040000000500040406000400050801
10208040807083807388778230257820635745403030667040807567756350657740706063347060301
10300060505000700060000070000060000000208080002000300070000080000000305030000020801
10577850222770837080324070242065672758703036702528758070437076355747207023274820801
10600000300040008000400040007000000000007000006000600040007000000000003000000000301
10488843304073383224326286327223234856342478776020762672346356565674766834728363501
10000000007000000000000000000000000000000000000050000000000000000000000000000000001
11111111111111111111111111111111111111111111111111111111111111111111111111111111111
