11111111111111111111111111111111111111111111111111111111111111111111111111111111111
10000000000000000000003000000000200000000000000000000000600000000060000000403000001
18305483554887858050423080603442803057756852607022508730404847503040804080808070641
10000000000000002070007050202000808030000000504000702000402000202030707020407020001
16682265654678608087202070604080207070657770808050807024603074308080488060503066301
10004000000050004000800030300030304030007070008060402000205000004000800060007000401
10753050442020408270872370466520308473403070387070844540507465503482207073224537401
10000040005000508000400020502000300000800020302030006000300000400050002060400000001
10773532706820767050876080706068736030738020702063205087735080805320702080708052251
10003000500020500080700020007000002080002040002000302000004080304000403000408000001
10602067442040804870206043775746604026304440546387405044202520404034245532306078501
10702000600070700020303000000000706000700070007000006030006000402000008000008000401
14606830706485336053606668457860204746443050705062553330845080205565207026755830501
10008000500000208000800070003000400030000060804000300000200070600000308030000050801
10467050456070408720653030702020355050385650506240302842304770305537504020403470801
10000060002030005030003080600080002000800080606000400000802000600070003060602000401
10838665806532243050404040603486403230705630307063276650408464337040265030323027301
10003000300000200060500060400000200060300000808000400030003000003040000020000060001
10204050276440804073473060655870348050574348206020402038733072804452506878477360801
10800080003040008080005030300080200050003000005040002000000080505000200000002000501
10744260206020622420404720605080403233542065428430838367275260808080404762605084461
10000060600070700000405000805080700000007050000050200000000000708030400030008040001
18487060253870802732303040752070243634807070607073307584577084605760583070808020801
10400080200030600000500050300050000000304050308000403000006000400000400070407060301
10605880803060328750536463704387558672605020602840406067602060367468203370607030401
10805070007020000040000000007000000000404080800030003000704080000000705000804000301
10505043373050238064763727304055587360204050507068422530808670248244308065506555501
10008000800030800050000000807070000080002000506000000000700050002000707000300000501
13863830503870408050406630373056424074602575805327888863438082455080803240485540201
10000050004000208060200030002000007000500000400000000000002080000040704000600000201
10277032722757507830307070302736504640333050724358355538603020208350245052362777701
10008000003000600000405050800080600070003050005000000020005080408000800080000000701
15805736605060635762306034735050355065402074403068283680328050383027608056865730401
10004000600020000000404050000080802000007040602000006000506040004000003040008000201
10588040746425402370505060454670608085236050503430408050704052504346435420707047401
10000080006000204000707050000050408000002000200020600030203000207000800020507000601
10373567887030473080302084503030208083505237878020446864208087508050808070706520401
10000000600060005080705000604000604000300000002040300000007020003070008000600050201
10467827806086505050803380607828805520303523306085504268533020346080886380586070601
10003000205000403020400060708000007000708000507000400060008030000030000070400050601
12532060608740803062385020885055467220602030703080487066804043208548268080606670601
10000040200080408000003050006040000050804080002070007000703000600000300080700000801
10502650454050306326704022306077775047202036448422602470503880238770404080825835701
10502020003020700000405000506000007000703000000000300020800000200000208020000000301
10208050807080484460507760807640203620203870253820838050305228204846506077652544501
10800020700040800060004000400060506000500080008000506000400020003000804000000050001
10703220825840707042236084248067507052357050206054803084556870467750603420524080561
10400050004000803000006000008000003000805040505060008070000000600000800060002030001
10854572805063805082602728304654655840708050502060635070783522805048348050454060401
10006000302000008000305000606000000070400030708000300040000000807060000020500040801
15803060203040476830708030504072375070526843303680207735572050505020424373404562801
10004080005050200020800070508020003000600000200070700070007070002060000000600000601
10454067574044802040606520707060607026802740424072478063606062576050855820233280501
10005000004000305070308000800060506000500050007000300030008030005050000060500000301
13606044503220704720854065573038304330223078605830604560502030204052255430804867401
10008000700050803000600040007070005000600040003000800000505000402000003000604000301
10303380705080403068503066702070228033503080848027272248203283703366208083202030601
10603000407080008060003040007080004050007050000060000000200000200030003060005070001
10667026207075672080477640206055804230323077737880667760604840362060252078532076221
10600060003040000030000070703000700070400070000000402000700030500040700030000030001
10408440583070455340833060508640635020504770207540706077233270408070603430504570401
10500030300050400020007030800070002000400000400040200060000000605040800070404000301
10327080405673507073487070842077707046735483266020276430627325404030462020328030601
10204040600000206050008000800030004000500060005020000060200000006080004070000020301
10803060624860405450206766657450762030507070206086742080707334822566402084588876801
10500040000020600000700000000030008020306060700060008070200000800040006000600000001
10802844843560802287364433475087702020638040675765803060386256807070656380504386831
10300000200000705000000000800050407060000020200000200030000040004000400050700000001
10707250503752705080534570707270804034502220806380307468736060535757508080335256701
10600070200030002030000040402000605000805050703000500000003080004000504080000000701
10704040885056848034802050206043806770607080707078885724254083807050403080272260401
10308060002000005000707070406060002000300030004020600000007000400030304080007040701
10404036206773605860536050607080478020867376662050602054503080245680804083408050601
10206000600000500080006060008000800020000000008000805040007020007080706000400030401
10205740345360275046505042432285804437245547807033708030485782206070405280402560401
10508030000050006000003070000000300000006060004040505030000000700080308000800070201
10307020805036808528767730235360267666606050556040406225344870352240407056364030601
10300040506000500030000050000030000000407070006000800020000040000000405080000020401
10437480477240247040223040575086782258404035505365468030458025278243603047676730401
10400000600060002000700050003000000000005000005000800020002000000000003000000000201
10328536603034838556682237824633636364338272623030354258552628476274486475444535701
10000000005000000000000000000000000000000000000070000000000000000000000000000000001
11111111111111111111111111111111111111111111111111111111111111111111111111111111111
