11111111111111111111111111111111111111111111111111111111111111111111111111111111111
10000000000000000000007000000000700000000000000000000000300000000030000000707000001
16707487472356265020643030803258604066752557702067402320202227803020708040803030831
10000000000000002020006040607000503040000000208000804000608000205080305030502070001
17226634423344208053407060806080506080857230703020207083802044308030546020305083701
10003000000030003000500030800070703040008070005020807000604000007000700020003000601
10388070367030305440466530275870305625204040456080368430306688303543808036286343301
10000070005000306000200080304000200000500080407030005000600000800040006070800000001
10546445603650533060276070607038273040267060808076307067455050608380205050708036241
10005000300040200050300050008000006070007060008000407000002050307000406000204000001
10807067655040706440707052645865402046705320356468608032204550303043658428306026201
10403000200020700050708000000000408000800020004000006050003000308000002000004000701
12503580204387877043708758826520803336676060703023788270824070206863407042784230401
10006000600000607000600080002000400080000050805000800000800060400000402050000060801
10646020742050308770346030703030788030244240207380407546506860606575504070506360201
10000050003030006070003080600040007000200040804000700000305000500030006060707000601
10253266508238377020503080602784605260407240805053682470608288355070633030543054801
10008000500000600080400040300000300020200000707000400050003000005070000060000030001
10502020472270708027287050366250226050467856705050404086738046206428508868568630501
10300050007030004040008080400040800040005000003070008000000060406000800000004000201
10383580602080624570808750503080307336523066535450337665566340203020504377402045771
10000060800070500000602000708060300000007020000070400000000000207080300060008020001
15464070445440202437805080754080387373303020505072307376674036207330447060407080601
10700060300070800000300040300060000000708030703000703000005000700000500020802060301
10205740203020768850478752206867578256804060402530504056508050434423702480504060801
10402060002060000040000000003000000000706040200080006000402080000000302000706000401
10408063327020488087248283504053363540603040802038324750506650672536307037508488401
10007000500060200020000000405070000050007000508000000000700030007000506000400000501
12245360302250207050302680623084785057304536805662856274842032634020804540448250801
10000040004000306020600070003000006000800000800000000000004080000030403000700000801
10573045335267705580406050505767703780783030478325448838806030605730734067253353201
10002000006000500000803020600080700020002070005000000070002020207000200080000000201
12607647502050484272407036385060268042206083303044884370828040336084708056654260501
10002000600030000000402050000020406000008050703000002000405020004000006060008000601
10834070888477406840706020276730208036554080804740804080204066206467867780603028701
10000020002000805000703060000040203000005000700030700050807000204000700080208000801
10324448484070736020307023307040308063303647258060765487403066308080608070802880301
10000000400070003080208000203000605000800000003080200000002040006070002000600030201
10838846706054802060306730208775806420504645805054508588475070436060738530788050601
10007000407000202070600070406000006000205000803000200040008060000030000080600040601
15746070407860505053822020873046764630808070306020736064805046705577546080705760201
10000040500060606000007060008060000060305070007080008000408000400000200030200000501
10608660887040202682808026706035342036708082576226207270207530877880502040753482201
10407040003020500000403000503000005000205000000000500050700000600000704060000000801
10204050608050377670604570206370808850608620248470527080306267507847508066354744701
10800020800030200070002000800070405000400070005000305000200030002000606000000030001
10407730572680605035783035238077203075528050802038602043633350724650305670585060671
10700070002000604000007000002000007000505080508040002070000000300000500050008060001
10585523207075707024608354507437767620702080803030588080323764203076575020832020401
10007000707000008000806000803000000080800060502000600030000000802050000060500050301
13608050204060384680602050707076623060588452603850405483427060803050638466208282501
10003070005060600080200040205060008000600000600080400040007080002050000000500000601
10232022622027608020707740604080808036308730366033532042603047878070576670464480601
10003000004000402040707000600060506000400030005000500060008060007020000030300000701
15508065807430405880754065435034302360454068408640202240308030205077656280707333401
10007000700040406000700020008030008000800020007000500000603000606000008000606000401
10608530308070307026503085402070282026804040783054468684408345402426502086502060701
10607000707070004030007070005020005060007080000020000000700000700060004070008060001
10477022203055445030233780408053803740656088686220535230203870487040272036825035761
10300080004030000080000070703000800060500030000000303000600080300050700060000050001
10207570284060355650564050602630728060204850404670705027352660206060407580508360301
10600060600050600050007020300070005000700000800030200050000000802060500050602000601
10345050308526705034355080326062605035587872864020555850852727203060433080876030701
10603050200000604060008000400060002000500020004020000080500000007020003050000040501
10606070486430205350606563742330388070202070406058386050608623663625208057353562801
10500040000020500000300000000070006040408070500050002020200000300080003000700000001
10808647833870305822442572524033507060347070534543407020774224804080824870802367731
10800000700000303000000000200060207040000030200000600070000020004000400060400000001
10507270307526707080426460308440302035307640704670205754664080356566504050384685301
10500070300060008080000060606000502000208060507000700000008020006000807040000000501
10205070244053684062804060508083704570308080806086347478427074504040304080724770201
10806030006000007000306020305060007000700040006050300000008000600070505040003020301
10503058806254503540774020703060357070584283672030505064504070635840705032605060601
10508000800000800070006080005000300070000000008000603050004060007080603000600060501
10207550784720646077203035262835207667774232203073808040277238705030207340608850701
10405040000040008000006040000000300000004030008030207040000000500030607000200020701
10402080202075208223354430236620282652506060258040708647566480444570504075843050401
10800040702000500040000070000040000000305050006000400040000020000000808070000070301
10567280226280376020558050335058672738304045405337535040866088255368402042874820501
10500000300030005000500020008000000000006000006000600060003000000000008000000000201
10385785602088478328533444686737243355586263745020746645452627834778575627255344801
10000000004000000000000000000000000000000000000050000000000000000000000000000000001
11111111111111111111111111111111111111111111111111111111111111111111111111111111111
