11111111111111111111111111111111111111111111111111111111111111111111111111111111111
10000000000000000000003000000000700000000000000000000000600000000020000000602000001
14606525534833845070388020303262506022722273707085406360302875602040605080406030581
10000000000000003020005070208000405040000000303000804000605000704070804040306080001
14583647343533404074504060303060602070387580505050208075505034306040735080606037601
10003000000030007000700050200050605070008070007070805000802000008000600080002000701
10864050488080504570464850488480507637504030875080632550703668804884203066466475501
10000020007000308000700080402000300000300050302060006000600000600070005040200000001
10557754203460737060737060705082423040267020304068807054272020408260604020705078741
10007000700060800050500060007000002070004030007000508000007040505000308000205000001
10405036354060804320308088627435605056306850233567807052406530507022248476407064201
10204000200050600070604000000000603000700060005000003080005000607000007000008000501
15202820207858684088802877722560206473754050206078454340275040308346707057542830701
10004000200000406000600050002000600030000070307000400000400020500000505060000050501
10222080583030606620537080806030544080458750205680807274707280408454705070208340301
10000050008040008050003020200080003000700030406000700000308000300080005070602000701
10376256308677458060802060705866406320703450604065323570606763264040354040842035201
10006000200000500080200050800000700080300000402000200030003000002040000050000020001
10606080354530302066574060855580435080588426207070206037586086206875602372578550501
10200050003040008070005060600050200050005000002020007000000070504000800000007000601
10868580604040253540205560408060808276768072562730274656438730805020605534702078471
10000020300030200000706000506070800000004030000040500000000000605070600080008030001
14386060584770205276307080874050624336305030603077304722838046608370224030805070801
10600060300080700000300050600080000000303070704000207000002000400000800050503030201
10608420707020252850738752606446272338203030307830508043404020648536206820708070501
10606070005080000040000000006000000000702020800040006000205030000000707000508000801
10606053484040486055882336707055884520605020503055873460302720532885208045603852701
10003000600050600070000000207050000040004000704000000000300080004000308000700000601
18847340504380605040807520242068725047208888707768324556222068335060702780637540501
10000030005000202060700070006000006000200000700000000000003020000070707000300000501
10884044348443807880405040507385604570677050467357685848402060408740257045744768401
10004000006000800000604070600050300070003070008000000080006050504000500050000000801
16204583406060587778408038584040878086305084805033627330544020437022703048687520501
10002000200080000000305030000080607000007060808000003000606040007000005060005000501
10682060422655302860706070552420703032874060506530605020304022703677733680407046701
10000060006000408000508040000080403000005000600020200060702000304000200030706000301
10554577627070487020203055508070206042407765754070268764707025406020204020805350201
10000000700060008080702000804000603000300000002050500000006070007050008000200050701
10442786605064508080505780604228708220402456405084404244322080765020522670753020401
10003000407000308080200050803000006000702000508000800020003060000060000030500050701
12845070804520805022484060346028666360404040806070256084304057404776348080306280201
10000070700020708000005030003060000020702060005060002000307000300000700050700000401
10702570476070305722802027505046245063404075627324305420503750767260208020746574701
10506080004060400000807000406000006000602000000000200080800000300000704020000000701
10806040805050834660405570805230807680404330257450736060502777404556806038853552401
10700060700040700030006000700050608000300070008000603000400030008000702000000030001
10803720772620605026755053323068606027854040706073705046646420243420404220554080461
10800030002000402000006000004000002000202050705040003070000000300000700040002030001
10378523306043206066706355306573628540306080508070443060445627504078445040672080401
10008000705000003000308000805000000050800030302000700060000000203080000040300050501
15208070806030273320404070706074847060357624406730504327672050802020388442808676301
10002070003040500030300080605050004000800000800030300080008020005060000000700000501
10252075428034504040707720703070808066707240484033285086505073442070448340753630501
10008000006000502020204000500080203000700030005000200080004020008080000070600000701
14307044704630602460668038368087404370637042808560707830203060304044344570204558201
10002000500070207000700050002070006000400050005000400000603000305000007000603000301
10804560408020503054806074707040484056706080278086387245208826503222207076202040601
10306000803080008070008040005020005080004030000070000000500000500080002020006040001
10236084404022857060332270708056306840478077558340482740608850788080653028746084541
10200050007050000020000040307000200020700020000000206000400050400050800050000040001
10702530648040385550223050708330663050207220307530306022887330803030404450306770201
10500060800030300060005020800070006000600000400050300070000000303080200060307000701
10362040308534306084482070673055806083326823474020347430765726307020533060237080501
10603060800000308040002000200050004000800060002020000040300000003040003060000050701
10203080878280706430706566652470754020203060805088324070807267766288305043533527301
10400030000080600000600000000080002070306020200020002020400000700080005000400000001
10206574587260602854858548656083408020288040234763306070266366606020276740804255581
10600000300000403000000000500050203060000020500000200070000060007000400070600000001
10508280804545704080844280203530505076606740604440603228285080222633507070842483501
10600080400060007050000030603000407000305040604000800000004050007000208030000000401
10304080427053423076507060508075705650705030403053424387244046405050603070877520701
10602040006000006000504070607080007000500050002040400000008000800030203030002030401
10206082203387207740457080406080555030437882668060405054607060856870206026807020301
10805000700000500030003070005000300020000000004000403040004070003030805000800080401
10706670243630375056604054322578407527776452305052502080424377303070802640804370801
10408050000060007000004050000000600000006050006020608050000000300070205000700080701
10204060803046502528726230377840846467708020628070607644548360427830605063688060601
10300060707000300080000080000020000000408080004000400020000050000000807080000050801
10255830765650672060834060755044246866402074506586844040268066332742303022655350401
10400000500030005000800030008000000000006000003000700030002000000000002000000000201
10668365604062768355347476343727278622587387472030786485667767444427776273244474501
10000000003000000000000000000000000000000000000070000000000000000000000000000000001
11111111111111111111111111111111111111111111111111111111111111111111111111111111111
