11111111111111111111111111111111111111111111111111111111111111111111111111111111111
10000000000000000000002000000000400000000000000000000000600000000040000000305000001
18206235535238267030566030408722505064354433607082503380706886304070706050803070241
10000000000000008020008070602000307070000000207000303000406000305020408050308040001
14764775652826805036803040207080303060723230203080703042305056402050225030407058201
10007000000030005000300060700070502060005060006080206000207000002000300040002000301
10484020522060605370886540884520706536403080865060453720302333603262604045327666701
10000050006000704000600080203000700000300050204030005000200000500030005060600000001
10552475403670225020447060608022447080542080602058306065655070708770203030506052681
10004000700070300060300040005000008080003050002000606000006050804000504000403000001
10808053238030705570708057235783504048805750278478604072206470805048763843304086801
10802000700080300080604000000000506000800050005000006030006000306000002000006000801
17308870804635456023304485462870404628773060508048663570462030803358805076837350501
10003000300000405000500070002000700070000080504000700000800080700000507020000080201
10855080384020307460546050706050686050742230406440508574606270206464407070803280601
10000060006050004020005040200060005000500050404000800000303000600030004050205000201
10763527808664328030404040205566807640403860603062285460305456433040278050285083501
10002000300000700080400020400000300040800000602000600060003000002060000080000040001
10408060228530308065822060268870743050264667708020203086862036605745203526845320301
10600050002080002080003070600040300040005000007030008000000060208000600000008000301
10848380803050456740505440407060803262668053467820378557646530608050202586407087381
10000080500030200000602000408040500000005050000020200000000000206050300070005080001
18885060643570408584308080447080482688203050604035502483585075602760627070402070801
10700050800020500000200040300030000000707040203000304000007000300000800080302080301
10502240608040288280284854205864424865305080207450606022703050473747407420308070801
10706070008070000030000000005000000000607080700050005000807080000000706000403000701
10207032445040268072625676804026238740808070202084454650307630246756705074608724601
10008000700030600070000000808040000080004000602000000000400080008000706000800000501
17468850608520807040605740883043668023306647506734822356256085263050405650425670801
10000060006000305050300030008000002000200000600000000000008030000080702000300000701
10534036322535502380703030204378304260232070252385543356205020405530322057265283701
10002000003000800000207020400070300070004030003000000050004040704000800020000000301
16508287603080848662202055786080637036503046706036486240435070264038203034282430201
10004000700060000000202030000030805000003020702000004000202020008000007080007000801
10666070474855808450602060463560407063848020506540708070504024205684258560404042301
10000060004000205000502030000020704000005000400040500020207000704000400070708000201
10332538823020763030802084508020508055305566385040346466407055604030708020402350301
10000000700040002080205000508000707000600000007020600000006040002060006000600040401
10525527308043703030308270608546307520706325607027303557877060632020422230253080201
10005000806000208030600060204000002000704000403000200020007080000070000020400070701
12254060605580706044425020656062222650706050807060875057802054302565633030403270501
10000050200040804000005070006030000050705070002060003000604000300000600030800000801
10305820553050604273806025508066724026703057222866204430605250743440402020378548701
10703060004050500000804000305000008000307000000000500060200000200000604030000000401
10606020304020453320707360803730604530308620824850377030607588507684306042887462801
10200080400020400080002000800040205000400030006000602000700070005000707000000070001
10202820327730603025435073864043303083586060304082602024884460742480205220723050451
10200070004000408000005000003000002000506040408020005070000000200000600030004080001
10862737708085808028208375708724722450602030203020625070454656203067268070223020701
10008000403000008000206000406000000030700020806000500030000000704060000070300080701
15203030307070536550705040204067735020587858202640505675482060606070442482204375601
10003080002040300030400070806060005000500000700080200080002080007030000000500000201
10725045238045803020602440306050204025606520523033682054403084425050778320323220401
10004000004000308040403000600060802000500040003000800060006070003080000020700000401
18706066402260402270774026268062204360484054806670808480205080506088555630507788501
10002000400070303000500040002040005000400070008000500000705000303000002000203000401
10806660704070406033307032405030743082308060636026848434607623406475708028604050701
10205000604020006050007020008030006040002080000040000000800000500050002050004070001
10864058407025262050835330405027208380554046856230742540405820546030437053626037521
10500040006060000060000030508000400020700050000000508000300050600050600050000070001
10505840526060865580552030805850636060302370304330605042252760604030603520407520801
10600060600070800080002050300060008000200000800040400030000000803070500020402000401
10747040506873806042524030787067204022662482276030478760588324403080876040226020301
10403040800000803060002000500030008000500020005030000020600000005060005040000030301
10402080374270407870802244362440278080504040608026388070703442367444405073844664301
10600060000040400000400000000040003020603050500080003040700000500050007000400000001
10408762643740707565228267478042703060676050242282503020643785405020427380506864881
10600000300000805000000000300020604050000080300000200030000050008000400020600000001
10305450205757804070774530706870805066402770807350707386784060784753502020834844501
10800040200060002070000040702000204000303070306000300000003030007000607040000000301
10706070823022358037404080502085306680707030204038487353824065404080204020527720401
10704030008000003000703020408080005000200060007020700000007000200040403030008070301
10806066205486503220645050205030356080867527427030308034403020428740407075804060801
10702000800000600080007050005000500050000000006000607050006020002080703000700060301
10207370455880236043804047888768804244563538205075503020584628403040304470203530201
10503060000060005000008070000000500000004040004050204030000000500070208000200050701
10703050807026707378275230226230387558308020344050502567373770367420706052684040401
10300050707000700080000030000060000000205030007000300030000050000000605040000040601
10382460672470456020486070636053372253702082802856447060588027658777807075584360201
10400000500020003000700080004000000000006000008000800080003000000000005000000000401
10543787604038674852773467433885624588375433843020742424664487787658565432632787701
10000000005000000000000000000000000000000000000020000000000000000000000000000000001
11111111111111111111111111111111111111111111111111111111111111111111111111111111111
