11111111111111111111111111111111111111111111111111111111111111111111111111111111111
10000000000000000000007000000000600000000000000000000000500000000040000000604000001
17707267736645855020244080406844203022633286304076604240707623706080606020404080561
10000000000000005070005040804000207060000000507000803000207000602050706020406020001
13742348766666303046707020704040703080563420606030702052804046706030664060202028801
10006000000080008000400060500060804060007080003020703000307000003000600080007000501
10488040624050507840523820556640505455502080576070732530502236202386805044236734801
10000060008000603000500020604000200000400060806040004000200000600030004060300000001
10678244605480633080353030406062244080437020502067607085688050604770506020308082521
10006000300030600040300060008000004060003040007000807000006020403000206000808000001
10205054482050306550805023734226203066604840358673602076405380502055485834303067401
10205000600030200020404000000000303000700060007000002050003000504000008000007000601
14304220602536366044507335258530202244758070608074775670738060805474302048842360501
10003000700000305000200020006000800020000030208000700000700060700000507020000060201
10344080827020303360857060608040735070657740608760502787408380803582203080304450301
10000050007020006020005040800070003000500030306000400000506000300050003030205000801
10725785403458333030702060502242402570203250706072863730306854575040835060866043401
10004000400000500020200080600000300020700000604000600080002000008030000060000060001
10703070736860308032877050756660723020443362703030607035527084204822202324883850701
10300030004060008080003080600040400030006000003080008000000080304000700000003000401
10358860208040685570703850505060204774576054388450337772784260708060502825205086631
10000080500050200000406000804020700000004020000070800000000000307060300030007030001
12428050678370305852803050664020883426303050204074203272378064303580234050205060601
10500070600060700000200060200060000000202020208000506000002000700000500030606080201
10603260307070277220644566207243267445505040703780606023502040622736706880207040201
10308030005080000020000000006000000000708030600030005000805030000000407000407000701
10303028656080578068724862603055854540406030608073564720404640283555508052506783701
10003000200020400020000000204040000020008000407000000000700080005000408000600000801
16445220506440807070503360887028884026203832303885363847446044438030307250824530401
10000050003000208030800030002000002000800000300000000000002070000040406000600000601
10836065846347808330807080405378706820862020677578457426203070707670334063765742601
10005000008000800000803030700060400060003080005000000070007070807000400060000000801
17806326206030475482802048536070376063502043205028847720863070274078506054525250501
10008000300050000000505030000070808000008050502000006000205070003000003070003000601
10473030672664607620802080475630603086646080605380605060708026608383837860203072701
10000060005000604000803070000020804000005000600080500050606000206000800040808000801
10633538424040436040206038208030807033402448525080623247707068204040607040306230501
10000000600080002080307000306000403000400000007070600000005040003030008000300050401
10355688705064706050808530605528703330407343303074206763728020855030544230875040501
10006000704000705070400050507000007000208000202000600080003020000020000080500040301
17753060707660505022857040664074434240705050502070557054402072607482857020707570401
10000070500040702000007050002080000080607040004070004000805000800000300030300000401
10602870538050202387502026405034582047507054855758303270507380546730306030844583201
10707060004060600000308000604000007000204000000000600080500000400000603070000000401
10607070405050352870407540603880404450406840565320656060707475702244604046755733201
10200080500070400020008000200020706000800050007000304000800050002000607000000040001
10402460767450807077334056836082205033786060508072207054727460526220306480454050271
10500080004000602000007000005000004000505080504060002030000000500000300060007030001
10372327702076803073302564608274767220306070204020437020373342803073563070572050501
10004000703000005000704000708000000070600080805000200050000000506060000050500080801
17505080208040445250408040306058657070286476507680404443573080804080456524707868801
10002060002080600020600050305080003000800000800060300070002040008030000000600000301
10488025336035803050705730403020706088607470482024777035206067227070674740854440401
10003000006000408030408000500020808000700060006000700040007050007030000050500000601
14408033707580404480633047626054304750445088507280602660805040806035354450503788301
10008000400060704000200050005020005000600030007000200000506000205000008000606000801
10304740205040208043602046205080485078508060832023462885402268305775603063406070201
10402000505080004060003060003070008050007020000080000000400000400020006070003060001
10284087203044268080656430708066405480337048765870784740304420335060355064635064651
10800020002080000020000050407000200070200040000000605000800050500050800030000020001
10806270842020474450333070304730844080807680406540502068573830608020208450305440501
10300030700040500030008070200040002000400000400070200060000000703050200060302000701
10778020503728302052852030675025603078578667743020534220823285205040824020246030201
10706040400000407060008000300050007000500060003070000050600000008080006050000020801
10502080575750602630506853825240662040207070402057832070807646223335708026848582401
10600030000070200000400000000070005030204050500080006040400000600020003000300000001
10405677436540504743584577584024803050766020677623605060456347602030848440206237771
10300000400000705000000000600030806060000050400000800020000030006000800080700000001
10302330503822307040882860805780502084408470504620207385225060484563507050438652501
10500040800030002030000030604000207000703030206000600000002040008000403040000000701
10607030224046262057507020504075204770804020803032258688522053205040804030338880801
10707050008000006000305020807040006000500040003030600000002000300070502040002050201
10808066404284307520762060707030474020428453682070204022607080652440805064702040701
10306000700000500030005050004000300070000000004000304040002080006050806000600070801
10607850458270284063203057457557303785783752306057507050784766703020203530802420601
10303060000020007000007050000000800000005070003030704080000000400040303000200050401
10406050407082702886442460748760845432202070858040508284754860222470805022478050201
10500020604000300060000030000020000000707040004000600070000040000000804080000060401
10283460433230253020326040232022464524302076507784552050444045366363404066652380301
10800000400060003000300050006000000000006000008000800030004000000000008000000000501
10355436406073433287674873383758874678366286474060347334728632234342726288568556701
10000000008000000000000000000000000000000000000040000000000000000000000000000000001
11111111111111111111111111111111111111111111111111111111111111111111111111111111111
