11111111111111111111111111111111111111111111111111111111111111111111111111111111111
10000000000000000000004000000000300000000000000000000000800000000060000000405000001
13205372643342555050865040508326605042258283207066208480307725303020803030204070281
10000000000000007080007050708000808020000000707000407000206000307080403050208070001
15765767362862306086402020608080603080628270506040206047304067604030642050407082401
10008000000070002000500020300080402050008050003030708000503000002000400030006000801
10738030582040506340442380666260505344303060756030724230402375403236205036236826301
10000020003000608000700030703000200000800080702060004000700000600050002060600000001
10256748204220362030867070306077532030446060607038507053868050606420404060403022361
10006000400070700020200070007000008040007030007000604000007020803000507000702000001
10405087342020503750207043542664806055205660742225205085205680303033777558402067701
10603000700080700040302000000000508000200080006000003040007000802000005000003000401
12806380306886732078806722853730803625736050202048388430677060607866606053724350301
10008000700000206000600070008000400040000060604000500000600070700000208050000040701
10634040373050806630373030608020442060886530804320405348606320807366502050202670401
10000080002070005030005080700060003000600040305000400000203000200020006070306000801
10727375405283285050706030406563504640403430603036535660707287442060282020535062801
10006000300000600030600060800000800020700000808000500080002000004060000080000050001
10205040578530702033235080423560862040775776705020508082734084708484307868332640601
10600020002080004050002040400070400040003000008080005000000030407000500000008000701
10626530607030832370706720707070804232644072586650228754575560703060203825708074781
10000070400040700000306000602060800000006040000040400000000000807060500070005060001
13732050574340803864802030472080472758705050506087806856773077702350633080208020801
10600070300060700000200080600060000000608070402000802000002000500000400050504050201
10505560605080488570445847703484427562207040403640507064605020376534804460306070601
10703060006050000080000000008000000000608030700060005000505040000000602000503000201
10608042674040833047474634703023788560307050504026225540804680477224707052804537201
10008000800080600060000000405080000030004000507000000000500050005000305000600000601
16454430507730403030407670573076888062504767408583262636448037354020608870732260801
10000060008000302060400080008000004000800000700000000000002060000020206000800000301
10327044535526805820603040606363306360724070873828754877304070302430836066233876401
10003000007000300000205040600080800070006080008000000050004030304000700060000000201
12403333607060468452308088622020574068808067206026483770236050772023202083632740801
10006000600020000000404080000060404000004030603000007000805040002000005040004000601
10586050754843704680603070376340508077468060806880808050707027503577577450203026401
10000020006000204000206070000050202000006000700030700020406000203000500020508000401
10373775457080865020705086707020203054402523847080746626306024204050406020404880601
10000000400070005030505000408000208000200000005060300000002030003020008000500020601
10355556403038202050406670505473805430808222602023602383876070544020632430674070601
10008000705000504040700060403000007000305000204000500020005060000040000030400030301
15825040606330203053587040783042326540502020608020427043708043705577847080706620701
10000020600060606000005060004040000080505050007040004000705000600000600080700000201
10307820284080608543208064205036725027207056487576703650304330853560403030863346201
10703060006030700000804000605000004000404000000000200060700000700000703030000000401
10808050503040565720303530303350205720803840224740232080605666303646806073838883501
10700060600050800040004000200070602000800030003000703000200020008000207000000040001
10402360852250605057588023328073506055863060705063502057444530342230708870287030451
10700080005000304000005000003000003000303050507070004060000000200000500080008070001
10252287505076503026307575304783282570406070205020773080663454302038887050286030601
10008000606000005000708000406000000050500050202000500020000000603080000030200070301
13407060606030865370807070807073636020277583503880303744822020507040587783503783601
10006020007060500060300040704080007000300000300040500040008030008030000000500000501
10234024227022206030207540406050206088305280274057775044703055222040362320672770301
10002000004000407020505000500080402000300030005000600040008060004040000050600000301
14304054202540802870884033554054607330486025708640703450505060707035253860806266201
10004000700060305000200020006060002000700070008000500000803000304000005000803000801
10408730308060805053706048402030845038807030236065844343708255808474403036607080201
10804000805060005060005080002060006020008060000050000000400000300040002080005020001
10342034402045367040272660807025406460625035252250878430703550758030834082648068541
10300050008070000020000060505000200070300080000000205000200040200050600040000040001
10607470876060456540228060708570247080207750702840807033287670204060607280204650401
10600070800050700070006080200030003000800000600020800070000000607030300020604000801
10272020304577805033273070284032808045767276864050852380437764305020285080675080701
10806080300000704070005000800080004000700040005050000060300000006030002030000040701
10804080344660208720506836257260228070308040507026423040403486848282803088644762701
10600060000060600000700000000050006020805080700030006080500000400020006000300000001
10204422442380708572238884626057608020736020433628604080385746408050255330604762721
10800000800000704000000000700030504020000080200000200050000050008000700060700000001
10408250405467805070678530306770207023602470804840407277366020468644508060248848201
10800050500050005070000070304000208000507060303000200000007050008000408040000000401
10507060388053784023202030202037403260803030306073366334286088302050205060646480301
10502020002000007000807030402040007000200050007080700000007000300080203070003050801
10502054305546405530537070504030876050463788624070603042202080222770804074305070601
10204000400000300030005070008000500030000000002000204050003020006040607000800050701
10605680577370327037303073223637607557258273205072304020684353208030508320405240701
10305060000030005000006030000000700000008080002080507070000000600070502000300070601
10203060406048608628254220664770358755704050547080406752324560453880703056663020201
10500080803000500040000070000070000000705070003000500070000030000000607040000040801
10426530333380855050674080487086553858803026303446444070332074675736402024687820801
10600000200080007000500070002000000000005000006000600080003000000000008000000000501
10376587206074286288245857682753842728673835476040475288885486324363742627246733601
10000000006000000000000000000000000000000000000020000000000000000000000000000000001
11111111111111111111111111111111111111111111111111111111111111111111111111111111111
