11111111111111111111111111111111111111111111111111111111111111111111111111111111111
10000000000000000000007000000000300000000000000000000000200000000030000000306000001
18705244484874564070643060706835304073253767804055208240802746703020705020602080861
10000000000000005050006030608000504050000000705000707000607000204040804060505030001
12555552423236704075402040805030604050344840603050408037206038607050577030605045601
10003000000070008000700050200050404030008030005060403000603000007000700070004000701
10622030682070204650586470665730402243406060237080445470808528208427305056882386201
10000040004000806000700070806000500000500030508050004000700000500040005060400000001
10446758303350857050232070302027583050747070607052504028277060707850307080702065741
10007000200050300080400050006000004030006050004000308000005050402000604000407000001
10403024643060705730502084726763502038206770876488207043205460404043884872303032401
10402000600050800040408000000000202000200050006000003020006000605000007000002000801
14704340802646372025302353574420803872847080506087826430486080705527707045424860301
10005000200000605000600080005000700070000080304000700000700030200000505080000030601
10482070653030308660325050704070566020565850404570405832403760807472704030805770201
10000080006070007060008080200060007000300030507000200000306000600050006050508000601
10232257704524244050203080305343303320406870603068482560707773743080752040653053201
10007000600000800070400080700000500060400000707000300020003000004040000020000040001
10405030523370307034846040685580532040667453704050203054576045206428302385262550701
10500060003080002030002080200050600060005000006070003000000060507000700000006000401
10532520702060224670703740308050702357726047453250568375358720808070806828705072271
10000070200020700000204000808020200000006040000050600000000000805040600020002050001
12227030364440504836304060626070323244408030707063702734877026603250437020503070501
10600020200050700000700020500080000000704020804000602000005000700000200080707030601
10808720308050463530483522806222247353204020606730404037507020822386404820407080601
10403080006070000070000000005000000000703030300030006000403040000000706000203000201
10705028266040624034746722407085554420206060503066454380208830376548408025306563201
10007000500080300060000000705040000040007000404000000000700040008000804000700000301
14427470808440605060404470472047635074604462807656864635473075223020302570878260601
10000030007000206020200060007000002000700000500000000000005020000080708000400000701
10447038323326608380704040704326303250885050633843286472305020306680737063235245301
10002000007000500000605080300040600070007070003000000050004070704000500050000000301
12507878204020687282806044322030484028305026207023844480786070828054203068853650301
10003000700040000000806080000040207000008030506000006000505020002000008020003000501
10537060653438807640504080586770707075637020602880307060403078507257882220707087501
10000080005000207000406050000030206000004000800040700070708000206000600060207000401
10667755732020634040806082404030508026307882427050437647504054407060308070804240401
10000000600060003060606000206000508000200000003050600000005080004070003000800030501
10427836302067207050206560603422602540307865808032604388337040554040238330883040201
10004000808000405020300060808000006000505000308000300060003020000080000060200070401
18722020605560608077486060863054663720208050608030467083208055407438273030807480301
10000060300070607000004080002070000020605080003050006000203000800000200050700000601
10307670337030806378308027307043455062206057357774702860702580874570202080553645201
10705030005070500000307000703000007000603000000000700070800000200000402030000000401
10502040608050636220207830404770408450207640886720845020603434306778407065782486801
10400040300060700020008000200040505000800070006000403000300030003000805000000050001
10607480755440405028454085367044803064867050308072708075863740454740506620748060231
10500030002000503000007000006000003000508040808060004060000000500000500070007040001
10824264805054406066607673708652486340403070803060346030663886406046245080687050301
10002000602000005000603000502000000030500050503000800060000000304030000040500080201
15507030504020587860705080504068762020454582207830803785724030707040526524805734401
10005080005080700020400080803080007000700000500030800080005060004050000000500000501
10638067765047402030304280405020403043702330767046335084307048733080538870423240201
10005000006000207020302000700080808000600080008000200080004030002050000050500000601
12206048305420702570882027576042302820457023805440207540306080205023888330805784501
10003000700070405000500060004030004000700020002000800000602000607000003000604000201
10204280207030708083708032206040822053307030833033676342202434303462804078307080201
10607000405080002020003020002060003080008050000030000000300000600030004070006040001
10547042807065486060384560306077606230563074252270226340402470834060535062442027531
10800070005080000060000020205000500030500080000000302000300030800050700070000030001
10505450362070732680224070707540363080405320808440304045832770507020203530603670701
10700080500060800050004030400040005000500000600050600070000000407080500060307000601
10865050804224407087548020468026707032442448588080885860777843508060775030846060701
10802070600000302030007000700070004000500020003070000050600000004020007050000050401
10704030373530304630808334448270285020802040507046866050707774538563707052567788401
10400040000020400000300000000020005070503030700060004040200000600050007000800000001
10408568378530408477548752864038405070228060526632404060527383204040537230308583551
10600000400000808000000000200030607060000020500000700030000060002000200050200000001
10203440207474804050582220306650304046507570805420406227237050785746208060658266201
10700030700080002080000020404000607000508050505000200000003040002000806070000000401
10803030458048247084304040207066505850507070407057444875325038503050308060266670601
10304030006000008000602050806050002000800040007020500000006000600070207080008040701
10702037602237404420534040402070738050757354683040704077404060347340605086707070201
10202000600000200040003060005000300030000000002000506040007030008080404000700060401
10502550776220566042303038358823805748772473505058204030636685805050808660206420701
10603070000050002000003030000000700000008020006050808030000000200080603000700050701
10608060404043206423664580456730474778607060284080205868874470467470403025887030801
10200020304000400080000020000020000000505050008000700030000070000000602070000040301
10258460452530865080263020387067666436405024507364822040673087587574502078766360601
10500000200070008000500080006000000000007000004000600070007000000000003000000000501
10827752708033436657652424744847848482227436354040887452265886444746243282883744301
10000000004000000000000000000000000000000000000030000000000000000000000000000000001
11111111111111111111111111111111111111111111111111111111111111111111111111111111111
