11111111111111111111111111111111111111111111111111111111111111111111111111111111111
10000000000000000000005000000000600000000000000000000000300000000060000000508000001
15702336264282223040487080503655506055772733208075607280704344308060206040802080471
10000000000000004080002060208000506030000000505000308000604000202080505030204040001
14473526575656707033605050804080506060638550206050703057503025205030376070704055301
10005000000030005000200060300050703040005050006060604000808000002000800020006000701
10256040554020305840876330552840604823507080623080225350408764306333506075744586601
10000020008000307000800030506000300000200060403050002000500000800070003080300000001
10635445306870688070534060204055538060723050707086306046875060707860504060405035361
10006000400060700020300030006000006070005020004000805000003020206000808000606000001
10706025547030605640807026244254405047305250424423207087504750503087455742407084401
10702000800030400060706000000000305000800060007000002030002000502000008000005000501
17605740504542488042804335758320605787545050208067776750477050703678302022632870501
10007000500000608000700030006000400040000070202000200000500040400000506030000020501
10224070273080503660878030602050345020553530608630204454504550705325406030805770601
10000020002080006030004050700020005000300060704000500000403000700020006020707000401
10344534803627586020807040402737506370607630304026864870508453358070485030675062301
10008000400000800050300070500000500080700000803000300050005000007040000050000060001
10205030572360604073835040843670448030465578804020407056425065606233203323285820701
10800050002050002040006060400080800020007000002050008000000040207000200000005000301
10558880606040277450402580508020208324745083753580887637583870702030706672204073661
10000020400070800000608000807020600000006080000020500000000000604060400030007020001
12275020266570807432506030353050773657608070803083707632335068702570263060505050501
10800080700070300000800080200080000000604080405000808000008000300000700060806020801
10305470508060667840755486208528632528705060804330707056706050443587506340308050601
10605030007020000020000000006000000000502080800070004000705030000000507000207000801
10702067483070548027347733802088257840402070808026374740403860455427502083408832601
10003000800080200080000000802020000020003000503000000000400050006000802000600000801
14625370402860208050406250738055532053307223808336366332238024826040504470255340801
10000080007000205070400030007000002000300000800000000000004030000070506000700000601
10262047763657807470407020308272404670487040775752354377608040402330788058376538701
10005000002000500000702050400080700070006080003000000040004070203000200050000000601
14305267606060754886402073844040422083302045502052788440725070525065503037866430301
10002000700030000000602080000030505000006080508000002000408060002000007030007000201
10834030356484606550507050585570502052878070606530504030306032702823457720603025501
10000060005000406000508040000060706000007000700080500030408000302000400050408000701
10225285723060636070807048605060804027703486845020778385207056804040808030502660601
10000000200080004030306000407000707000800000008060600000003060007080003000800060501
10834486507087804080603440204825408250504537708075206863623050282040272640772050601
10006000502000505040400070507000005000207000304000600080007050000020000030700070301
15626040702730508042868030648076235560705040705060775084806022408326647030503360501
10000030200020806000002050002060000080804030005030008000403000400000700030400000201
10308470838030706325403058502026365047606083524624604480503470883420804060872245801
10203070003040800000304000708000002000802000000000500040300000500000407070000000701
10808050508030658650608730806660507680707440342240442070705668608668504045774754701
10800030200040700050007000400080405000800080003000806000600070004000706000000020001
10307820552370705052635034848034303023633080504084408025568650373850603780287080281
10400020003000206000002000005000005000208050308060002040000000200000700060008040001
10486433706037303022505478204685727670706060707040267050228267504043444070254030801
10003000205000006000808000307000000040300050704000500070000000404030000030700040301
14404060204050268360302070506077227060484274505820406553636030406020323623605356701
10006020008050600030500030302060002000500000600030600050002060003080000000300000401
10763086632038405080406850507030205052406750234025347064406036344040284720722540201
10002000006000205030405000800080607000600070004000400020008030005020000030600000801
13702048808820505670233084858047602350787025304770507840206060607037837860208672401
10003000300080703000300030002070008000800080002000200000806000602000008000403000401
10507530702060402066202073408060787077607020346073767237307668502234502057503070401
10802000502040007050006070002050008070008060000030000000600000500050008050003060001
10667078407063484070868580802072205580588034564270426360208760583040844022337045571
10500060007050000020000080207000700050600080000000802000400030700030800020000030001
10403720865070787540385060208840682070207540406840804064525480402070503260307560801
10400020800020500070005050400060007000700000800060500070000000402050300050702000201
10784080702786702058857050848078304086436452345050338850326457806060474020456030501
10305040800000806040002000200050007000400050006050000020500000007080005040000070401
10202080242770804250703875585480364060203060204043455040404824858355205023763753201
10400020000060600000200000000070006060805040400030004050700000400070008000200000001
10704446483250305628475743343034806070485080743545302020347744206030635540803265221
10600000800000607000000000700080602030000060200000400070000070005000400020800000001
10803750505644805060664570205830502057508220206250308563585040856578306030582626701
10300080800030005060000040404000408000306020404000300000002050004000204050000000701
10207050627065658064508070403042406640802040703035768882376083403050704020485720401
10702050006000004000304040707030008000400080004020400000002000600020502060006060601
10208068802638503630246030404040724060265242564040304064803020445270302063203070801
10202000600000500050004040007000500030000000003000505030008060007060503000600040801
10607870256650434038206048727664203887435432502074407030234533403050306370304420501
10404030000060004000007070000000300000007030007050404080000000700040704000500070701
10406060705055504366864840763240847455204070834020604227576720473750203032464050701
10200070502000700050000070000020000000703030004000200040000030000000507020000020301
10724720668580247030324030766043336283703083805854644080756044782864307043645440701
10400000500030004000200080003000000000005000008000500030004000000000002000000000701
10526433802085866755264653334732246854775378238040372342254368833384248524853765701
10000000005000000000000000000000000000000000000070000000000000000000000000000000001
11111111111111111111111111111111111111111111111111111111111111111111111111111111111
