11111111111111111111111111111111111111111111111111111111111111111111111111111111111
10000000000000000000003000000000700000000000000000000000600000000040000000707000001
15408786653622233020227050606885808084683554202055604460404372307030405020203030481
10000000000000002080005030207000705080000000704000408000508000705030306050602040001
18763686738263406084505050602080208050857830803030405025303028807070365020208026601
10003000000070008000600060200040504050007060002070705000708000004000400070004000801
10365080634040503330238830364220608556507040367050786740603665805626405045344475501
10000030004000605000300030202000500000600040807060002000300000600030008050500000001
10563665407230383080274070305022323070348040602083707027785070607650408020306088271
10006000700040600080400070006000002030003080006000806000007020807000206000206000001
10408075433050606740307038257425702072407860754822808075405830708064822843802053701
10807000800070500050304000000000205000300070005000005020008000204000008000008000701
15405870303382665024304233768330603643278020802037845470532030804444604072336480201
10004000400000207000300020008000800020000030606000700000600040700000504050000020401
10577070872040508560522030403070563060526580702650702624706620506727604050708430801
10000070004020004070005070400040002000500020707000400000607000300080002040804000501
10754845402485388070306060406867803860702550802044645860805624422040353070248024301
10002000200000200020500040200000800070600000608000300020005000004020000020000040001
10606080858470404042383050288350483020243345306070708053357077807672207483485670501
10200040002030002020007080300050800070004000004040007000000080402000300000006000401
10284230307040767280607440405040402644768064665680678457784520704080306765705048671
10000070700070400000208000304080200000005060000020600000000000804070200060008050001
12276070653380405366507060543080638567707050402026404832578082405780784040405030301
10200030300020800000500080600050000000506030503000507000003000300000200060803020201
10503530406080752450238582308883825472602060702660203033702080674633303440605060801
10802070006050000030000000006000000000606060400020002000605080000000704000602000601
10802057272040355082674686208046358720204040206074333560204560427372807028306883401
10007000700030200050000000704040000040004000802000000000800020007000507000400000301
18834750208650407040606620724057535077608343706525637636843074263060606750837840801
10000070007000502020400080004000007000700000300000000000004060000080308000700000501
10244034744422403760206020807443408620835050658247286624306070806850844042872548501
10005000006000300000604060400060400030006070006000000080006030705000600020000000501
13502256607080766555406076655070477046402034407078857440827070488083402028374560301
10002000200020000000303040000040404000006070308000003000706020008000002060008000501
10255040632865402650205070346540702082385060302640203020202087408336787440808035501
10000030008000408000502020000080205000008000400030600030308000305000400060702000301
10783868727020365060707087408020607033408224875080555725607086507030707030505420301
10000000300020006060603000308000707000600000008080500000003060008050004000500060201
10882248203088606020204650804252605440602888707053606256644050767060263760856060801
10008000706000308070200050508000002000405000404000300040004080000080000020300080601
16876030507440205083786030455045266450402020203020486066803064202564483080704320601
10000040200070305000002060006050000080207060006060007000407000600000700030400000301
10307740862070407238208046604034587022703023667782206720808220455850203080374775701
10203060003030400000304000804000005000405000000000500040700000700000205030000000701
10405040805020288450306760405730708270708760267280673030406545808753602064673552801
10300020300050600070004000300050704000400030007000505000300080003000507000000080001
10204670335230804036827024866035404042453070406086505044563430428750605370656030841
10400030005000203000003000005000008000703050708080008050000000800000300070005080001
10474268402052803063402626402656352340505080206040566060763876706062424050553060601
10003000702000005000407000506000000040400080607000600060000000705080000060700030501
18706050504080587820408060308088685080685235406320802368538050605060252565808487301
10007020008050400050700080304080007000300000600080300040002020004070000000800000601
10668026576086805080608230605040607058305680532034784086403078278050353430485660601
10007000003000304070403000600030206000600070005000500030003050002060000030800000501
14503085804330404670754082645056703360383023807230704330602030704077833840507436601
10007000400060607000200080003030007000200040002000600000703000508000007000803000501
10702880608080805058607046804070368044808020656078843453205228502743404025205060201
10204000304020002030003080004050005080005040000030000000200000500020006070005020001
10527062406047823040232840704084605380858037533440545780308460787060585033564032551
10500080007020000040000040605000700060700030000000508000400050400050400060000020001
10204540243030746680735020405470662050308760606570202024328740606070705350804730801
10200070700070500070002040200050005000500000300060700070000000806080600050707000601
10354080505468204054227030354057503077848338846080285620872427708020522050262020601
10202060200000306060005000300080007000800070006080000030300000006040004030000080201
10506050528540305530805727728280648070607050305084723020804645677656802047363443601
10400040000060600000700000000020005030202080400070004060200000400020005000600000001
10707423325640806377668752485025407050478030554467702070827833604060358470303522861
10600000500000204000000000300070302040000030600000600040000020008000200080800000001
10307250306245207050676780408770805066602830706580407688564080586378704030868628601
10600030200040004040000050704000808000808020706000600000003080005000803070000000701
10507030385036524084803060403053807830206060304074788833387035408060705020727830801
10204050005000005000806060203030008000400080006020600000002000700020203050007030201
10408045608268508230538050708040745030363325773060807032703050847240808038208030701
10804000400000300060006030003000800080000000008000807080008070005050706000200040401
10603280448460552034208063522757705762425668803085604040445786207020808720603670701
10703050000070002000008070000000800000004070006050206080000000700070607000400020401
10807070306082204455365870886220354257605050633080708372325840238870808088238070701
10500030505000400070000060000080000000305050003000700070000030000000602050000080301
10735370637450587040373050428054735476705056603877655020366036288277402062276320401
10500000500040003000500040004000000000007000003000200070003000000000004000000000201
10723366808048267357877767334647688827548644655070845662787758548325575854568842801
10000000002000000000000000000000000000000000000070000000000000000000000000000000001
11111111111111111111111111111111111111111111111111111111111111111111111111111111111
