11111111111111111111111111111111111111111111111111111111111111111111111111111111111
10000000000000500000000000000070000000006000000000000000500000000000000000000000001
16503765283530778620406685258023604044403280404023304250455080408832864287526373601
10002000000020000060700000007000407000700000304000708000700080502000000000000020001
10407754643050724040388746805840508870545645886770508027804450458070652465276080751
10205000400020403000300000400060605000400040002060508000005020003020000040006050001
10807080702060805732205050654060404084204028802040204737273080407043345480205060801
10700030002030002000003050403070005000006000702000800000200050700080000000300040601
10557085782750326080343040208027632460253250805622257540608335228770224775644060501
10008050000080200050002020004000000050000080702000000060800000000000300000002040601
10607650707074806047308032855477485050777020808060758050843364658242608227403540501
10500080202000007000803000000060000060007060003040005030007000300000603000600070401
10387030804236327550606234764470402842607038227084502087305040602620702050668082701
10005000706000000040400000002000200030002040000030603040005060008000406030006000001
18704456405030706054467446765078726050804040508870307040288030382034482070306258801
10003000800040803000005070004040200050806000500050003030002060002000002050400000201
10575440705360382042807030206040607260403873868663862020208060502247502080586570381
10000000700060002000600030200080002000400000000020000070503030500000300080000020001
10765868604063808857574870342450532080325227846060763784803075662460354247366480601
10000000504000500000005000800060600020700060700060000050002000700000200000000030201
10448580558520524728706082532080507672607050604365538050242770208327607343754027501
10000030400050400000007000000030700000003040008000002030000000408000605000300070001
17474560806080604035223786207248608220724053773077453020625846643080704080803270801
10000000505050806000000000203000200050003000003000003080000050003070006030800070601
10567337303020704866205380586060567085782820504855205024882070503063284050834040481
10800030002000400000200040200060003000000080700000806020000060803000000030200080001
12606020207682255620788620804753304084354084603760302042833430504827425336502083401
10005060606000000060000040706000005000003000606000708000000000800040006000005040001
10242060264066388088766066404070326385402360507058807467504387726020602060742080741
10008000500040007020002000707050000060002080307000606000400080007000600080004080001
10604267703070704060223850265052324070258040224420408020727046407066832366403072201
10500040004040200050000040002050000040300020000030003070500080006000000040007070201
10646050348060576248382020205080462280506786762053537480603860603765664040274060601
10708000400060000000000060505020200080002080002000000020300000605000000080003000201
10408383406034367588886860506080503046364030303077367040235653674054733270602855601
10500080406000000000000040300060006000004000803040002070003000000060000050200000201
10504050807034263552545050805055858640703443507030204065803424665380363060543540301
10202050004000008000002060208020000020200060008000805000300000000080300040000030401
10353020822772503034806070503040277052735030347578508330602748848060404056786080801
10000070003000308000500070606000800020000080000000303000400050000040407000002020301
10758852204052703020576670305772376230708378624830806067484850502736505558237030801
10600000308000008040008000200080000000300060000000403040000000303000002000800080301
10807530503252837673555056224020328584778340847825404040606365406048732030202520401
10002000603000400080004050003060700000000030006040007000200050504000003040300080201
10823083206070404080204080743060705087634066603020602420288070804673708026234060501
10008000500060602000700070003020003020006000006000800060305000502000506000006030301
10708520736720305658782775303033238220503462333526764080408070405080505875208030301
10200050500000300000600080004060000060800000300060004050207060404040200000800070601
10574080507586386740803070755080377030303380306080308020705087607020686620485070701
10006070602000700040508050000060006000706000305070800050808000603080000060005020401
14348020508050605030508057343872803088302053208070488460703260702042665048206040601
10005050708050008050804000400000507000807000207070500080005000808000403000306070301
10205070302030878370306280303740704660505380474070872077632523406660702020508550501
10600060706080004000208000304000808030704070003040007000000000300050803030200050601
10786560802088305057804044202035705060203030504078605887658550502050505030335060501
10200070402050003070006000007000006000303020600080400000000000308070402080007000301
10208060204032265050808386805377758865402080864250403228532436407050207027308244201
10302000403000003040500000700080007000006040000000200000006000003020508000500000201
10705586603343704020403250686050404075383077853670207774336045245060305626334020601
10207000507050005040506000500040304050008000300020607000006070600050700000006040401
10807360203080627020308036506850704080804440605080685074403050608470704658303050201
10402000300080000040708080008000606000500000408080800040006080700000400000402070301
10608084322384753540802035382020307448278646603055707570704040337638347330802220801
10400070006000000000405000000020500000000000703000006000702020000000006000600000801
10656720606070842288603863576788526534424340523878847020803066537723508056365754501
10000000500020600000200000200000600050000030000000005080206000000000207040002000301
10332376242330605840804630307340805060726043384520204020702236335270806072502060701
10000000000020606000800030008000505020300040000050700060600000008050008000004060001
10382820285770205074387038675030644050302430444084622530704537605020762572547042431
10000060005000708000005000600020600080500000700080000000800000503070000060000080001
10756044705072607264402824303787303440344750703840468425865620207024484070254430601
10002000807000705000400000200000804000200050308000400040000050700060000050000020301
18602230402630605050247840375740805040508068207082333080857520843420707744723074401
10003000500020803050000070000040804020707000305000004030500030007000300000004000001
10306063638020205075807076337040205035608540605088704070303027706082524840407253801
10404050008050006000404000005020005000200030003000502040707060002040000040400000301
10643066504023854780408546263087384280734035562840506040606070335060826072824020581
10002000804080000000404080000060003000800070002040805050507040500040600070006020001
18608240705070504825207030487270807080508233604050305040208050724480706280303034301
10005000207080600000300050000000306020300000004000400070007070004050300000507040001
10726022702030207340738675666762308030227827547837833242565058208020202757408630401
10004000007000400030000000000000800050000000000000000000008000003000400000800000201
11111111111111111111111111111111111111111111111111111111111111111111111111111111111
