11111111111111111111111111111111111111111111111111111111111111111111111111111111111
10000000000000000000008000000000700000000000000000000000700000000060000000606000001
14204327452863625080438040808322207032827758806034507420807647503080704050808040681
10000000000000008080004040803000503020000000702000802000602000606040802070805070001
15474835284845404068206080708050504080355230302020807068304032806080285050603073301
10007000000080007000200060800040207040002070002050806000407000008000800060006000501
10542070784060703650256270327660702367406070256020474680307523804463407073236738301
10000020005000806000400050807000600000800060806070008000500000400070003080300000001
10436446405640264040682060307024645050264070703074806047475030403820708080205033631
10007000400080400060200050003000002060006030004000804000005030307000406000502000001
10408023655070307580602047658833403083804280645855202062202650205064255783308032201
10606000200050700070205000000000608000800080008000008020003000704000004000003000301
14402550508747887084508423287380603484724070206076874320773080406656505075785380601
10008000800000804000700040008000200030000030708000800000300050600000506020000070701
10767020238030405750346030808050354060482340704440507855503330606534807050308250201
10000050008050007050004060400060003000700050506000300000806000200080002030605000501
10683243305725287070208060602528202820204330707043478380708743382020682040685033701
10006000500000400030800040700000400080400000207000200020007000008070000080000020001
10807050867770707055668080538830775080623354403080603048656024302257507242846260301
10400070005040007060005040700070300030005000005080004000000070307000700000002000301
10634270404050765220703660402060207833478057736880782878747450702020503335402035861
10000020600050300000406000608030800000008060000060600000000000407020300050004040001
17553050742250208767705050566020674232603070707088807766833058307550365040406070801
10800050300060200000500060200070000000803020602000507000008000700000400080803050701
10605260307030532880242348805856445575306030508620202083603040427428505260502070701
10605030004060000080000000003000000000807030700070005000705030000000602000706000801
10405075438080474045446363208035364660807040602065567520207350326447307026202787401
10002000300040600060000000302040000050008000508000000000200080007000705000500000201
17472580505730603030502860644038727087607864804453283442565045464080508760473730301
10000030005000503080300050005000008000500000700000000000002040000050505000200000201
10377056587267806860508070308536404360883020664423443572306080307860756067372433401
10005000008000600000608050500070200020003060007000000020007070607000700020000000501
17602558606030822736806073686080532065205037806063342640624080678035508085455730201
10005000400070000000202060000050607000004070202000003000706040005000005080007000401
10547030878822707330805040585220407052338020706730607060705035808246733460302055501
10000070002000503000607030000080507000006000200070500080707000703000300050302000301
10263855853040325020804052806040604083702258546050663234502045503080306050702760301
10000000500060008060602000606000502000600000008080500000003020003060008000600020501
10578272808047602050702750406583206270207862608052403485674060467080338370444070501
10008000702000805080500070208000007000607000807000200030008050000050000020200070601
15332040705430408046647070642058728250604030205080682088505036608374428030403780401
10000080300030507000006020004070000050702070002070006000804000400000500080400000301
10802350855050504684606083805044578047403044545635408860303770548350304070447438601
10506070007080700000605000504000002000206000000000200070500000300000606020000000701
10407050303080742570602550206360508320306840753770463060806265606352305064773865801
10300060300040600020002000200060808000500070005000708000300050007000602000000030001
10806340748350304028785048872055707052755040503033508026436740527860707480552020771
10700070008000706000003000002000002000504050807060004070000000700000600070002060001
10554325303063808033205233608368342360802050703060586030526252603024763050755040401
10006000406000003000806000306000000030500030605000500030000000507080000020400030401
17608040203030772760308070308067482070683734207230503673655020808020367752705482201
10002070006020500030600080803080004000800000200030400040004030008060000000800000601
10574045788074803030202280506020708088205250677035268058302075776040887330848820301
10002000005000505070505000400060604000600040006000300020003080005020000020300000801
18803077804330607370287083633055505320242035607240303850408040705056827540602856401
10006000600050706000300050005050005000400050002000600000507000302000004000703000601
10202440607080704087305072402040264063305030332044435633406768803765503027403080401
10704000507030004060008060004040004030007020000020000000300000400030005060007050001
10265067204035463040645450302057404620237047655350774280504860285060264053342067671
10200060007040000060000060506000500070200080000000805000600030200060300050000020001
10507660885040332270358060803370434030307870707670605046727450603040708350604240601
10500070500060600040008050600070006000700000200040800030000000203050400080602000601
10365070602547502045278080885044704032663755665050265660634544302070437030688020501
10707060300000805070004000400040008000700070005020000020800000003050004060000060801
10603060468480507380508453627870847050806060604053422050704467864582504025687432201
10700080000030700000500000000070008070308050600020003080700000500050003000400000001
10503833345750507674822324327042505060636060777873304020744577803050836270802548241
10600000700000202000000000200070303030000070500000800020000020006000500040300000001
10308650706437307070332870403450303086203670205870308458435030436777207080577763401
10400080700040005030000060205000605000204020705000700000007070004000302070000000201
10602050647052422037706080405074806740208040406023685877846086203080704040624580801
10504030005000005000402040608040004000800040005060300000004000400060302040004020501
10306068304657604280558060602080235070473375673060508024606060885270306076607020701
10802000400000400020006060008000800020000000005000706080008040006070307000200030501
10704220445630333042502064787335504683333375704046303070826776803070208630508540601
10703060000080005000007080000000400000005060002060404080000000200070206000200060201
10602070605063703634473450224460647383303040553020506282464540562880406048242040301
10800040206000200080000020000070000000608050007000600070000070000000607020000030401
10473770383730577020875040283056626522505028406562688020753036874583702034487570401
10600000800080005000500030003000000000008000008000500040008000000000007000000000301
10645328806063773885745532487553464657577686234050265846423486325737754572463256701
10000000008000000000000000000000000000000000000070000000000000000000000000000000001
11111111111111111111111111111111111111111111111111111111111111111111111111111111111
