11111111111111111111111111111111111111111111111111111111111111111111111111111111111
10000000000000000000004000000000200000000000000000000000200000000050000000208000001
13303773456524884080874030406453503026463236804046506350206374207080505060202020861
10000000000000007080008060207000608050000000304000705000207000407060508020404080001
14323753825846506075605020505070603050788650406080405034305025202080674050503085801
10002000000070007000400070200020504020006070008020604000208000005000800060005000201
10383080238020304570253670588820804555206080428060755450506445805265708068648243701
10000080008000202000600020508000700000400060408020008000700000700070002020400000001
10637432604420767030324040404026658040646030702024607043745050206580205050808073441
10007000700040300070500040005000005060006070007000705000002080508000405000508000001
10608063888070207260702042463323405054502440832748302025203720603028438447504065801
10807000400020600080307000000000803000500030005000004020002000604000007000004000801
16302430502335433028503422533220506733826030504028485650622040202546506048743360701
10004000800000707000600040005000500050000020208000400000200060500000202040000070701
10663040427050605780852050404040536060372640608240405443406820203875808070206670301
10000080004070007040003060500070003000300040408000600000808000400040007020403000601
10225485405736582070402050305257306350803470505084363820602358532020637050372042501
10004000400000800030500040700000700020400000606000800050007000005060000070000070001
10307040723880604037755070367350773020535435208050206062672076304435407426275470401
10200050003040005050007070400060500030004000008040006000000020404000200000006000601
10532620608070756360706450706080604353423074535230335657523660405070207728807026841
10000020500050600000402000506070500000005040000080300000000000706060600050003060001
16547030555430504265502030847060877435505080404045603535224082708550323080508020801
10600070600050800000300030600030000000506070602000608000008000800000700050208040401
10705240704070872430442527707252353563404040703470605077202030256852306240702050701
10302080007080000020000000006000000000508060700030005000807030000000604000808000601
10206058723070276064573644207035864280805080405047338770307580686644308038605222201
10003000800070600030000000406040000070005000803000000000300030006000507000500000501
17734530306680308060503270375027253024207624305554477758237084563070505320535830601
10000080004000503080600050002000002000400000400000000000002040000040304000200000201
10684082383725208780403070504244308480664030633225472488607080505680326028845382601
10004000004000500000504070500020500060006040006000000040008070603000300080000000801
16806836403050543845502026427060482085204045303055587850572070742046305033856850201
10008000400040000000607060000060606000005020802000004000706060003000007030006000801
10777030376624607680306040242780303082834070308330605030504042805322578430507083401
10000050005000804000808070000020203000006000300050500030605000502000600030508000701
10232742847050455080808077707070407036603675723050342752407085207020607060205320201
10000000200020007020806000703000804000200000006020400000005030003080007000700020701
10324526405047406080303850307866202540808226807075502486766080653020682740556030301
10006000805000402050400040805000006000308000206000600040004040000040000040400080601
15885040404560408055237030355045224560506050804020854082507028808637682050808570801
10000060200080207000004070005070000040607020008030003000504000500000500050700000301
10206720532050402643507078607068347023303074475422307820507480455640806030666546201
10806060008030400000304000807000002000308000000000400070800000300000203050000000601
10207060805050854420707680803340204820808230572630462070707358606434806088774678701
10200060500040600060002000700040403000700040003000606000200020008000405000000060001
10708580522250407066452065633047508047445040203045206068386240272530208530236080381
10300030005000504000006000004000005000606070708020005080000000200000300080008060001
10346477704057405037208573803677647260302020805050455070355262408072375060477080701
10007000308000008000705000207000000070400050403000600060000000305050000020300060501
18505080207060443540407030405043364060285732707670306854472080506070866825305524501
10002040002050600060300020502040005000500000300050700030007070006040000000800000501
10525036438045405070606550803070204044605340775033624047403088522050537840564430201
10004000003000702040205000600080305000800030005000700060003080008080000040500000801
16302067806650806420543026328065504650436068804840502330307070608024524330502284301
10003000200070302000600040006050007000300020002000500000204000206000007000204000401
10408360207040208022203074305020773056807020877044628846307688606763707088408020701
10608000405060007020006050008020002080002050000020000000400000400050007070007030001
10545044303066348050755770602026304240247086585450375450603370854020436072347062821
10300030003030000030000020204000400030600070000000304000700040300040200060000020001
10706450885070822580623080308340653070404370404870403067263860503030606380503860601
10500070600020700060005050700040008000800000300050700020000000207080500020606000201
10266060702835302036828050838057604042342736778070837220684786806050248020378080601
10308080600000708070007000400040008000500040007060000020800000003080005040000060301
10406040726470506830802575758880636030702080803083452040507738272248307085482236601
10300080000030800000600000000060007060505040400040003040600000300060007000500000001
10806852722420207735227882552067402050257050654474302050872842205050377630208442841
10200000200000608000000000700080306050000040800000300020000070005000300070300000001
10408850703325208020463660407640505043607670402370708724738060544446803060354767701
10400050600050005020000060708000404000307040308000500000005050008000604070000000801
10807050462074823032608040308033403470204050802045337323588027508060205030764670801
10805030005000008000808060702040004000200070002070600000002000700070306060007020201
10807033703852503560582020205070437020686375758070806032306070647770605058206060701
10302000300000700070002060008000200080000000008000507030005040002030504000600040601
10705460846880576076308086285278204847786683303046604070255446203080305820203320501
10206020000060007000005030000000400000008060005050808080000000800030504000500080801
10707050506087703745325450372230685833308040626050705266234780743470806044527080601
10300080502000800050000040000030000000505060004000600030000040000000606030000040401
10443340446530458060522040647042446283504084702264237030275028626774603077486530401
10300000400080006000700020008000000000003000005000500070006000000000005000000000501
10533836604027724648646634366462667465277782334030564724834637835525825452577353401
10000000004000000000000000000000000000000000000030000000000000000000000000000000001
11111111111111111111111111111111111111111111111111111111111111111111111111111111111
