11111111111111111111111111111111111111111111111111111111111111111111111111111111111
10000000000000000000007000000000500000000000000000000000300000000070000000307000001
15502874455454665080227050503483508034437288203042603260502783803040806070505050441
10000000000000004060003080204000705050000000302000603000502000403060403070303050001
15443888425875706077508020205050403030744630304040302044705062803020552060303087401
10003000000040007000400060200040604020004030007050505000803000002000400020006000301
10228080362050707650276330566550306583306060325020678280303773703586208046443533301
10000050005000708000700060208000300000700070802040003000500000600080008080700000001
10648642804270846080384030803064424040376020203044303083745060608280302070302065361
10008000600060500060200040004000007040006030003000808000002070604000704000205000001
10303072444080805550405064544685506066703330685862205074808860405047482668607056301
10808000500080400030407000000000802000500030002000007040004000303000005000003000401
14202730405284833048407544453240206436563070505087446720365030208734804077287530801
10006000200000204000700020007000300050000050802000600000400060700000808050000050201
10574050743080602270447080702060667060846220504440402847805420303784705060605640301
10000020005030002060008040700020003000300030306000200000605000200030008070302000801
10422662605882453050708080508883705740503840404048477340408633785080727080673075701
10002000800000200020200030400000700020200000504000200080008000006080000020000060001
10602040887780203087567070856750477020645555805080602055478027508872206288346420701
10800040003070002050008040500080300020007000004030005000000070305000400000007000401
10226650602070485460608480808030304444586042235360266873872450603070603564405035481
10000020500040800000806000208030700000007040000020400000000000504030200030008060001
17668070677630206867203040524030672623808050603074805575386074503570488050404030401
10800040600050400000400030300080000000308060405000704000008000600000200080302080301
10402560506030576730822272808555742823308040604680708084602030365636205220508050201
10406030007080000080000000008000000000808030600020002000308040000000604000404000801
10807072633080335072685426708085338670603070303083867670406430622878407063603284701
10002000400020600020000000206070000080002000808000000000200050005000405000300000701
15373270805520207030606840686043527087704522204864384482757022476060604830664220301
10000080007000307030500070008000003000300000700000000000007050000070702000800000601
10748032333468505870804080408638605740843050332726875578207030206730666084648234301
10008000002000400000704060400030200030008030003000000070004040508000800050000000801
13202854403080436284202073888040737044502037204045273530426070263077607084688880201
10007000200080000000608080000070605000002030705000004000203050003000002070005000601
10684040884848204320507020352280402078226050804580808030403058508568655220806085301
10000080008000206000806030000050605000008000500030700060605000307000800020604000701
10533226625080255060704047707080806085804737382070757637505056608020208040303640601
10000000600060007070507000307000308000700000007030400000002060005080005000300080201
10687724605047506050405540308678206330607654605064507778444020667040782380633030201
10003000604000307060600030308000003000507000504000600050008070000040000070300040501
13855030806480808044485020523034766240807040803080453078704086704757435060303480501
10000030200080606000008030008080000020207030008070004000308000200000300060600000301
10402360224040406663703053803028858068605046682256806830602680856530406060663487701
10508080003020500000508000306000006000608000000000600080400000600000702050000000601
10505050202080768450707470503570205620807730842880767050702258602538803057262657701
10700060400070200080006000200040804000400080005000602000800070003000403000000020001
10408450626430308046468074223078806085238060805026704035472570274840602420756060851
10400020005000203000005000007000003000308020402020002020000000600000500030005040001
10843745503064603064308638705227666650207070802030763020534323704027764020438030601
10002000502000006000508000508000000040200050506000500030000000504020000040500030501
13807050503060668670802040702027853040338378305260304242486030602040878578803348501
10003050003060800040600020607030008000500000600070200040002030004080000000800000701
10423058663056208080505370602020402086208720432083737033307038562040632380446480201
10003000004000703020208000700040208000700030002000300060006060006070000020600000401
12506042504830504530644046445042506660738032602860304340207060603042252770708588501
10002000500040306000800050007040004000500020004000200000803000802000004000208000801
10407580408020508024206044502060545047608020774034644876505574206245402076707050801
10503000303020008060007070002080007030005070000030000000700000300060002060003050001
10342055604064837080877880404028607670774076646870457380504780768040876065457066761
10200050005040000020000060405000300020200040000000207000700050300060400020000060001
10704880783040535530328080803470766040707360208280502022882340803050603570307680501
10400030600040800030007060300040008000700000500040800060000000802020500080302000301
10373030306455302073636060752088506068624264576020535230557664804060545030367020401
10806020300000404070007000600020008000400070003050000020500000005050003040000040401
10304050467720608750403784737740873040802030808053877060403775674735405057686728601
10300040000050500000200000000080006070708070700030007060400000500040002000200000001
10208533367640208376828862887072206080588070532374306060872583208040226820702745771
10200000500000702000000000400070702060000050400000300050000070008000200040600000001
10608830808632702070324460508520308022505570604220807232875060363847506030644828301
10500050800040004020000030708000605000704030303000600000006080002000406030000000801
10803040876062553062405070203057608220607080807035336458447072403030803040625670501
10705080007000006000703080204060002000800040005020200000004000600080204070003020401
10602044804227408220865080302020488080666328874060804085208040582680502045702030301
10207000200000600050004020008000400040000000005000502030002020005080808000800070401
10303530745580624078402053787526506343238286305064602040826763306030806770803560701
10308070000070004000004040000000800000003020005070604070000000700020708000500060301
10502070206075607466368350744380377764308040667050405543684680323470802065425020801
10700050305000800020000080000080000000202050002000300080000030000000806050000050501
10435880376550748060826070488064362462202046807583235030438046453875508042575680601
10400000400070005000300050003000000000004000003000600070008000000000004000000000401
10385627707068324557753434842583285567744664775080735835823766746267757336227234701
10000000002000000000000000000000000000000000000080000000000000000000000000000000001
11111111111111111111111111111111111111111111111111111111111111111111111111111111111
