11111111111111111111111111111111111111111111111111111111111111111111111111111111111
10000000000000000000004000000000500000000000000000000000600000000020000000206000001
15703444657668357030575060207724406026754736808045702320605832702020808060802080881
10000000000000007020003030802000205050000000808000204000707000203020505070202070001
15234784383875208054502080206060205020554530507060206072807043305020662030603058801
10003000000020005000300040500080407030007040006070602000808000004000500080002000501
10883070632040406730524840645220606485303020452060444660407685307633204058625244301
10000040005000403000800040306000400000300080307070002000300000400080004020300000001
10472738204550787060723080504087773060865020504028205045858080604560402050703084431
10008000600020600020500040004000008030008060002000407000002050307000807000702000001
10303074433040803860503086358856306076304460624557406068305520602033756824603038801
10204000300060200040502000000000707000200040003000008060006000504000006000007000801
14806840607372888086808678852270502872533050806082672760587080606263207065464670501
10004000300000404000300020004000300050000030304000800000300030500000504080000040201
10777080385080305450723050707020338060654580803630707768205720404832703020208560401
10000030008030002040008030400070007000600030502000700000504000200050003070704000601
10673868607858835050702060803333306780206360704088653280403567265060857040774085801
10007000700000400070200040400000300040200000502000700040006000006060000050000060001
10706070767360504046873020545540667020562286808020304063854078307767203584424830801
10200030002040008040006080400030500020005000004060004000000020706000300000008000501
10552860202020555550703360404070604525764087274450678832485250207080303334607056671
10000070700070700000707000407050600000005080000020600000000000602080300030008040001
14883070248680303464406080556040567787603050607028205628862023402250847030205070701
10600040500040200000800060500030000000307040208000805000003000200000200030806020301
10205770605020476650345353507487737443306020306220505068506060637746308780403080401
10306050002080000020000000004000000000302030400080004000804050000000606000502000801
10508052284020655032582467306057263440806040405052465270302420733622403058605822201
10005000300040300030000000408050000070002000805000000000200050002000707000700000501
12234740403350206040404230372048473048206736705552258548358028738060407630244380701
10000080003000607040700020008000003000800000400000000000006080000040203000600000501
10546035277833302720506020808654505260378070582328683567203040707260483088668646601
10005000008000500000806020600050400030007040002000000030007020705000300060000000201
17807426605030343268808057755020278083607047307058862420366050637048607054524770801
10006000500050000000808060000070506000006040502000007000407070003000004050004000501
10367040648588707770404050888340502066472070402250704060405046705335645230702033201
10000040006000205000603050000030807000007000300030800070603000708000300060307000201
10564578882020384040506022507020706037806463642060888582505077708060406020805670201
10000000800070004020604000703000408000300000002060200000006030003020008000800020601
10337486604085206020505430506332705470307784707022204787285030587070385830666020601
10006000807000308080500070603000002000202000808000300020002060000070000080600060601
12344030208880408044534060347034578560606040808060632074705034707764274020308440301
10000020600050706000007050002070000050305050002070008000304000300000500060300000401
10202370842070308348306065703066728076303046362573808470606850788460604050456765601
10604030005030800000805000502000005000202000000000700080800000500000408070000000301
10802080707040483750206830802530504520803250276240653070205248502268503028487842501
10400020600080400030004000600070308000500020006000702000300060007000503000000070001
10808740328880605064287078426042407025533020408043703074758680235660508670727020651
10400020006000203000003000005000007000705020808060004060000000200000400040008030001
10246438507053704046204675605724435280504030407040553030546637405088348070275050401
10008000603000003000807000702000000050300020302000400030000000304020000080300040201
16605040605060826680208050502072753030886756804630706282258070203030563267802775501
10002050007070700050600040202040005000600000600070200020004080006070000000200000701
10767043422058605070207350304070704065305840627085825072307085554060575220375350701
10005000004000307060704000700060705000600070004000200080006050006020000020200000401
18806057302360305640332078672073308870772076503720602830608020302042787360307248301
10003000300030703000300040005050008000200060007000500000708000605000004000508000801
10602750707060203055203025802080687084506030277048654287506734307473504078206020501
10305000504080007070003070006030007040004060000050000000400000800080005060008070001
10352055305075585080464460703044205460526077747730574870407330672080536058668082641
10500060008080000020000030306000800030200060000000305000400030300070300060000070001
10703430644080286730284020602370234030302640308550607048285780805030704750607330701
10700080300080400080007060500070006000500000800020400040000000502050600020708000801
10658050804532603082782080734023804063623226754080333430637538803060376040367060201
10603020400000305020008000700040007000200020002040000040500000004040005060000040701
10705040755370407620504852266270463080808080303023222050607767234558604073525874801
10300080000080500000600000000030007040305040300080003050500000600040003000400000001
10704635755660508862347587683033404020735040886473204080686375806030844750603765351
10700000300000502000000000300050805070000040300000200080000050006000400020800000001
10402630607548706030226770605570705033803680502860702566742050478285806050885237601
10600050800080006040000060608000702000206020302000500000002070008000406020000000301
10703070723063366054607040205056403820802080208075633887282044404040705080255870501
10606020006000002000805070204020007000600020003070300000004000200070707060007050201
10606067506556807880646040403050738050366436272030707056505080237550307025508060201
10402000300000600060004030002000600080000000003000208060005070005030804000500020201
10606580678470327022803043638543402583252883302083706040424452805080603630203240401
10507040000070007000003020000000300000002030002050306070000000600020205000200070201
10607020707038708623774370682270883275708020324070205644434520663820307032623080501
10700040207000600040000080000050000000206060004000800030000020000000802060000080401
10636420868440647080735060337038778282303068506335232050466065574666608046728540801
10400000400070006000200050008000000000003000005000300020008000000000007000000000601
10744582205058344345867877735867768826422888858030238845472227833372657827538552601
10000000004000000000000000000000000000000000000060000000000000000000000000000000001
11111111111111111111111111111111111111111111111111111111111111111111111111111111111
