11111111111111111111111111111111111111111111111111111111111111111111111111111111111
10000000000000000000006000000000500000000000000000000000400000000020000000303000001
16602843828438666020237040806647404072224224302022508230504466705030208060304030421
10000000000000002040004060703000307070000000305000805000302000504050305080306070001
18734857433378208087304060304020503050626260502050806062307053507080568070703042301
10002000000040002000600040400040402070008020005070606000807000003000300060004000801
10657040858080707260537330844360805673208070638070653850402464602873204087675362801
10000050007000308000200080804000800000500060703060007000800000800060003050200000001
10744274306270624070455030403087828040283070307087604064522060807880604020405074841
10008000300060700020500070007000005080002020002000405000006020603000506000605000001
10208043463060302380403064456833206086503280746775708068608880503074827333803047501
10507000500050400070502000000000508000200050005000008080005000605000002000006000401
18807530408824644038502377627270603574234060702042843240284030507845805077736880801
10007000600000407000400060008000200070000050506000700000400040600000705080000080401
10826030346030508670483060406050226020235720606770608872204860806482807030604220401
10000070003080004050002030300060005000800080608000300000706000800080007050403000601
10265538207734574030707060206664308760608430707082364880805282472060527050857025701
10008000700000600070800070300000600050300000408000300020003000007080000030000040001
10208050326280202037785080338380562060735345407020506026426065803863602536566350601
10300030002050004020004060600020800060004000002040006000000070604000800000004000201
10857530805070746450703680805020505565854048573470834526625280505080308468502045521
10000070200060500000206000602070400000002070000050800000000000607060700020006060001
15633070663320608675508040467060266687202060505033406746842034205480464080604040201
10500070600020200000500060500030000000505040307000402000007000800000500030205060201
10608680608080333380784265205822734225402070508850502056204040463277604730802040201
10705050008060000060000000003000000000504070500030002000707070000000508000705000201
10406067472070324052728527403068536770305030802085432340505380635525402076603288701
10008000500030500070000000208060000070004000408000000000700080004000202000500000301
15527450707640308050506560443057478042208565703226372342254082438020407840283570701
10000040006000304050600060004000008000700000400000000000007060000080203000400000201
10275045888333702680605060803545708750842060354424472845807080802650768063445236701
10004000008000400000403030600060200070007050002000000080003060407000600030000000301
12602346308060652456706068627020782035605025206085628350722070328033407027784730601
10006000500060000000804080000080304000006020502000003000707040006000002060002000501
10468030437388202640804080378730804067622070302850306030603067605777665330705037201
10000050008000303000204080000020708000003000600070800060708000704000400040408000601
10562324266080324030407026202070502043502255267070488455702055808060205040805870201
10000000500070003080403000208000506000700000008050500000006080007050006000700050701
10858274307028703080407460804734806430205558805067203278536050374050836820674030301
10007000506000508020700020303000006000602000706000800070005020000060000060300050601
13728060602360708043685070344045355350308040206060547065604082602654275050306250501
10000050800080605000007070002030000030305080008070004000803000800000800060500000801
10803860264040606785402072208036733027306046567625404450406750774370305080868735301
10403030004080800000204000706000005000207000000000500080700000500000707020000000201
10805080203080853850504540208730207340405850358280432070307453403648508046825283401
10500080800030300070003000800060506000600040006000404000700050003000408000000060001
10808750273380202067248083883025204034666070507028202084425630656630408320252060761
10400050002000706000007000008000002000605050607070005080000000300000300030002020001
10868845306063206077507837402256633740508080508070545040372626703044364030776040501
10008000808000005000405000305000000040300030504000700070000000702070000080300060501
13507020503020678280305030302027575080473874704220503546564040806030838523805562701
10006020003020500030200030607080005000600000800050400030004040004050000000500000301
10748033778085704050308450806050804056407770464085546048503037243070383420474520701
10002000005000703060806000300030504000600060007000300070005030005070000070500000301
18602058202240305540442028576037602530568027208680706450507020803036235270306353301
10005000500030406000200080008020008000200080002000500000404000304000007000603000601
10404420704060807062407024503060365045305050263088872563205683308822805032805060401
10504000307040006060007060002020004060008060000080000000500000700070005050007030001
10467076403072423060243270406058604380337083578650463580203330538030646027742062551
10200030002030000030000070502000400040200070000000608000600020600050400030000020001
10802550566040222580255030305220468080803730403440306045343350807060407720605780601
10800070300020700030006040200040007000800000700050300020000000805020300060307000701
10285080808453603044253020838023406032388725322080245630732675508070563050436040201
10808050300000304070005000600030005000400020007040000070600000003020007020000050201
10402060858330705450607473324270334050707080206058422030307665757758707055535557201
10700030000020300000400000000020004070807040800030002040400000300020008000400000001
10808747477380304788733768246032707040375040247625206070658278807070387420502455441
10200000700000806000000000800070404050000020800000300070000060004000800080700000001
10802220606846205050662770708350508066502820806570304735834070742266803060626854301
10200060700050008040000040307000507000208020404000700000005060007000203060000000701
10504030366075772042307070702086807550502030205077385777288067207020508050433440401
10603070003000008000707030507050004000200070004080600000005000300050508070002060401
10604087304777507380753080703020587020263653785020805048402070363570808058404080801
10508000500000200020004030003000200030000000003000402020004060003020208000300040501
10702660265580426047602047767547504443687285202088505080238477507060605370604880401
10604070000060007000006070000000500000002050005020802030000000600040404000400050601
10405060204057806654645230722720633865503050234030305224658740432560605047458050701
10300030306000500070000060000070000000407030007000700080000080000000204080000070501
10356250655440476070642060583078472827702024603652336040363066326724208065656260601
10800000700070008000600050004000000000004000007000800060005000000000007000000000601
10644866608056867847328572838885343467324525277080277868662378262762633273846777301
10000000007000000000000000000000000000000000000030000000000000000000000000000000001
11111111111111111111111111111111111111111111111111111111111111111111111111111111111
