11111111111111111111111111111111111111111111111111111111111111111111111111111111111
10000000000000000000008000000000400000000000000000000000300000000070000000807000001
17508282232764748080766060505546508033868577608076806560503348304050608040402040851
10000000000000003070004020605000304050000000508000706000408000605030502040608080001
16727646573263604084404040403030206040527240606020507032304063805060558060406026601
10008000000060002000800050200070302040008080007020206000704000007000600060006000401
10832070758050402360885560433280805662703040377050422830407584508868807054582487501
10000030006000604000600020804000400000600060504060005000500000600030005050600000001
10277435307740267040556080207064732070374060802057407026442020702640204030803047331
10006000400080500030400040003000002020004080003000503000008040506000703000408000001
10602087832030702250708074583378303052304560636822705037308450303038334236603038501
10408000800070200070203000000000205000200020002000008020008000504000004000007000501
17603480504444874037804573277770306424463080705076686680676040507243203026643380501
10007000600000705000500080005000800020000020607000600000500020500000406070000050701
10262080534020508570634080406080288020474760802560804534707670508734208030202420701
10000070004070004020007070700070005000200040502000600000706000400070004030707000501
10854424208525784080403050503335207420704660307065664240806552348080335080878047501
10008000600000800030700070800000600060400000302000800030008000002040000050000070001
10503040538270504073564020534270688030632885204040405063247074805333308227224630701
10800060002040007080006030700080600030007000004080008000000070207000300000004000201
10832440308060364740803530208020408548385074723370822777552840607070706625802062241
10000080600050800000706000603050800000005030000020400000000000702030300060006060001
15375080233480306678705020752070374764208020806088805825776056406450735030403020501
10500070800060500000800040600060000000704040402000608000004000200000300040404030501
10807830704040355860822323702277676528202020402240602023306070242376605570303050201
10704040003070000040000000003000000000602030500020007000806070000000506000205000801
10803047453060265088532546604066546620305080203032467260602420675726606033202428501
10004000200020200080000000504050000030006000802000000000700080002000402000800000701
18353640504750202030405370656038583087206338706766774568254087343030403780878360301
10000040006000506020200020005000004000600000700000000000002060000070804000600000201
10227076788622803770308040404735306540445060844366887388505040504240474065273632301
10004000002000200000305080400070400040006050008000000020002040307000500020000000201
12805565303060885765202025755030347082302044206065278720478080283053803077764240801
10002000700060000000402050000050403000004070507000002000403060002000002050005000301
10724070527563306550702070864220203064587020708280407080402064407233836570606038501
10000020002000207000605080000020805000002000300070300070207000608000300040707000201
10488585475060544080204048407040308037503885747050487582805086405050304050806720201
10000000500050002050803000206000308000300000004080400000007070003080006000700080501
10785386407088708070202260407434506380407673303048805335878080422070426660327020401
10004000606000607070800050203000008000608000306000400060002080000070000050600080701
12557020202650807067587040636064655420404080605050827064303022403633334070308640301
10000080300040803000003070005080000070702070008070008000802000400000400020300000701
10408550845070606234708055807062645063802066233322608250406380863550802060482735501
10605060005040200000403000503000003000407000000000400050700000400000505060000000301
10303080406060227630304730506470506760306850767570353040308272304455303057545666201
10200040800050300080003000400030507000700080004000404000500070004000806000000080001
10804480474360702052252037547036503024337070408046708088636850455580404780363050251
10700060007000802000007000004000006000602080208070003030000000400000200050006060001
10432573203084403024406523703888235280202040202040266080232764705062633060833070501
10002000403000008000306000703000000040400040405000200040000000304060000040700040301
13707080308030234680606070607082657080226436502220507354325080203020577426205454401
10002030008080600030700040502060002000500000400080400040005060006030000000200000401
10854044644086304050207550402040607044507670666075573038807053485060386220748870801
10005000007000707030506000600070605000600040004000600060003050002080000020400000701
17804056205850202450238037683028708580254048203230202670304070206067385220204274401
10006000200060408000300030002070007000500060002000400000303000807000004000307000701
10707530705060306088602038404030384033304020826063876468708832604325805032607020701
10402000805030008050004080002040006050002080000060000000500000300020003030002050001
10838083202078788060886330505053708740348037233750363450406850845050652033378085881
10400030005050000040000080602000800080700040000000608000200050800020700050000030001
10603660358030458570243070708820867050702330205830702086655880302040704660704660401
10700020600030700060008060700070006000400000600080800050000000407060200080208000501
10668080504762708057436040558073806033454274434030366870234843607080682040336070301
10303060200000604080004000200020004000800050006030000050700000006030004040000070701
10505030334230306230405653268660827030506080703065453050406434843856807068366787501
10200040000020500000700000000040008070303080800020004030800000400030008000600000001
10608842776220705225686754785073204070732050637586404050432442507080626460608332381
10800000800000705000000000700050505040000020300000800030000060007000600070400000001
10308340602332208030277530203670207085406830504860602444264020455688705040287443701
10500080200040007080000040404000502000305040803000500000003030003000304080000000201
10202040255083835082807080408025705550607040203034786753326035504020306070833230201
10305040007000007000304080807080005000500040007060700000007000700020802080007070701
10506063206627208440254080802040842070882286754070808027604070774420804062306030401
10202000400000600020006030003000300060000000006000408050006080004030305000600070301
10307230355860422038608053338458604387857457504058403080856722203070608860708780701
10406020000070002000002040000000700000002070006020802040000000300070805000300030701
10207030403073304354558840766550562526408060476020205464663470568420302063827060401
10200040706000200070000030000070000000703040008000500050000050000000304070000080301
10448630776540662070636040455025675874502072807566264040383027465445603034655730601
10300000500050002000200050005000000000006000007000300050003000000000005000000000701
10553823303075856342673384536624383244348745247030462287365756637426358745447724501
10000000002000000000000000000000000000000000000080000000000000000000000000000000001
11111111111111111111111111111111111111111111111111111111111111111111111111111111111
