11111111111111111111111111111111111111111111111111111111111111111111111111111111111
10000000000000000000008000000000200000000000000000000000500000000070000000406000001
15205657378534375020545080502248404053755226504068704470502867307080604060608040481
10000000000000003080006020505000205050000000606000304000803000203060608030504050001
14654283472277705077507050803030306030862620602030703055406055408080585070402044601
10002000000060003000700050400020707030006050002050702000404000006000300050007000601
10867080327060302840548630773640504634805070452070844440302348306688405038333848401
10000050004000203000800030406000600000700060504040008000700000800020006030300000001
10743232307450348040776050805033636030287050705033208042425040403750503080405023771
10004000300050200030400060005000004020007050004000405000006050205000502000602000001
10605056328020202330407085688476306022504450785386707088708420804035454346606066701
10703000200020600020205000000000304000800080007000005040008000706000008000003000701
14408680204324886023807522267830603865235040502038528420836030504456808044375680501
10003000200000203000700030006000300030000020507000300000600060700000408060000040301
10424050727060306220222050808080442060627330807860807735608530802655806070605420401
10000070007070006070003030500050007000200050206000700000705000200020008020408000701
10386473605647745080505070608783206550506250607087868650204478563050866040737083701
10004000300000700070700030200000800070200000506000600060003000006070000030000020001
10804040737240806026388060844840477040582387303040707043346073704655407324588530801
10500080007060007080006050300070600070002000005040008000000030806000400000008000301
10873760406020352770504830705060707548538022486670662523632670602080506276605033441
10000050400020800000605000502050700000005050000050200000000000805030700070002070001
14387030657620808463608020833050368245308070207026708457885065402670344020304040301
10300060400060600000300020400060000000407040306000304000002000700000200040303080501
10202660608080472220752633303448452373707020202380204058606020353353407270405030201
10705040002070000050000000006000000000704060700040005000205080000000203000204000701
10505088276030446088362766302075685570302060404068756240404340287548607035805244401
10005000500080800040000000207060000030007000508000000000800040003000205000500000301
15888280302480807030406660643054557067702745404386733725765056556070703880735520501
10000050006000303040700060003000005000800000600000000000006050000060404000700000301
10442057573742602360802060504355207470837060627854867753206060204220772048235726401
10002000007000500000508050600040600070006060007000000050003030706000400040000000701
15808867404040354583203028233070872034307062803026838460247050747055504048363440801
10005000600020000000606070000080803000008060703000007000404070006000006030003000201
10588070223433706540206040627320207058453060805770602070202043807245772220408074201
10000060007000302000502060000020302000002000800050500030507000306000300080208000201
10628272247020626030303022607070706074204355824040435582806082705060706070508360401
10000000200020007020506000704000703000800000007070700000007080006030003000300060501
10768267507064308080402260707237803650302382307035608584223050575030334880825030701
10008000405000307040600040505000004000204000805000200070007060000080000020300080601
13867070306730508056384070522042767820705040506030447066302035404323662030304250801
10000020800040502000008060004020000040804050004040006000204000500000200070700000501
10305870264050707633303054707037424063307076628883607240204440448640406080487762501
10705020002030300000202000204000006000305000000000600040600000700000802040000000301
10808070607070723450704780506660208730407480676330422060703524602832405087748357401
10300040200060300060007000800070207000600050003000707000800020004000504000000070001
10803420436530804036523068642077807033856050703085302063824230378340206280256070531
10700020003000703000003000004000008000807050503020002060000000500000300080008060001
10857254207077804074602637306547887750504060805040878080774227205045888080774070601
10007000608000004000406000307000000030600020204000400080000000808020000020400040501
16307030508030485380808070508033827020236652607750808447888040303070822456208486801
10003080004040600040800050406020007000400000400070200080002080003070000000800000201
10846076356042202040608560603070606068406830332066762084306033836050857450785430401
10006000006000405070802000200030504000600060004000500050005050006020000060200000301
14703043203480303760446084254027306250327057608870404720306030605025768620405357401
10003000700070803000400040005030006000300030006000400000603000306000005000608000601
10504570507030806062303024705030536086703050322076868677405462408677404042702050501
10504000504070002020002060008070004050005040000020000000600000600020005020006030001
10277073704058722070432450302077703640732045368750768660202480337020545045365077531
10200040006050000020000050508000700070400060000000306000800030500060800080000040001
10504230238070324460464020504630628040608880405570606073652620202060503620805460601
10300070700030200040006040600080007000200000600070700080000000408070300030506000701
10744020702458202054225050558086508025828383387030645630528244807050385060737050201
10204080200000402050005000200030003000300030002070000040400000008050004060000020601
10404080827860805350405526384870725070405080603067784040406388757236703054885472301
10700080000070300000200000000070005040604030800080002070300000400060005000800000001
10208823387420607868444326776066207060645060334354705080485328602060733780305475331
10200000500000404000000000700040203070000050300000800060000080005000400040700000001
10408220808747307040353380304680505037403520305220408442828020234373603020557855301
10500020700030002030000030407000207000506030605000600000007040004000302060000000401
10608080464072673084307050206084607370402080302032374525545045608030502070537420701
10808030002000002000304030602040002000600080006070400000004000700020304070003040801
10303052404455202680485030502060732020775588333070307035407060578620706024505020201
10306000200000200060004070007000300050000000008000808050007050003060306000700080801
10502230438440244087505075727788402767837753204035704070353365607060804660305530601
10808080000040007000006030000000400000002020002050606020000000200060303000300040401
10804060205032807265664640633570583782604070727060208655775670564280604042555070701
10600030307000400020000030000060000000302080006000200080000040000000205050000080501
10876740628330422040256070263087637445603038705833253040457023737424802048758580601
10700000800070005000500070005000000000008000007000300030006000000000002000000000401
10675566802034625765686378837258772443425344547020553544247673477288373466382737401
10000000007000000000000000000000000000000000000040000000000000000000000000000000001
11111111111111111111111111111111111111111111111111111111111111111111111111111111111
