11111111111111111111111111111111111111111111111111111111111111111111111111111111111
10002000000050000050000000000020003000000000500000000000000020000000000000005000001
17602070288020385050633234406040602035766240405680306275502740703832783328804030501
10000060300030002000600000603070600030000030003000400000200030706000300000605020801
10443780606758205086577540405030378840502028265035277760638060603020505480405060301
10003000500000004060000070807000800000703000400030000050800080500080203000700080301
10204077584632635740202040703272402332305370607730672040803450206250507738225540301
10806080000030000000202000600030006000600070800030007050200030805000700000006000701
10805060362050485547863420553050406022273030286084727040834030607037644540205382401
10703000404040800000400030007000704020000020303000600040807000804000700080205000701
10203463503040703354206053376022207030583580502230803220505523406780802046303060401
10700000005000600000608000007000303000500000800070007000807060003000603000206020001
10582857575528828680604724208072804872606083487070264043806080476087705840508074461
10000000000000000070400000804030004000405060004030200060008000200030005000507000001
10845880364434564050723380606030225570304670804050506840807263708070274066803357701
10600020000000500060000000704020000080800020300040400000600000708040003030008080001
10704057422070605773623736207026336040546020607220206882726556708487704050446050541
10003070004080300000003000006000002000506000307000600000007000200000202000400080001
10875080202060364673404080853663805535705076806062656838563080476650303088205080301
10003050505040600000700050500060500000007000304000006000000040000030004020008070401
10604020608020504070404627503020824677725080202746404070428025444032453230602048601
10405040702030003050308000307000400000004050600000800060003000003050000000302080001
10308068602058357070376080405584336356608020533480462843207327305050304454703070351
10802000004060000020000080003000000000006060504000600000404000508000508000406060001
10704765688024208438646654322060343384762020607053205540263020404280207040603072801
10406000004000604050000070002080000000006050808000008080002070700080302050007000501
10608065203340303070207050202050564046508070708056476023406320323020806070675740201
10700040003000700070507060400060003040004070502000300050003000403060707030500020701
14478820723020465440804030365850804730588080208070206760477040807030604023602030501
10002000200070200000603000800050300060700080008020800000800030300020703000605000601
10352074403778703067208628784026225020402670483820682388608050445528606030502435301
10000080006000005000700000006040000030300060500040200030002080000070005080200000701
10234580558068745880444424303080347440604033605050704030568040587880473030274540201
10000040000050005060008000703060006030607000402000506030205030800000600050002050501
10842057844040807060802050705030306070635060226758504040202053408332225077404020201
10608000003080300060800080500030800040004080200020002000306000300080008000300070801
10305042703020436580207880435528608333204240504040466863203380507080408040664860201
10705080003060006000500030000000400000400030008000800000500000503070702020000030401
10505040464568403026347683847220352477476050864823607030754637746078306044344270601
10606020000060004080003000600000300000500080000000603050000000003000704000300070801
10804068885070825020802030805672202320602046582655702074488230805870305043603050201
10002000004000305080500040003000503000202060000000005030000050600070504050007000501
10476457607483203080347766847050743044404520402785228064726030642780804060844823201
10000000700000002020000000800080004000800000200000503030000060002000508030000000701
10484520422583842060273420205062705840657820784880204080707383666054503078533230201
10000030005000000080000050804000500000700030003000607000300000200020005030007000201
10565040406028635585502050303050872772554030578086408070728220508230524040507057401
10002060303030004000807080402020000000008040700050006020003000405000400060600070601
10602058407070805380537050503735686023202046802560608036706056705054806040384880401
10504000505000500030004020507000003080003000400000602000204000800080004070000000801
10303040504234425085508070208048202030247440808578852420452750274340354470722336801
10804030400000004000706060408080007030000020204070005000500050004000400030500000601
10708020786767303680607060603060435073636030804070408027207078406062504026305047801
10605050000070508020703070004050006030300080800030800040008000607000007000002060001
10706840328020304060706036234276305070304620406220622460506670402546423284533020271
10300080007040300020007000700000005000802000700070000000700040400000000000300070001
10854054465070223274728480205062552277805038577734207265342040203036556240755750201
10005050006050600000000020005000008000008000003000802000800060804000700020000030801
10703020302050402047867060743362208053273025208040738030302650706426502020688040701
10407080700070408000800080300000705020005020005030004070006000700000403030008040401
10608020265460808060505652407060336040402730658082707036884073434870383080703045301
10506050000000206050602000004050003000500000300060004000700030000020002060505040001
10502044756867305250705075542067207562786383606730532320506447874035807073704030671
10406000000000500050600020003000500000000050006000800000300000000020006000806080001
10605565232750866020527482808070647220646022856074302063865648623520668430725060401
10300000000020000050000000008030000060308000003040004000000000000020000000400050401
10756538233055476576874670874082546080705054704030406034525562655050375836407056201
10000050007070400000000080200050800060006000800060708000007000500040000000703050001
12256060503060802233878070608880702373387036724380208857667040703434664440508030251
10008040802030502000300050200000300000005050000000206000300070300030003000408030001
10227070702040404070704650302323573423506520835350246070607350736080402043402038201
10000030200070005050007000400000000000406000600020500050007000503070204080004080001
10627750805662878040524030844776525450808024503044806474746047708040207320235040551
10004000405000000040600060000000002000404020704030004000200060008060800000600080001
15825020558070306380304658656347204040304070307070633030608060853080708064503084201
10002050400080600030407000400060006070303000608000600050408050000060507040004000501
10406074702040472780802530402330787060503227603847608020405032374580506780578430301
10700020007030500000700080800000200030500080006000005070404000200080208000700000801
10848260472720408388444080403278303642484630505087585860804452302050244043373374201
10000000400040602000004040700000800000005000704070000000500000202000300070000000001
17278467402085306072768020755445465434408088472030578842473850503467402040756558231
10000000003000004000000060000000000000004000000020000000000040003000006020000000001
11111111111111111111111111111111111111111111111111111111111111111111111111111111111
