11111111111111111111111111111111111111111111111111111111111111111111111111111111111
10007000000050000050000000000060006000000000800000000000000050000000000000006000001
12408060444030742050352385702030803074335620304530504843203620708453765478408030601
10000050800050008000800000402070800020000070005000300000600080305000800000603030501
10224280503683304046825750607080284330708084458056526570477060702040505320607050401
10004000800000007020000020602000300000302000200070000030500040400050602000700030701
10204047586873568430205040704724707327507430503640678060408880805420402355864440701
10503050000030000000503000300080005000600050300060007070500030204000600000002000301
10803030883020455484855520356030705037425070522063262050328060608033472320605762601
10403000604080400000500040006000206040000070304000600030707000405000500040605000401
10804282504070607448605034474027806050563770804880806470602874404480502023307020801
10800000008000800000607000006000408000400000600040003000803070005000402000208080001
10488465754857884860405474206058807383808057255020648074303030283086507530208054871
10000000000000000030200000207060002000603070008070500070005000400070007000508000001
10736730565222425070625640604020622770605860502040704660805632807040657052502573801
10700070000000400040000000802020000040700050800020400000600000307080002050008030001
10202024742070305884828678702027263070673070707620504738353486804744804070257030751
10003060004060600000003000002000004000702000604000300000006000200000806000500060001
10246070607040656826602080634234208785707065208062438755753020883830706038406060201
10005060203060300000700050800040200000003000204000004000000040000070002070003040601
10302070805080506050804635405080324346648070804652802040483083583046556330803028601
10507040403020008050206000606000600000005060300000300060006000002020000000304040001
10208032207033525060338060806364458486204070332380323822204548702050608676205080631
10804000005020000020000060004000000000002020408000600000808000605000507000706080001
10204668388026303736732242523040525244672060508054404580364020302820503080808052501
10402000008000807070000080002020000000007050305000004060005030500030404030004000301
10707043303530502070804060604080873068803050404044882068208850878020702020466340301
10800050003000500030407070400020004080002020705000800060005000805040503060400080801
14635360222030588480505040352670503760456040805050306530583030405070503034305080601
10005000500050600000702000500020800040300020007050700000600070600040606000503000401
10366073603848403038606254564035278060505560632580737235502080737757407080404546601
10000070003000004000500000008040000040300070500040700060003050000050002030800000601
10532870243048374740353566207040556730204046707050202020233040384640453040826250401
10000080000070007030008000308070002020507000203000704060703040800000200020006060201
10453062735080603070707080207060506050822080338772207030305038508526626085408040601
10407000006050500030400030800030700040006080200050005000602000200080004000600070801
10505036806030246530605650248285406844802630407070565763802860507020708040455640501
10302070007070008000600040000000800000700070008000700000600000208030305040000070801
10203080534333405065474424256460223452646060856843305080886676276033304066656280301
10408060000030007060003000800000800000300030000000507050000000002000803000700070701
10702063843030264070502030206625605820205047427483307087683860607650806087502020601
10008000003000204060700020008000805000506060000000008070000050700070508020006000501
10335283308376407050347282752080375084402730304487778067338020788830308080853743401
10000000800000002070000000400020005000800000500000205080000050003000307040000000801
10367630643725853040856350207027302220647350883770205070406848572027203062458570201
10000070005000000050000060404000500000300040004000708000200000800070002030007000501
10223080508067685224706040206030334262478070674047408080473360704470243070705027401
10007020608080006000702050308050000000008050600040006070008000403000300080400080701
10702067704080204480678050304734632044403065702820307048304064503023708060424640701
10208000704000600050007070504000005070007000500000808000608000700080006030000000201
10303020708466836026307020408057708080366620607623226340368380775220438870368548801
10205050600000003000708060403020004040000070407040003000500060004000300040200000401
10203050327382708280605060203040686038824040204070505026707077702082807035805058801
10504020000030304070408070008020004040500060800020500060006000603000002000005080001
10408550438070502050308065888644804080205760208820243730305440504847874387826060221
10500070007070500020005000300000004000504000200030000000400020800000000000800020001
10526057578070268882675630205066757642302084534753602732574060506075246880627760801
10004050003020400000000020002000006000005000005000508000200080307000800080000080201
10705050406050607053872030648576203045452026504070765050407220606878205030645050301
10206060700070308000200020700000505020006040005050004070008000400000507040004070401
10308040672770206060507737807060358050205260236036305044477023586380638040204043601
10604030000000802060802000008060007000600000200040003000400020000020007040202020001
10608056837775306380702064645038705676236477803780836270203746476025207026203070881
10206000000000500060800070006000700000000070008000800000700000000050005000204050001
10707453646570842040263362707080466520225062345062706027282783566280842620777050801
10200000000020000080000000006040000050507000007080007000000000000050000000600040201
10824367854038355566344370868065776070702087805040804046737564378050438353507046201
10000040005040300000000080200060600080002000600060708000007000700080000000304060001
18727030604060303222838080208320303725445076624630805627388040806567865360806060751
10007070302080602000200080500000700000006050000000602000300040300080005000406050001
10673060503030702050508660504825555826208520377470536020705840825070804038406032701
10000080500060002070006000400000000000403000600020500040006000208030707040008070001
10874430704256686020534080342763568830804022305052502782466046508060802740756060331
10005000404000000030200020000000005000307040207060007000300020003060700000300030001
13556030688050204540706437425434403050704070706020787050707050325070605072706083401
10008070500060500080404000300050004080303000607000400050206060000070208020007000401
10508082407030677280507360303250288080406545405732508050806075645360805220777620301
10600070005080700000400030800000600070500070002000005080702000600060602000400000601
10733260735480406445236060702636206887285520505042254830708366307070247064452784301
10000000500080703000005040600000600000003000505050000000600000802000600060000000001
17277562305034706056227060833636887253306062447080552455644650404587203040748435521
10000000005000003000000050000000000000007000000040000000000080002000002060000000001
11111111111111111111111111111111111111111111111111111111111111111111111111111111111
