11111111111111111111111111111111111111111111111111111111111111111111111111111111111
10006000000080000030000000000060007000000000500000000000000020000000000000005000001
18804030326020847050252622602040404088256350502240604588808720404282265884502080801
10000070300050005000300000202020500040000030003000700000500080503000700000504030701
10887730508323607028586430702060887660707043887047478360584040408020604580602030501
10004000300000002060000070602000700000802000600070000030700050700050606000300070201
10408063786448737720604030405874707425408360604830554060505630402830405662682540501
10505080000040000000807000800020005000600080200070005060500060804000500000002000801
10806060457060658628856530575020308028587020266087267030644020304045577780303865401
10502000306080600000400080005000803040000070804000200070505000202000500030203000801
10802236408020402884708063823032508040285540808650203720702363703380807084803020201
10200000002000400000805000004000605000400000600020005000306050005000406000807050001
10867838722237445650804857306036607567404055575070455084706060623076304720203083231
10000000000000000080600000803030007000704060008020700080006000200050006000605000001
10228580764645784080863670807060372260505650706050203450303678508030783072308528701
10200020000000800080000000705030000070300040700060600000400000305030006080007070001
10702084647040807842457875608034478030255030308560204444524435503236507020444030341
10004080004050700000003000007000003000406000203000500000008000600000207000300070001
10345020303070543647205060665342502666606043505035444465344040772820303074807030401
10003060608060300000400020400020500000007000308000004000000050000060005050006050801
10207050506080303080804666604050785274366040302382606040734066624068423760707036401
10204050207080005050304000306000200000002060300000400060005000003020000000803070001
10504054207032638070238080307767757623407030582620354768705683804080802878203080571
10206000008060000040000070007000000000008040202000200000204000702000305000202040001
10603887536043802475553737685070587745442040202084308470326030202580508080304024701
10502000007000607060000030008020000000002060302000003080007060200050205070006000401
10208058204340504030308080305040868025505020302043842082302770852080608050733670301
10800020005000300030804030800020004070007040305000300080008000506080405050800050201
14448250787020574360503020863440302320467030608020804670246060805050207078403030201
10007000500020500000404000300030400050400050006040300000700060400040203000206000601
10585036304756408088208242568073645070207330444220547828705030784866803030808544501
10000060008000003000600000007040000050300020700040500080007040000020002030200000701
10338340643038283750642243402050686660208074508070402080482080822370534070638250501
10000050000050004030006000204050005040208000705000708020308030600000500020003040801
10686033336050203060206070407040202040557040535382705030407077405432356022808060401
10502000003050200020200040800040700050005030600050005000408000300070004000700050401
10308072207080863220303620524734707665408380803030878245304530404040604020228330601
10305070005040006000700080000000400000700070007000600000700000703040707080000030201
10605030665258406042763865878520228455425020564288603080742683727055403062265230601
10506080000080002050008000800000500000600080000000305020000000004000808000500070501
10303082634060587050605050603284308640802048348428403034457360607220807083704020401
10002000005000505070500070007000408000204050000000002020000070500030704080004000301
10567254506778607060653564462040768036407460408477832038555040226640608050368864501
10000000300000007070000000700020006000800000800000805050000040006000702080000000401
10353730226484874020825720306082408650234640473850207070502638426028208072782720601
10000050005000000040000070203000400000200040003000507000200000600060007080005000301
10662080706086742673206050508050342232273080863032808030622380807580586060603075301
10008020607050003000403020404020000000002050800040006070007000508000800030600080801
10303087803060708280233040503546487074806022308350605066306075806065807080644630401
10207000302000300020002030304000007070003000400000705000707000300020004020000000701
10606050307466875022207050507054703030884860308556247860367420287370365540523648501
10808080700000005000606060808030005050000060207020006000200040008000600030300000801
10206050365665506320806030607080542037832060603070307063305055608042302083703056301
10708050000050604080306060004040006020800060200020700080008000604000003000003020001
10807250735020405060407082335254802050602570705520242360402250506884228677266050821
10600060007080400020002000500000007000602000800040000000600060500000000000600030001
10236047643080534737376340404048328823508083574625805578224040206072332330728570701
10004030006050500000000020008000008000005000006000602000400020803000300040000080301
10302050705050503044457030347223302072745043703080277030506630504228603030273080501
10808040500080507000800050200000302070007060002020003040008000200000802050004080801
10308070486420502030305465503080636060507680638048604025884024365680237050806064601
10304030000000204030303000006040003000800000800080006000300070000020002080607080001
10804054537838705740802028864052308876438785604740423250504862382033705056803080731
10604000000000400030500080008000200000000030002000200000400000000030006000808070001
10308243277270272040672233803080236560324023635035204047367524584270377870437080301
10200000000040000030000000007040000070802000002070007000000000000020000000400080601
10435527756038886422774580576034475080505042206060703067774534453030634263705036801
10000080004080800000000060300030300030004000400070302000007000500070000000203060001
15672060408020308328465020405660307488886078647670508224358060506636866540702040361
10004020404040607000200020700000200000008080000000807000700040400070005000205040001
10355080403030408060302860207633232646706850387750323060408850245030507065806083501
10000070800020006060002000800000000000406000200060800050003000405060602030007040001
10736820603725354060477050265244272320502072505028705253347035603050606620644020441
10004000704000000050800070000000006000802040207070005000200040002080500000200070001
14246050787080507320305763585574704070702050205070562040707050282040503045403024801
10004050300050400030708000400070004080303000707000400020202050000080504030007000501
10805034304060553520802550204240772020805338306374505060704086833540306330322380801
10800040004060300000700040500000500060200020006000004030403000400030806000800000701
10383260283340703744375020507864602585337450405027522420203855605030876032746384601
10000000400080507000006070500000500000004000204020000000800000404000200040000000001
17527534706024304088333070588423245678707062357050744288666580803435308040327644381
10000000002000007000000040000000000000007000000040000000000060006000003020000000001
11111111111111111111111111111111111111111111111111111111111111111111111111111111111
