11111111111111111111111111111111111111111111111111111111111111111111111111111111111
10002000000050000020000000000030003000000000800000000000000050000000000000004000001
13702050334080874070588754204060806077746840705620704467802280602624827673402050401
10000040600030006000200000204020300050000030007000200000300050407000200000407020801
10286370804846702084423350606050452320402066465052745420256070204020406750505040701
10004000300000003060000080702000400000606000800020000040200070300040208000500060301
10704046736343532860507060606642405248704740705760724060203580707860805648565780301
10403080000030000000604000200070003000300070700060002080500020605000300000007000501
10806020262030482832378820635060502072472070545076734040353040307055762450403476701
10605000403020800000700070005000304040000030203000400050203000403000200070308000601
10206844407050503353303065445032304030244870507650504620605647706580304022305030701
10200000008000800000703000005000304000600000800060006000307060007000705000502020001
10443337675334543450402573406042304376305056335060726068608080642022403750606066431
10000000000000000030400000307080005000304020006020500060005000200070002000703000001
10465360743246387030764680506070635870806560702030204350605764303040437065302658301
10700020000000500080000000703020000070500070300080200000200000502070007040008080001
10503086432040303327675724202047887040446060406280306565766534707284307030423030271
10003030005030700000008000006000003000404000805000400000003000400000505000700040001
10838020302020342487408050427543708665505076305073446444758020868630408062405070701
10006050804050500000300040300050500000007000408000003000000070000020008030007080701
10203080204060604050405377308070343445237040805488802030432045363047775470503072401
10708040505040005030208000504000800000007030800000300020006000003020000000505020001
10804085702052735060768080402658836473603060426580868254205852504070208882204070761
10704000002070000030000020007000000000008030602000500000808000608000508000206030001
10706648246088607222465683646080468788783060704027502440454030204320506080306067401
10306000003000304080000070002040000000004030206000003080007070200040805040004000401
10203058808740208030302020507030255062506070308085238022606320268070707070224280201
10600040007000800070207040700040003050002050703000800040005000408030404040200080201
12548470286040265550606030745520407250725030508070306350828020708040504038802050701
10006000800020400000703000800070600040400050003030400000800070800060807000706000601
10772065602467204065806553854058685060804670272280834468807030732462608070506382801
10000070005000005000800000005080000060400030800020800070003020000050004020500000301
10272260426065525320652638208060464340603074503020205060476040773470574030436480801
10000030000070002060006000508020006050506000705000407030805020700000700080008070201
10234058487050407060503050303040505030537070543377605040304087702353286045705020401
10408000005080300050400070400050200070008060700050004000606000200030007000300080701
10606048202080526430502840676623202878504520706030765588802670204040803030233220201
10604070003070004000800060000000600000600030004000800000200000805070804030000050601
10508030333483606065843433546870688524522020328544403080555426674024507022884860501
10802020000040007030002000400000400000700020000000205080000000007000308000700060801
10502066637070364020507030803243304580405048856787704087537630206220707055402060801
10002000007000406080800040007000308000208050000000002060000080400020602060005000801
10338565607733604040472458587060466025308570608665485042845070638470506050282457501
10000000300000002080000000600070004000800000300000308050000030004000805070000000401
10627460233844628020647880807044305380675630336870208080502388552034208087872340301
10000070005000000070000070505000400000500050008000406000700000500070005020007000801
10663020308082636277806040702060783382576050573046408020543880504870556030407038501
10006060405030003000204040205050000000005020500080005030002000807000500050600080401
10504058206020405750468020808688538066404036604430506058604062704035706060666220301
10706000806000700030004080202000007060008000200000702000205000300040008070000000301
10205060803447355062403030802058305070773830503668488750572520336760844680567344401
10408080600000005000606020703060002040000060802060004000600040008000300040800000501
10407030822237506350307030305060642067338080702050507047604025705056404064802045701
10508020000060307050306030002030003060400050600050200050008000704000007000008050001
10304580538050504020602085752523605050504770607320257820607470508872784462382040661
10500080007070800070006000300000003000305000500050000000400040700000000000500040001
10447066274030545533276440403087388868804047822438604443865070505083547870284620801
10005020008020500000000030006000003000007000006000404000700070307000300050000020501
10807020205070506065785050424573605024823087505070824030805660804383306070733040701
10608030300070806000300080800000806040006030008040005070007000200000606030007060401
10805040653530502080506856703080844080706230528024506073654087236430287050503032401
10704030000000808070607000005040006000300000700030002000600020000080003030406040001
10403025836886604730806054233035308378658728806250655760807577256045802026805080261
10804000000000300050500050007000600000000070002000700000800000000040002000406050001
10704324833540553080223562407060626260354053743023602024774338746840752250726040401
10600000000020000040000000003060000080602000008050007000000000000030000000300060301
10572843546057354222632440264028822030303028404080307084222348526030453734405057601
10000060003050200000000020600040700070006000800060504000003000800070000000708080001
14482060408070407237456070707820207244286064228230507635368050506342245820608060321
10005070705070605000600080500000700000008070000000604000300040200080003000704050001
10235050508050604060302880806366858558408720346440346030603780768020408043804065801
10000080200020007080006000400000000000704000300030300030008000306030305030007080001
10782850608732465020584060536353386520404073602053208263562037804070802330568040821
10004000804000000080600070000000002000205030305080002000400050003040800000700060001
13733060524020507230205566227664508060508070204070776060703040525080705062604048301
10003080200070400030304000400080005030605000404000200050204070000030508080002000601
10807037406070466660302830807660676060606444608636603060605053843760704430236860201
10400040003050400000700020700000200020800030006000006080205000800060506000300000301
10685450282270604432383050402842407857432740403026748750307885603030874034568288401
10000000500070705000002030400000800000003000603020000000300000505000800060000000001
15588864504073308046837060223762738856306087673040646872253450808354808050672823771
10000000006000008000000080000000000000002000000060000000000060005000006080000000001
11111111111111111111111111111111111111111111111111111111111111111111111111111111111
