11111111111111111111111111111111111111111111111111111111111111111111111111111111111
10000000000000800000000000000040000000004000000000000000400000000000000000000000001
16302464282340466630306832338087205086507460807078308830562020308862672786375554401
10004000000030000060500000004000804000500000806000602000700070406000000000000020001
10207282245050722080663744803720703270638266357240204025202420786050382477588060551
10604000400050803000800000800050705000200030002030304000004030003050000020008020001
10503060206050705822305080247030607044708043406020605823662020808023434640504020701
10700060008020007000003080802080004000003000603000400000600060200030000000800050801
10787028777740585040383030603057675860663760407866263340506442377880867533388050201
10007020000040700080005040002000000070000040505000000070800000000000600000005060801
10207280207027808077408072583577564020223020607080388080684434327428306658506680701
10700080703000008000508000000060000040002040007020003030003000700000202000300020401
10688040803484483370506765444520805435404028842066508037308040408860208060884088801
10007000505000000050400000005000700070005030000080506050005060005000407030005000001
13205733306070308025564567762057388060408030606430806050542030724028546070302352401
10007000800020206000003050006020600080203000500030008050005020007000008080300000701
10456620604250483078503060602050508450807443364882456030504050307365702080843450331
10000000500080003000200040700040003000700000000040000070305030400000200060000050001
10565238202057604476452570542330457050828585245020382745807023365880255587775250701
10000000504000500000003000800050800080800060200080000020004000300000200000000060701
10267720665460687448807088524040704356306080308687636070326550304727505434533036301
10000080200020600000006000000070200000003020002000005070000000505000305000500070001
16757330406020708047668845704775603770847045722045546050545558486020508020402460801
10000000702030304000000000802000400060006000006000003050000080004050004030800030301
10564533605050207288205730547040637057257450305675503073334050202034438030536080441
10800070008000800000800030200050008000000060400000302040000060707000000050500050001
17803020606537424550276720302532808082677077303880403077354720206838247384508038701
10006040803000000050000040607000007000007000706000304000000000500050008000003030001
10763040346027567087784085702070746262805430805083407447302885456040606020582070621
10006000300060007050004000206080000060006030804000307000300070004000600070005070001
10204243603040303070332840834037257020886080642630205040227032602048633378305054601
10200050006020400070000020008040000050500020000070004050600060003000000030006030701
10655050578070448332275080506030335240403422677087767350206750602833588070672080801
10603000700030000000000030706060200060005070004000000080300000702000000080005000701
10505583608055824723686540706030205042668080507027224060886572672053277340205523501
10300080806000000000000060500040007000005000202030007050006000000020000050200000401
10606040403046265348866050704048236250805537806080204075607325423470453060363430801
10406030007000007000008040205050000070400070002000406000400000000050700050000030601
10554080427757706084802030302080635088767060584468605450407765226080308038347020201
10000070008000808000200070608000700080000040000000403000700060000060303000006020801
10767323608088805020822780508575343560406458736780704034782280407725606465255070501
10800000508000004030004000800080000000200060000000306050000000204000006000700050301
10205880307555386775845075864020328763367330744752807060407447808055582030507860801
10008000603000300040004040008030800000000060006080003000600050503000004030200050201
10732034704080503060304020665070602074684055203070207640433070308265808074777030201
10006000600040407000800030005060005020002000007000800080206000607000302000008030501
10608720638350306334682488508055835320708485543622872020408020305080707538303080601
10600050700000700000500070004080000040400000200070002050404040704020500000600080701
10456040708748755650204060653040563070507650204050506030505062503070877280643050701
10002030205000700050402020000040006000602000803040700050407000607040000040006060501
16864030807020408070308072422834708076806027405030888760207460808054588064304080801
10007070805050002080204000600000808000506000304030600040007000308000302000802080601
10602080505050637820305730705270702480402670667020684066525663503560308070302520301
10200070204060006000606000506000604050206060008060006000000000600060808070600080801
10488740306063705064608067804052605060403060702042603765878480605070503050666070701
10400050806040004080008000008000008000602060200040200000000000706080704080006000501
10302070503067664070804528307827533685408040687780808547652467708040507055306366801
10504000807000007080600000500080006000007040000000300000007000005080206000200000501
10706466208723603040804730782050408084655028848440608864544065863070204632586040701
10604000704020003020207000500070308070007000500030802000007030200050300000006070501
10208420607020875030804085803720204070805280702060666075204030704660803785804020601
10507000300020000080608050005000305000200000608050300040002050500000800000802020301
10605078658546445440806042734050302877686386802026208440703070242276425350404780401
10600080003000000000206000000040200000000000702000004000403070000000005000700000401
10262330407030222527308572557857658757628670325272766040406067254855607067562666301
10000000200020600000500000800000200020000070000000008040402000000000806080003000201
10583838778820308480708380207630206070353064637280305040508434748740206035704040801
10000000000070403000400040007000605040300060000020300030600000004060002000005050001
10363350644750408064286053385060477050607450276057467620306785802050823336482033621
10000050005000206000008000500050800070600000200060000000600000204030000020000080001
10557053507078404835503638708552704560873530604780884782454860707025326020353720501
10003000506000207000700000500000608000300020402000800070000080400030000040000020201
16306480206740203050783780545770503030308036602052888080446780687360305827527078201
10008000400070703050000030000080807070405000204000008030400030005000800000002000001
10707054784060704023208024248070304032808330302075303050702033806086764680807336801
10503040003070008000705000003080003000400070007000302040803070006020000060300000301
10445046506052555440408227284048844840257038767220804050308030348050243076545060581
10004000808080000000604080000060002000300080008040603060508070300070600080004070001
18502630805060203286203060282440402020502356304020304050207050725530803220804078401
10007000706060600000700050000000305040800000006000600030007070005030200000707060001
10346066506080204740585455435662208030654864645322845865248078503050703675405860401
10004000002000700030000000000000500060000000000000000000003000008000200000300000301
11111111111111111111111111111111111111111111111111111111111111111111111111111111111
