11111111111111111111111111111111111111111111111111111111111111111111111111111111111
10008000000080000070000000000040004000000000400000000000000080000000000000005000001
12805050764020533050662727803060602075268450404640606237708430806642548747708050801
10000040400040003000700000603080600060000060008000500000400060307000200000803030501
10242230706848604073575670507040456230307054647045232450238030505020408480708050401
10002000500000006050000060303000600000806000200080000060200030800080803000300080601
10508066484775683530306070804286505546603630708540345060605520306740504373637260401
10302020000040000000702000700020002000400070700070008050700040408000600000005000601
10502070263070562254575750447040403038424020754035468040666080303052573660804722701
10407000204050400000600040002000606050000080504000400040305000402000300070704000601
10406324702070803482603032753076204050645420804530502320505677603440407063607080701
10600000002000600000804000007000607000600000800050004000607060008000702000708040001
10572632734828328380702336208067705773705085657070287036708050484073304280308043221
10000000000000000020700000706080004000308080006080200050008000500040005000804000001
10424250457862575070772780502040765220302430403040307320705424502020745028408425401
10400060000000300070000000404050000070500080700080700000600000206040008020008020001
10204074688060705767552386405083683020335070305380208487825656308583308080588040371
10004040003070300000008000003000002000403000307000700000008000700000707000500020001
10688020803020584587403030842327804636706063508047365485372020842620508054202030701
10006020207070800000300070200060400000006000502000007000000050000060005050008080301
10307070806070806040605662306060232248256070707635404030425064747073542620502064801
10705030702070003070707000307000400000004070800000600070004000003060000000806020001
10406026208067272060662070505476285423803070376360873828305428205070405367706060341
10607000008050000040000040005000000000008030308000200000607000502000403000504080001
10506636786082802627748255784040332824873080304076607320872080507580507080706066801
10208000005000406030000050005040000000004070602000005070006060600040702040006000801
10307064403430208070805040305020643066207050606083737087308840652080603040874840801
10200040006000700060705040700080002050007020607000700020007000505070802050300040201
16548530255080222780604040348760304620437020605080808820388040706080505047308060401
10008000400030700000604000300040400060700070004080400000700060800070202000708000801
10467028806642503048603773672034883080805520668330573372307070325443207080405646301
10000080005000005000700000004020000020700050600060500020003050000080002080400000701
10627620344067522840782464502060675720207085506080805080776020626660323070764880801
10000020000020002070004000308040004060607000506000303030507070300000300080006050301
10837046325050803020402040603050406070842020454874605050804036308866543076804050801
10604000006040500050200080200030500020008050500040007000404000500050008000400070601
10307026505040468450407850237223504363705740203020888846203480207050804050584650301
10203070006080006000800020000000500000200020003000300000600000808080608040000080801
10805080375723407054578324245720678322327050483343708070756375274085603024728540201
10602070000060002060007000700000400000200040000000205050000000003000204000500050501
10402042228020834060507050402267502270202058648264504057355850508730203045404020501
10002000007000707020700060007000306000602080000000006080000040200030506060003000701
10254252308764204060276435772020832043603750305783235066778080344670703050783684501
10000000200000003070000000200050008000700000300000802060000060008000705040000000701
10583770886576266040265370707047808280328830346220405060407824753083607085736880201
10000040008000000020000060208000400000500060008000605000200000700020002060002000801
10388060204033755566704050206030874572883060634074603020782430204480555050804027801
10004050705070004000805070205020000000008030700060007050006000307000800060800030801
10206083207040206820338060804885545075304024703630502047606035704053307020738380801
10504000506000300040005070807000006050002000300000706000203000200060008040000000701
10408030802548768088306060604043808050438630305668462760456470572230478370775355601
10805070800000006000407030402050007020000060602070005000700070008000500080200000601
10706040272484502550307030606030533082557020508030503035602054306037204076207067501
10207060000070307040204060007050002070300020400050600060002000806000005000008060001
10402620746040307060408083434442405050703380706670478850702350504822672585228020561
10800030008080700040002000500000008000503000600030000000500070700000000000400040001
10378086634060383364324520203043746325703057526642203825627040707038576730756220301
10006060005030400000000020007000006000004000002000507000800020504000400080000080301
10604040604060304068763020354238308084523024805050782030503220305284407030725050201
10706030800070302000200040800000505050004040003060008030005000400000206040004060401
10508020432440804060306542508040376030508670445077407076282068362440562050306077601
10507030000000606030205000008020005000400000500020004000300070000080006040407070001
10306077846827304620204072554087403846552743206480228320303843654065805067707080261
10807000000000200060300020008000400000000030003000600000800000000030003000304020001
10704844388880546030658865606020878570258025636028303046244885422270552450676040501
10700000000050000060000000005060000060807000004050004000000000000050000000700030301
10758572786046267473875270264045323050305063406070702085455823636040847348206076301
10000020006070700000000030800040600020007000600030802000002000200040000000604020001
18836070705080406564464080203730304428855042743740603873257060808756648370304060231
10002070304030407000800070400000800000007060000000307000300060500030006000806030001
10284060506020405070608320507283754585306520387880536050506760356050806083703064601
10000050800040006080006000300000000000507000700080800030002000607040403060006040001
10867320404372288020268060446364728320506068406077407244588023405080803730687080251
10005000703000000020300050000000004000304060405070003000200020003020300000600020001
18236060584050808440604745473888307070306080606080425020705050387050408056306038801
10002070700020700030405000300020008040705000403000600030404020000030202040003000301
10704035208040744750807840602420723080304566808846505050505042284620403680854680501
10400070005060700000600070800000500050500020005000003040403000700060602000200000301
10448850522270405672475060203267307668452880408038428640307484704060852058483762501
10000000700020406000004020200000300000002000804020000000400000808000500050000000001
17556564706065306078857040828244337725602056673070377235263730204728608030265232681
10000000004000005000000060000000000000006000000070000000000080004000004070000000001
11111111111111111111111111111111111111111111111111111111111111111111111111111111111
