11111111111111111111111111111111111111111111111111111111111111111111111111111111111
10004000000050000040000000000070005000000000500000000000000080000000000000003000001
12305060348080335050423845302020805078673850704540205782708720602546288678607030301
10000030600020006000200000705020500070000030002000500000300080403000300000708020401
10456240307486206052585220203020337850207062844027778220783030504040606550502020701
10004000200000008040000070305000300000403000200020000060200080200060603000700060701
10208067534834537240706040805258502732605260506320624070302620607450702433844370701
10504020000050000000405000300040006000300060600080005020700080804000700000003000501
10808060386030855336687450362060602077746060568077546080828040707046762620604588201
10202000206020400000400020002000803020000050408000400020602000308000500060402000801
10702346502070804573602056262026303070735620406880506450704264405320705045503020301
10500000006000400000207000008000802000400000500030003000204040008000608000303020001
10224558437688387880405646604077806332406043732050784065402080877048503240407048461
10000000000000000060500000506080008000508020002040800020002000400040004000507000001
10736630678336745080458540808030544240506670203070308440204275507030558064704436701
10400070000000800040000000502020000030200050800050200000200000803030002050005070001
10306087233070603627777438608043288020425050808630305457657436707382302020428050571
10002060008080500000005000006000007000507000504000600000003000400000807000300060001
10466040506060548273704080275587707252503033305085878858767080428740703033208070301
10005080602070400000600040400070500000004000203000005000000060000020008030003040301
10808060307050604070308785808020385777854060204787806030465035588038565350504023701
10306040302060006040804000602000200000004080800000300050002000006020000000307050001
10403075403077354050787020702325332737605080786330387578807282708050806384203020251
10606000008030000060000050004000000000007050508000500000407000206000508000803060001
10203265857043702537332655862040635622374040406044303580643060706770302070507074401
10704000002000403070000080003070000000004040508000003040003030700050402070005000801
10704086406770602070407040208020237072808030303072778085407640378060605050476230801
10800050003000400050203030300060003040008020302000200020008000703070406030200020201
15783820887040358650508080766220605880777050806050404280522070208040804026207040601
10002000500050700000408000300030600020800020008050800000800030800080304000408000201
10653026602363506076602448668025763040205780747380266346402020866238307040804758201
10000080005000006000200000002080000070600060400030400050005060000050006040800000701
10235260465088485220483828804060625330503048303050706080522030655260844060235870201
10000080000060004040002000203020004070602000707000708040204070600000200040003080501
10648032368030205060807040504020608040255030244547303020804084605377575064803070201
10207000005050200020200020700020500080002060800020007000704000300080007000300080701
10506087508030423430705320323546606228606640306060752882302750403060207060735660401
10807020008040003000600030000000400000700060007000600000200000406080302060000050301
10402050373374804075726235424450734758326040778653307030847652287026303086483240501
10607060000040006060006000700000800000800040000000207020000000008000607000600050201
10808026274070674050405070802463306420305023754722405024833340505870302042602030701
10005000004000807050500050003000707000504040000000006080000080500020503070008000201
10647224508866807040774476432040562048403640405786875088383080725620307030457726401
10000000400000004050000000200050003000800000200000404020000060004000602030000000501
10337850662777662050777260505053505630376570425240705040807738488037608027238580601
10000080003000000050000080807000600000300070008000204000700000800040005070005000401
10265020804043335656508040404020428446846080236076302060456780402340456030208024401
10003020803050006000203050203080000000004020500080008030004000604000200060700040501
10405082608050608680838080805346758058802057605830607042304077204046402080563450501
10606000707000700040002020706000006080006000700000608000208000200070008070000000801
10203040703854728077505050503058304040527670806533678630848650848380486440466543701
10703030300000007000705020706080003020000020308080005000300040008000600030700000701
10808080452256305380702060808050454048362040708030508054708043408062206088602037801
10707070000080403080502020006040002080300020800070200050002000202000002000007070001
10604540343020306050603038544876807020607560804570552220505480204772486483333020431
10600040007040200080004000200000006000208000600070000000500070700000000000300020001
10478087776020467733728280406044666832804042523482708457442070308033753570765540601
10003040007080300000000020007000008000003000008000505000500080805000200060000080501
10602030302020806042327070235725407058687078504080865050706680507744202050645020701
10504080600070202000600020700000707070007020004030005040008000700000707080004080201
10403060253220207050502545506040565030808230778076507082472022688860852050404033701
10702020000000403030604000008020007000400000600060006000400080000040004070702030001
10408024745448507630704026525066607335432244407680588240705542338044307068505040451
10705000000000800050600030006000200000000020007000300000400000000060006000202050001
10705768264380746060384667703050245560384066524088408064285754663730356450443050601
10400000000060000070000000008060000020507000005070005000000000000050000000200050401
10634828863082657547648680245085552060505035508050408043857682774020844532602026601
10000070002040800000000040300040800070004000600020304000003000200050000000304030001
15737080403050202684662020504560406377586054852880706767524080403747522650807060441
10005080406060703000600080400000600000008040000000306000700080400070002000607040001
10737060207030508030702420204372274325207720645870727020402720535030707067708057701
10000080200060003020005000800000000000404000800070500080003000803060708070003050001
10375740508387352030837020363723272630805032407078706772334032503080704470634070541
10003000608000000080500080000000006000703080408040006000300030008020800000400020001
15635050845020404330608856425253208040502030605030557060605060537080504048808047301
10004020600030200070506000200020002060508000207000800040805020000060405040004000201
10408074702060726380405760505770835020303248805358207020208057384880603770455270701
10200040002030800000500060500000200050700040006000008020807000300030605000400000601
10746660363730506638446060808485402845384570404042487640608525508050276084566562601
10000000600080408000008060400000500000007000208070000000200000406000500050000000001
12388888606062503084633030786775423776407068472020836724763370605873306030474356631
10000000007000002000000020000000000000005000000070000000000060007000006030000000001
11111111111111111111111111111111111111111111111111111111111111111111111111111111111
