11111111111111111111111111111111111111111111111111111111111111111111111111111111111
10004000000070000030000000000020006000000000600000000000000060000000000000006000001
18204080424030363040732344608030803023568860405730205856605460707725764776303030401
10000030400020006000200000208040400030000020006000800000600040505000500000808030801
10762530507227507083543860205060246380206056386034762840875050606030504520602040401
10004000400000006020000040608000700000502000300080000030300050800070508000500030801
10303042568863435680705060208546703654602850305870388050708850407540508383287350401
10602040000080000000408000400070007000600060200080003020700080605000600000007000201
10206030273020245725747280678020605052263050566068577060233070207058225380508757701
10308000708060300000500020005000408040000080407000600020707000208000800050403000601
10406454305030206262402044754064806080366780704660404580803734407670708026705050401
10700000008000500000205000004000708000300000600040008000304060004000804000402060001
10255628467578726730405353202032204654502082425080333076302030872058205880305037421
10000000000000000020600000203020005000202050005020800080008000700050006000403000001
10875420828268778040487760706060438430308730403070603330802574306030742034507843501
10400050000000800050000000802070000040800080600020200000600000808020008070005020001
10502054543020204374837786206024747030352070505450508644855725507466307080677040381
10003050007060500000008000007000008000608000603000600000008000200000707000800070001
10567080404060346274602060645642803685702033603065435552487020477560408083802020501
10008060204040300000300030700030300000002000505000004000000040000030007060002030401
10205070308060204070204538302060782782637080404446703080554045774058253870804048601
10205050404050007040705000804000500000006060400000300020006000004060000000702060001
10802064303058452080452070604672433523603020632380484448504455504070307525206080221
10703000002030000060000040002000000000003030408000200000806000406000304000507020001
10305582627043603675377665555070653556776020802026508560475050402480803060607028501
10304000007000708030000030007050000000008070204000002050005030600070708080006000401
10707026206680204050706020603040542038603070406032836054206230346030807020656420801
10700030002000800020406060300060008040002020408000200070006000806020206030600080301
13775240538030768360605030337420605530872040203040407330362050802040604085407080801
10008000400030400000504000300080600050500050002060400000200070600070805000306000301
10838084402827808038807532467034478050305670326880626375304070364653205060206322301
10000070008000007000300000008060000060800030500060800080002060000070006060700000501
10482640636055876740458478203030322820205046802020703080637050346540445050326880801
10000070000050002060006000604070002020706000204000708080808040400000400040006030401
10865035775060704060402020205040307040325070634783704040805038805265573072802040201
10602000003040800060200060700070600030008030200070002000708000400060006000700070701
10306036204060277680405360786625404776303820602020832465608830505050304060378370401
10803030007050007000700060000000200000500030004000500000300000704080608020000050301
10304070788426208022662637647660456273628040557624404040474778836048407036464740501
10207070000060004080006000400000500000500020000000303050000000002000206000500040401
10605048228020286030606080604363503870604033427426704026552650705370808026408020301
10008000008000505050500060004000405000607070000000002080000070500070604060005000301
10655738608225603020448588556070457075602340504347268075338060666460806060286652601
10000000700000008030000000200080006000400000400000802080000070008000206080000000701
10425380845256524020824480605088505830332470747650603080304423347055803028445540701
10000050007000000060000040703000800000800020008000705000600000300040007060006000601
10786050508037676356202050206040335528483050726052608030733270405450375070702053301
10004050507050002000603050608030000000003040800050004020004000605000300080600030801
10703074303040202640387040803726842034305054508550704077306073206067308060553270501
10208000806000200030002030504000002070003000700000303000702000300080008060000000701
10704070506254566055202040302037208070665430202238366650286530474840382830656565201
10808030500000007000808020707050005050000020406050007000200030004000600070400000301
10506080583386708270704040603030634077652020208040703037504067208084202065506046201
10204050000080208040603070006070005050800050800040700080006000503000003000008020001
10405550574060802060504057487446704050502520603380278680504570607548786854634080861
10500060007020400040005000500000003000708000800040000000800060200000000000800050001
10628076676050237674783430303037574556206066722865804625652050408033636880847270601
10007080002080800000000060003000003000005000004000708000300020706000300030000030601
10307080506060604075652030576674604033732023504020233060706470304763403050545040801
10802040600060205000600050500000603020005030008020007050003000300000803030007070401
10408080736850406050608467608070486020402530273024405058458047556830744050407054601
10206040000000403060303000008070005000800000500020007000800020000080002030706060001
10802083438547607470207043756065306442788243406540633630607264442044207062704030351
10202000000000500040500040002000800000000050008000800000600000000040007000603020001
10808786645650665020757268405030443680382052262082803073576258223870326880323070201
10500000000070000080000000006070000070803000003060007000000000000040000000800060401
10858727562065527248774460756048643020203084307040507046732452863020758522303042201
10000060008040300000000060300060200070008000200070608000003000400020000000807080001
13747080402060304657383050308670308438745077242680202722255020806226455860305080561
10003040607070308000600050200000500000006040000000803000300030800040007000706040001
10522050802050204060406840403855266774702270257360254020508230667020506084306038201
10000050400050004040007000400000000000307000700080200030005000504020405030002060001
10246350607878447070588030685223553750202066805023206374823035203050402460686070251
10003000308000000080400050000000002000804060407020005000600030006030700000700030001
13558080653080504240504424786727505070308040508070826070506070327040605064708045401
10007070200020600070606000600020005040705000506000800020508060000080505020004000301
10303067608030836430508630605880474050202267607635803050505064455480203350342530701
10500030002030400000400050200000700040700050002000005080203000800070305000700000801
10563360432550308653787030705467308488743650604074656440605366704050254042672267401
10000000700020204000002080800000400000004000802080000000600000705000400020000000001
12225868507073207087734060676443732672505067783030785658377280306842806040736752371
10000000006000007000000030000000000000005000000060000000000030002000006060000000001
11111111111111111111111111111111111111111111111111111111111111111111111111111111111
