11111111111111111111111111111111111111111111111111111111111111111111111111111111111
10008000000040000070000000000030008000000000600000000000000060000000000000002000001
17705030477030273020367724605030705044284660502770508625706620407625554578705080501
10000040500070008000200000803050300030000060008000400000600050804000300000703020701
10362680203537605022786750407040488460808032434028355780772050406070303540802040601
10003000300000003040000070603000700000805000500070000060300040700070808000600030801
10308048752834286730602080502847605523404550706740254030203760803750702552842470801
10802020000040000000506000500060003000400040700080005070600060203000700000004000801
10202030753070255723776860766060307088724020886056566030536050604084846660707645301
10707000702070400000300020008000506060000030404000600060604000604000600060703000801
10302847803080402584306042848073308030257420207450404260405478404530803066606070501
10600000004000200000305000002000505000600000400030004000307070008000803000207050001
10525256232264567760702653806037402478306046642040333063206040577053202660808038351
10000000000000000040800000602040008000505070006070800060002000300070004000308000001
10265330462742522070275450302070372720608240402030204230602288503070673083503868601
10800020000000600030000000605080000040200070300030200000700000802080008080006080001
10308046662080508354327554305033748050478080204680206654846588608467307030436060881
10002030006060200000002000003000005000207000206000700000004000400000707000800020001
10742060408070236534308060476375708474506087407022585235625040855540606083802080301
10007030207060600000700030400050700000005000704000005000000030000040008080005040801
10503050503080208050804255605030252254826050708487806080687067556042545550404023501
10507060806030006040208000402000600000004030500000200060005000004060000000308020001
10804083408087474030265040706247228522705040745370774853602245203020806685807060861
10808000002030000070000080003000000000004040305000800000408000406000706000303070001
10503752256082806674627288253020245874647030605042706270258080404370704080506028401
10403000005000305060000070002080000000002060404000005050003060400080803070002000801
10506076508280804060502040704080448046703020307086565065406370326050205020753540601
10200080008000200020803050500070005060007060606000600080008000402020804070400030301
13342430226040758450204030662340606730263060303060603850264080302040307064305040301
10005000500020300000704000500060200080700040008060500000300020800050603000804000501
10266052802668706046308458423086365040407530484540538287302040886288704080308556401
10000020002000007000200000003030000020200040700030700030002030000050005070500000201
10826550626057787820224767203020334330208087604040706020364060287650367030338550401
10000080000020006050003000702020002040304000608000308080805030600000300060005030401
10533038344050607040803030404050506020244070857838506040205066706287488065807060701
10704000002070400030200020400040600030003050400040007000604000700040006000800060401
10505022806050773230708270354246207245304480408040247652508340206060608070622330701
10807050002030008000600080000000200000500060003000700000300000507080607070000040201
10504020553822302054646863338320258867347050422627204060473445456078707062864230801
10205080000030002020008000600000600000700070000000707070000000003000806000700040601
10402028878030637050707020608887307230407078322582407046236530307840805074404030401
10002000008000305050300040008000302000503060000000002040000030400050402080002000501
10648886404878603060538843532040338076604260802274378033745030228720705020744684401
10000000600000004030000000400080006000300000700000604080000050008000204040000000301
10275870883274488060223840307023505880554370477470202060705372573055302036374580601
10000080007000000050000040607000300000500040008000202000300000700070008060008000201
10458020707026246654203080206060226334754080636086803020678660707480368060503085701
10005040706040008000505050202070000000004050700070002030007000608000200030500030701
10304026204020208470844030404637478063307086303530608054802046206077702080688270501
10406000708000400070005060207000003070002000800000802000808000600070005060000000301
10805020606875247047202020308046604030853340807366374360874240386350273560773664701
10505050200000008000205040705060008040000030605020006000700050004000500080200000501
10606050687466204620304060207020633076556070706060206034804083204085404032405073601
10606070000020303050505050007050006020400070500080300030007000304000005000004030001
10604430278060207020207052227844805080608460205320237540506670708488623546242080381
10200060007040300060003000500000007000708000700070000000700070300000000000500070001
10787024362060864225674840305047545557704058347244302852578080806066842320773240401
10005080005030300000000050007000008000003000007000804000600050702000200020000040601
10402040207060808074742020857638403087822034803040633020807830302472806050642050301
10804070700030206000800030600000302020006040002070004040007000700000806070006020301
10705040483850808080605533504020854020308540562036506048886056345570645050607062301
10208070000000802040805000005070002000800000200080006000400040000080005060304020001
10405026266442802220302024488047406742555223406350443740806244752073808032202050741
10608000000000600020700030002000300000000030007000300000300000000020002000506030001
10206368363370424080555372607060743560338047762025807086883774568420732750358060501
10300000000070000030000000008070000020603000002030002000000000000060000000300060401
10332535633023243565528430648084245030503055807080602058624224672020555536403063201
10000080008080400000000080200020800070004000500050803000008000400050000000202070001
12457080508080603642875070304330607736883045354560402487336060703286834730802080761
10006070606040807000600020800000200000007040000000206000700060300020008000707050001
10473060405040307060506280203467787828403570567270388050605360848040305024408087601
10000070300080002060003000600000000000702000800060200040005000703020604020003020001
10858470302885558030684050872537824630808034607086507252474064606040405330553030721
10006000402000000050800020000000005000302030504030005000400040002050300000800020001
15278080852080706320302752676376504050405020406020735060704060368070503033308057801
10007050400050500060804000800070003070203000502000700020508040000030807030008000201
10405075303030426550803330807370534080303478606473306080608067437220608780665270301
10300040007080700000600030500000200050400020003000004040507000800030503000500000701
10276650582780808685852060404468408867685830707035373730408438305070733026878763601
10000000600050706000004080600000200000003000702070000000700000707000200020000000001
17422462303034407037545070724563278766605074268080583886243850202556806080387546261
10000000006000007000000030000000000000005000000060000000000080005000002060000000001
11111111111111111111111111111111111111111111111111111111111111111111111111111111111
