11111111111111111111111111111111111111111111111111111111111111111111111111111111111
10005000000040000020000000000020006000000000400000000000000050000000000000003000001
15505030782050653020377576207040804053586250607420805862402520404637873266304050501
10000040800070006000600000802040800020000020007000800000300030604000300000605030801
10562640807356407064736820205020628530502045488048345280467030604050708530505050701
10006000500000004030000040406000400000407000200050000030800050400040806000600050601
10707074348546477520602070202825302247403880402430468030705470706650706268568740501
10303060000080000000403000700040006000500070600060003020200060803000300000005000701
10705050355020268888743750525030808062824070324066324020755060607076225820205776501
10502000803080400000600020007000808050000080603000300020203000603000700050302000801
10506556208070805423506036252067207060567770302480208730803444604230604064405020501
10200000007000500000205000008000203000700000200080006000703050003000803000402080001
10337583763877668770706873504062605464502058636070386054207020762088208770707063361
10000000000000000060300000703060008000704020004070400020007000700070008000405000001
10447670888877643060248450705050245820803860403030805860205754807060247038407583301
10500060000000500020000000802040000040400050600040600000300000706070003050008020001
10806073765040706422328885606088346080828070207840206386423747603524507050447080521
10008030006050200000007000008000008000607000605000800000002000800000803000300080001
10748030403070627644403070342372603286706055502072752688636030435630506056308030301
10007060308060800000400040300080300000005000308000007000000060000030003050004030301
10603030205040303060207632208070588344458020408586307070734035377067334550206068401
10806070306040004070704000503000800000008080700000500030007000008050000000207030001
10406038408032776040855050702868877356407030524570568635706643402080402265206070221
10608000002060000070000050002000000000003070505000600000504000302000603000802040001
10202723252028704383553333672070478458265070402067506880834050706320806020502076301
10402000007000804030000070005030000000003030703000006050002050700050302070006000801
10603077407820805050807050207030732023305060308043535022503620833070506050678320201
10200030002000700080503020500080004030002020403000800080002000208080504050600020401
18347260443040566670805030334750703360838080707060703650265040606070204072503020701
10003000700070800000306000600040500050400040002020600000800060500050504000603000301
10374088507836808034408676762025534070608780384360874232202070332583706040605873401
10000040003000006000600000008050000020700060200020700040007040000040008070600000601
10568550546037837730677672708060267230305052203080405020738050385520656030448840801
10000050000070004080006000306040007050607000704000306050608050400000800050007050501
10627026852070802030705050702050804060434050823223602070702032603273277026207080401
10408000003060800080600030500020500070007070200070007000308000600050004000200020801
10608076806030356370408270753834802864307570803060778542702880807070204050333870401
10207080003070002000500060000000600000800020006000700000500000807040206070000060801
10206030455642606047324448782530884245556040682822708080255583246055804023387540201
10203040000030002080006000800000600000500030000000603080000000005000207000800020501
10703086252030544070302070408686407260405027442685404066666450604860405077502030501
10006000008000802020700040004000605000308080000000007070000060400040507070002000601
10832247705585605060343687884080673042803360408435772034832020528770602070342823701
10000000200000008050000000700030005000300000500000505080000050005000203070000000601
10343380236287256030644540707087602770227360238240404070705245685053307027348240601
10000050006000000030000030206000200000700040002000802000800000400070007020003000201
10456030504036236866704030806070454554745070774037708050773360805480334050204055501
10004070505070003000605020802020000000004070700070002080008000505000300060200030301
10802032706030202460364030707852438042304058303730605026205025404073303020637570301
10505000507000200020006020503000007040006000200000505000506000200040002070000000201
10605050402525356046807080308077502040445580502643557820838620434570553240465728601
10403070200000008000808080708070007060000030605070002000300070003000200030200000501
10405020874748408850707080505070485087446040206050607026508088303084503077305056801
10606050000060305070207070005050002040600070400060700030002000504000004000006030001
10408540454030808070408077755862605030507720507440476380402480805337265484737020681
10700050007030800050005000200000003000206000700020000000500020600000000000800020001
10467023823050456626638350404055267523507077834228805824373070603053652560757630601
10004050003060700000000030005000005000005000008000804000800020807000400080000020501
10502020202030805032456070557434606023467058803050742060203550603236306060374070701
10603070500060804000400030700000602020006080005080004050003000600000706060005050701
10804080438650305030206344403070456040308650873022308042753084327240484060702063301
10405040000000304030606000007080004000700000800050002000500040000020006030407060001
10403028622385305320704054877075507724647566604820525370806368675076206026302060361
10707000000000600050300050007000200000000070007000200000300000000070003000804020001
10807358854220847080564376305080733350486086267074606045627635745670883360477020201
10400000000070000050000000008030000070302000002020006000000000000070000000300070801
10744573467034728268234380665026567040805054607020203026442682422040546638707042201
10000080003040700000000050600050700050006000500030602000008000300080000000408040001
13354070307080208356372040703570808767728025622640507873453040302848724830402020781
10006060303050205000700030200000800000008050000000603000800020500020005000704050001
10874060206020703080403740603227523685802830474460752060206340333080608043704026701
10000080800040006030004000400000000000207000800060800060003000405050208070002020001
10445820303356366080578030774422468580208044603072207776723082503050206630725070751
10006000305000000070400020000000004000608070406060002000700070006030300000800080001
14485040668020603320407262853725804030405060804060253050302080236020507045705073701
10002040300080300070704000400030006020803000607000700020702050000060203030002000601
10502058302080622830605570805350768050202765503655202050704022358820702440546860401
10600030004050600000800030700000300020700020003000002080706000500070206000300000301
10622740864880502766587050204778502565775680305083882320808825604040576028767228701
10000000400060203000007050500000500000005000406040000000700000606000200040000000001
18468523803072307024354030786486434537703032878030265334745860708223308070554562571
10000000006000008000000040000000000000008000000060000000000020002000006020000000001
11111111111111111111111111111111111111111111111111111111111111111111111111111111111
