11111111111111111111111111111111111111111111111111111111111111111111111111111111111
10004000000060000070000000000060003000000000400000000000000070000000000000003000001
16707020737040545030654376607040605044456660703560703823208340706823824535403050201
10000020300040006000700000402030800040000070003000400000700040605000200000408060501
10665540406584305077445560607080235830405047774035867720427070608050307780305050801
10008000700000007070000080508000300000507000200050000050400040300020508000200030601
10205047823875544830808020607556508756404450202530246080208480407360402844878320301
10503050000060000000803000800080008000700050200020005030800070705000500000002000801
10203060285040547582872280643020708076563050534086872070334020802044457780706822601
10204000808030200000200030005000503080000080504000400050507000508000300050303000401
10803356807020507384405063485043507020382370805560407350305774804740505042705020701
10800000002000300000803000005000605000500000300070008000705070002000602000402040001
10785638388867655770502345205066307647304056854040586068604040382048702560208056881
10000000000000000040800000304070005000308050003020800080007000700030005000502000001
10663520675252765060538250302080878540405580502020808830605848502020386038705837301
10500020000000500020000000803060000060500050300040200000600000203030005030007020001
10807067346080604855487635703037476040634030404880503788587848808426506060747060321
10008040006030400000002000007000004000805000705000700000003000200000703000600030001
10758080602030544824502070363744705777206045505042457383528050384340408032503030401
10007070204040800000200070600080400000008000503000003000000020000030007050007020301
10304040603030205060205764503020768636433020406234608050233063828062673840407067201
10506050602020003040603000703000300000003030400000200040003000003020000000705050001
10307084206032258030788060505625356553805020325450376343602648404040404534705040871
10508000005040000080000040004000000000006070606000200000408000506000606000403060001
10708487525072307877447824553070786255724040302032706420644040603580307070408026301
10407000004000804040000050008030000000003030408000006060007080700040206060002000601
10606035406470408020306050202080372042202060702027268037502340464080604070563340801
10800040002000600080608080300020007060008080708000800080005000207020207080500030801
14828740457020433240308030456460802460458070302080607260675060302050505085805050801
10005000700050800000807000300060400040700030006050600000300050700070604000608000501
10763037502425608028404745388052232050803420254730832524604070368776605030605554401
10000060008000007000200000003020000050400070500040200080008040000030002050700000201
10773380487034885640565246207020737740708082206020403070684070552350822080643770201
10000030000040007030005000503050005030703000404000506030808080400000600040005040701
10552048333020806040807020302040403040672070274426204030302066302224848023308050801
10803000004040300060800070300080300070003040200030003000702000700060006000400060801
10604088806020277570607220734256507226507850506050648848703240405060804020645530301
10302060003040007000200040000000700000800030008000800000400000307070808040000030401
10706040226553704035856376346430674233545040626278505030354673454033503064367760701
10708070000020004030004000600000600000200050000000305030000000005000504000200030601
10708052627050452080207040604233408560606065864462404083243270204330703083408040501
10005000006000306050700020003000505000805020000000005080000040700080804070004000401
10225848507277504070828368387060457045606270704857468032534040764520704050644575701
10000000200000002070000000800070005000400000300000408080000020002000606050000000501
10873420478644467040282520705065404350674280637240307060708863865037304034572770601
10000080003000000050000070704000500000800070004000805000800000200050006020007000401
10362020602078356487708040302050245582233070877046404050773730602370753040804066701
10007070607020005000306050304030000000007060200060003030005000508000800050400050401
10703078805030406530874060406637553072203024307260308076607056504025303080524880401
10505000803000200040005060405000002060002000800000407000207000400020008070000000201
10403030706885846054205060704056606020863470607443443850642620423470558250227267401
10807080400000008000305050308070002040000030502040006000300030007000500080300000201
10203080567724403560608040604070835047235080302050207023305028405024705046803074801
10704050000060707080703030005030003060700060400070500040005000508000003000006030001
10504560554060207020405087353426607060806650202430432450803280308458588452724040371
10200050006070800030008000200000004000404000200040000000400060700000000000500070001
10773082478060276657548660706058444286702057374427203275356050504024266340287440201
10004060002050500000000070004000008000008000003000504000600040808000300080000030301
10403040606080202062623020448338407068235036407070248060202470703722807050484060201
10608030600020207000400080300000302070008050005070007030005000700000406040005070601
10304040835630802030607348808060872070704560724024205083442068856880654020205047701
10208030000000602040407000006080008000700000300060007000800040000040007040502070001
10808036286753602560607072472065208522362648403350225270405364743088402074307040741
10502000000000300060300020004000500000000020008000600000400000000030004000505020001
10605283783820253060554763506040286820868072873038708052457285734430883680448030801
10700000000040000030000000005060000070308000002060006000000000000060000000500060701
10687552323066663753564330486035748020706083504040306054453387286050833872303045501
10000030002060700000000050500020500070006000800040503000008000400030000000303080001
16834050405020203827445050306860704826824036383750803475823060306522224330406060381
10008050407060405000700050800000500000006020000000505000700030600020003000806070001
10654080708040807020802560608458636363706660373350238080505520686070206028503023401
10000030300070007070008000200000000000404000500050300080006000207050503020002030001
10567420706636653060537070762635836440803036503066608737828076503050406670333020371
10006000306000000030700080000000008000303030308050002000200040008060600000300030001
17245050287040302880605367864282404060202030208050548060308040858070303033407078701
10006040400020200030504000800080005050608000405000800020703080000040806030008000401
10507053307020847570306530406820338060206252308284302040502025775540608550827670501
10300070004020500000600070700000600040300050006000005080207000300050803000300000401
10544740427380405455448020508283406668672660206036624370503487206020754048684843601
10000000700060208000007020300000200000003000808080000000800000808000200070000000001
18763785705045405085278060435854568633706033632070553334484720304232408030574365531
10000000003000006000000030000000000000006000000080000000000080007000008060000000001
11111111111111111111111111111111111111111111111111111111111111111111111111111111111
