11111111111111111111111111111111111111111111111111111111111111111111111111111111111
10008000000060000040000000000040005000000000200000000000000020000000000000008000001
13504020625080872050523442603020702042822770603270504482804730403375884558204040301
10000060400050004000500000308020500030000030002000200000200020506000600000704050301
10265470304633508055345320402040773860502028456055538520878050303070205570808070601
10007000600000006050000080804000800000305000500050000080300060700040603000200030301
10302046835725544360802070305264604766407280808660663070803750708680808743327750501
10306080000080000000504000200070006000800070700080005050600020607000300000003000201
10603080644050367768655420554080502087723080446038268020446060803038384260707538401
10204000405020600000300030007000206030000020604000300080204000404000600080208000801
10706666406020405532703056426057407060652630402650502340303247807360702026607020401
10500000008000500000803000003000203000500000500070006000806040005000302000406080001
10877854453632736460808548305057508285508055886050785085207020878058603250407036781
10000000000000000020700000704030008000502060006050300040005000700070008000802000001
10486650766273585020582820703030665780304350504040404270207823602040664075803586201
10800070000000600030000000804050000060400030700070400000200000503050008020004050001
10408063742030207272476542408028334080567040702280506335877782802426602070263060431
10008040004060300000006000003000002000507000503000700000006000200000207000300050001
10753030707030832647404030364283305476206052805045367343628030525550703047407050501
10005080706070300000800060800050600000008000204000006000000030000060008040007050301
10307020703030603070307547705060568838437080607442205050687075643055227860704054401
10304050302050002070402000406000700000002060300000300080003000004020000000304070001
10207055804087683080384080206334577424804040327840826848203663207070803728602060581
10803000006080000030000080003000000000006050202000400000602000503000602000505080001
10508365423074805555634353478070238487788070306072607780385020506440407050804085301
10504000007000506050000050005040000000007050503000006060002080800080305040007000601
10607055208630508070607050306030268023606080504044837045305270562060705060643750501
10200070008000700070205030800040008070005040403000800050008000606040602050300050501
12647660833070684630208080652450706220743040508070302230235020703080206077302030601
10006000400070700000802000800050800030700080004060600000200030400050206000504000601
10737083505827808044706358842064385060307240276740467474706030868252606040503435501
10000020006000007000400000006060000060400070800040700020006060000020005070700000301
10226720872045376830724566704030573270304035704030408050355070247430864040257730801
10000070000060008060008000508020005050505000406000205060505030500000800030006040301
10832033533050605080304030206080405080378070772885704050806022808356753066503060801
10803000004070400060700060400060700040007040700050005000307000400080008000800020401
10403064703050468280306480232642602448503280807020458256603470406050603030522580801
10606030006020003000200030000000800000200080005000400000500000806060702020000040601
10808030274367402037664852724260743868224060258444707050775533672082303048652670301
10806060000020008080002000500000200000600030000000706030000000008000706000200060701
10607074778060387070807020707224407870706067338278706076567280704760806086702070501
10007000007000205030700070005000402000703020000000004080000020700030607060006000401
10823383404755804040743542387040322036204730803452545057823060577280504070265762401
10000000400000004040000000400020002000400000800000606070000080002000508060000000201
10727730427833567040665530807073307220637860858670704060606884583056407058745550601
10000060008000000070000040404000600000400060002000505000700000800040008050007000301
10873040206087534458506040607030482423444060644082208040873830803370465060207056501
10006030302040006000807060303050000000007050800070002050007000604000800040200060801
10202034508060708840242050204753325077308022207670806024404066604063207060386480201
10403000504000200020005020207000006030005000400000807000603000600020003030000000601
10208080807543282077203050302076708040362670606846477770272730462750376660862623501
10505080800000002000305060808040006030000050608060006000600060002000600020500000201
10804080673778702380405040206030237058763050804040208084504057708045208043207084801
10406020000080805020508070002070004030600070800030800080004000606000004000007060001
10803720623050308020302022367883604040507460302450664340203820804824235244745030541
10700020005050300060002000800000003000804000500030000000400050800000000000300060001
10487045723030358735427850407074434565604056834545708456367070804042885480367350201
10003070002030700000000080008000006000005000007000305000300060605000700070000080301
10303050406040403042568060758654504062542072806050346030808550406286806080624070801
10806050200070403000700040600000702040004020005030002060005000400000707030002080301
10403030538820708070707686207060663030202460888064307052788086388870842020706055401
10602080000000304060803000007020007000400000400060007000300050000030007030807070001
10508085237756503530405052888057208434564526602520535770704452544035504024808040731
10208000000000500020800070008000700000000080008000500000300000000070008000206020001
10704554275330476020847623507080575760583078366068608044445353422560454380875030401
10600000000040000070000000003040000040502000006080003000000000000080000000800070801
10563575634038377837284830222082733080207066602080502064825372436060277678806088801
10000060002080300000000040400030800070008000700060208000008000300070000000703040001
13573030505030708754253060702730303483752073386330805547427070608446766330408040851
10005060308070207000700050400000300000006030000000805000600020700030007000506030001
10338020204080308040602760408732438885303430276630858070604450628060203088602037601
10000040800040006040003000700000000000202000800020300050002000402070408050003020001
10337560704428882070743060428388285280704046208048603825752055305050508670687070551
10006000504000000080400050000000004000507040604060007000300030004050600000200070001
17425060687070408420406482352243503060502080705050862040207030277030504064402052601
10006050700020600080803000400060004070802000205000500060203080000070406050004000401
10502043306020373750503860705430533050308664704442705070607083782460206720375880301
10600020005030600000600030400000300060700080003000004020506000600070307000300000701
10783320223260703764845040607887803476566280702076456520507623804060645062752484401
10000000300080604000003040800000200000003000704050000000200000403000800050000000001
18786423302054307055673030764673846884404054682080727578485650705245305080476328521
10000000003000008000000020000000000000007000000080000000000080008000005030000000001
11111111111111111111111111111111111111111111111111111111111111111111111111111111111
