11111111111111111111111111111111111111111111111111111111111111111111111111111111111
10002000000040000020000000000080008000000000600000000000000050000000000000007000001
14803050334030668060688527803030202063572620608440304863504330208756366364804050401
10000040200020004000500000602050600060000040007000700000700060208000500000606070701
10734470504367707066733570602030757520708057365053685630248070703020404550508050601
10004000600000006040000080508000500000704000300060000050200060200040607000500060601
10202026866644885830403080306265806238808780605360846030702470807770306463856350201
10304060000030000000602000600060005000500050700030007050200050207000600000004000201
10303050738070384452562580672070606047264080444074738080843080303033267720403644801
10208000405070600000200030002000507040000050506000400040205000604000800050307000501
10506436704040206463406023866047706040372380202280408740408627503860204075805050501
10700000004000600000707000006000306000300000800040003000703050008000203000804060001
10356475427274485770503265407087704438203025224020656035604020283048606270406087781
10000000000000000080300000807040003000208060007020400040008000300040004000307000001
10766430626287366080476570802030568330304620302040403660206757607030858024804688501
10800080000000500030000000706030000060200080300050500000800000702020004020007070001
10807024428040506656836522604083664080846040605640503583568747606282307050333030341
10003070006020800000006000005000008000506000206000400000004000500000805000300080001
10882050206020835553804050342774302523507037803088267834458030563660803054305070201
10007040504030600000300080500050600000002000302000008000000060000040006070007050401
10408030802030507070808746605080238266646030405784702040388053434058687570608073501
10407070802070004020806000405000500000002080400000600060008000002020000000504080001
10404083705022764020435060207753274222806060685760842484808682804070707556302030781
10807000005030000060000020007000000000004050208000200000302000702000205000502080001
10207778888062206535465222655080546533778070502085305860522050708680407020203085701
10606000006000706060000070004070000000003050408000002020002060600070402030003000201
10808055202740804070702030202040855038505030504022583036608340632020506050762370201
10500040004000700030402030300060008050002070702000300030006000702070707070800080401
18863740578080434370605020362580607760458040803080808670383040703060304085305070501
10004000800070500000405000500050200020400040005070500000400030200080204000406000601
10822085606827302066205588888033883080504760544370372272505080787358408080408363301
10000020007000006000700000007020000040700040600080500080004050000070005040600000801
10242530334027374370557237507020537260302067306070207020555030375350238040242380501
10000060000080005040008000406070006050403000506000704040706060800000800070008080701
10764058424060704080605050806060704070654060264783302020305078303237352067304030701
10506000007030200030800020500070800060002060400040004000707000300070007000400030701
10805062406060422850405860855764605543704840504070433264202430804060605060552220501
10404030007060003000700070000000200000200080004000700000400000807080305070000020601
10605080763328603068565865366520442626678060676642305050434274648046706055555240201
10505070000080006080003000600000300000300070000000204070000000006000507000300070501
10505084264070642070506020207222804330802044582545408087844850705330307086404080701
10008000003000707030400030007000303000404020000000008030000070800050508070004000601
10463524608373203020824343542020232052407270203367588044843040422860505030832673201
10000000400000007030000000300020006000800000700000506070000030004000707020000000501
10386220382573582070474480602057207260262640848350806060706484242072403033636580801
10000080007000000020000060507000500000500040008000608000700000200050006060008000401
10382020606084657878405050708060847864828080253085504040675870205660278030502066401
10008050808020006000408060203060000000005050200030006070006000304000200060500080801
10206042802040208770882040607378325082408047203760607047303066307052207040763440601
10307000805000300040005080405000004030005000800000803000208000300040004020000000701
10606050302542487026608020206053202050422220308825425770882340853830326280532772801
10704020800000005000704080704060004040000030608050004000200020005000800060700000401
10206080327645604480308040503080753024458070202050808087304062304063204072407062601
10408060000030508050204060004070005050800020200060500050007000804000004000008060001
10707750854030708030806067227546302080404540307530442340506770305532325748466020681
10700070007020600080005000800000005000808000800080000000700080300000000000700040001
10645028357080777553778420703074747682804035863688705827855050807045276830734330501
10005080003060600000000030002000004000008000002000208000500060503000200030000080801
10203040404020606022424070385328205038785074302040583040408270803865707070283080701
10507050800030406000700060400000306070008050002060008050006000700000805080008050301
10605070387560805060403722405050458020807620868034507022242048257450352080508033201
10607070000000602070702000005060002000400000800060005000500070000030004070804050001
10604066858382504560202045444055606458327867807230384340507474577045404066207050381
10607000000000300020300050002000600000000070005000300000600000000070003000803040001
10205473228360684040674544808060885330232053357034507036537384385470423870743060501
10600000000040000080000000007040000050705000003080007000000000000060000000200020301
10732767682067623476773430254046475030304063305030506068672642327050432865806045601
10000080007070500000000030800040300020005000300020707000008000800050000000506070001
15644050707050208835244030803340308645644044247650404868364040307344242770807020621
10008040307080508000400070800000800000008080000000306000300020700040007000806020001
10843080403040506020406480705476745552305560325280673030404780483070802028503064301
10000060700050005020004000800000000000206000500080300040007000406020802050004040001
10642520607643654060468060545748736650203077708065304286346026507040705840558070821
10005000205000000030500020000000004000402040608050008000700040008080600000200030001
16843050677030502560708373423542506020402030403040443080308080873060503084206036701
10005060500070400030307000400060008050203000305000500040307080000080504040005000201
10405036406070482250605340404680548050805468805453204020707085667680806730462760501
10600060005050400000800050300000700020500020007000005030607000700060605000200000401
10823830253440504264545080505344306782853430402033368780305368508050243052827623301
10000000500080708000006080700000300000007000808030000000600000402000400080000000001
14744754503056702053675030745456247568207054257020525343777250405725608040387277681
10000000002000004000000080000000000000005000000060000000000030007000002040000000001
11111111111111111111111111111111111111111111111111111111111111111111111111111111111
