11111111111111111111111111111111111111111111111111111111111111111111111111111111111
10008000000060000080000000000020003000000000700000000000000040000000000000008000001
17506060545060674080334266406060403043372350203340604532703430705828874844804020701
10000070800060002000300000604020600030000080003000400000300030405000200000808020601
10345750703257405038652460502050634470707036285025776320274020607070302350703030601
10006000700000003060000070805000200000505000700070000040600070400060507000600020401
10805082368568842560804030405477804226605830408330658040706560804820407667636630701
10603040000070000000506000700050008000800080700020004070300030606000300000002000401
10605050477020755744245520273070304023277080855083564040435060708036377680603232801
10808000203020300000500040004000606060000020308000700030404000402000500030806000701
10508428208060406646306022232088607060682430207630708440807367605430304038203080601
10800000002000500000507000005000405000700000600060004000702020003000806000204080001
10453853524588763740805488702065506652407056545030542043305030575072703250702073771
10000000000000000070800000706030005000506060006020600060004000600020008000308000001
10326440665382675080453650504030684760402270406080503430508652305030347024204284601
10800080000000500020000000804080000060300080500060300000600000605070003040007020001
10705066825050508648783748608036464080645050403670208785578334702276308050264070721
10008070008080500000006000002000005000202000207000700000006000700000506000700020001
10872080403080444547208060622278702785503058602028358484674030644740202033307050501
10007020508050800000400040700060700000004000204000006000000060000030007040005060401
10603080606030602070408356708080576677472080204533703070557062375076454870405048701
10205080705020002050703000302000700000005080400000700080002000008060000000407080001
10404075408024644030828030306557665545408080442360487525807888705030706783406080781
10803000002030000080000060008000000000006020605000600000804000504000204000802080001
10408276467032602844433343385020322565528070403045203660634060406270204050505036201
10302000003000706070000060002080000000007040206000002080005030400030602060002000301
10306084603460506020703070403070653087308080508035546037203240438030303030487750401
10400040006000300070406020300070002040003070407000600070008000602060402050500020201
17872650884030276230408030678740406270585020206050706260236080302070808065504030701
10002000300080700000507000800070300070800080005080200000300040500080708000702000501
10634075207555804088504543658035255040407650656750254532305070484756208080405684501
10000080003000004000500000005060000040400040600060500030005020000070007080300000401
10833320876075228550476274603030778460303052604020808080784050762330422020387240401
10000030000040008060006000706020004070302000405000703020302040600000600020005020801
10558027868030802060702030806060508030788020347534205070505072207784458084405030201
10503000006060400070600040600040500080004080200050008000603000800020008000400070601
10204043503030547220205540646422402438804280603080643724302450303070703020832650701
10806050007070007000600070000000300000800030004000700000500000302080302040000070701
10706030338443607062542688558780653436353040876538206070224853824086406064337730301
10702050000080008030008000400000800000600030000000508060000000007000808000700060301
10708047253030657080303020606882505450202048645233206062646540405530806074707020401
10008000005000208050200050003000206000204030000000008080000070500050407040006000301
10463545605877508040566358447080222054704850406526582084782070858730604040345646601
10000000400000008030000000800020007000400000800000503020000020002000804070000000301
10884860234382486040465340408038208560732650372460703020504438745087404084555670201
10000020005000000080000020707000600000400050002000708000200000500070004060002000301
10548070804056627722306060508040783783286020456046408070254260403730857020808052201
10002040704070005000405050206040000000006020400080004030002000403000800070600070201
10308068208060605870465050304424854072708084703620202085305035207035504020245670801
10603000304000500080006070302000008040004000500000804000404000700020008030000000801
10603020708467288084804040404083308060247840605738382270676620745320366860632743801
10202070800000003000703080307040006060000050408060003000600080006000800050800000401
10206050678262802640503080304080262022437060508060406046503032205088402043605067401
10806030000050405080305050002030003070700060400060300070008000303000003000002060001
10607370885040203080808024257666807060602750507750774530605450504477782554578040251
10800080003050700050004000300000008000408000600030000000200020200000000000600070001
10336022333050754284522560307052274534703036272332407844375040208062377480534840301
10006050006080500000000030006000004000007000002000604000400080808000200060000060401
10804070306040202048556060245622306034655067505020475080607860707537506060783070601
10707080500030807000500020700000802050007080004070006030002000300000708040003070201
10705060464740702080506862708040782020705450366067606065567038462420853070803037801
10702040000000802030808000002060008000400000200080007000300040000020008020607080001
10804056832424308480504073357036704244886572804360857820807843532052406067608020421
10805000000000300050500040005000300000000050007000300000800000000030005000307030001
10807627544440637080777282404040842430883066627088605036427456635370465450663080501
10400000000030000070000000002060000080808000002070007000000000000030000000500020601
10863357574045425386655750753035845080706065805050405086373443452020772478305074501
10000050008060700000000080800060500030005000300070507000002000300070000000503080001
14864040706040603746423060408850704275477072722530206433865030506862367220808070481
10006080505050808000400080500000600000005020000000505000600050400040003000805080001
10638040208030608020704330708263487842402770875330833020306560486060503035206022801
10000050200080002040007000800000000000605000400060800070002000303050606080002070001
10676420304882736030247020234387232540504034508038808747327057502030304280464040721
10007000706000000060400020000000006000606060204050004000500020008030800000800070001
16484060862070603680204747252535407020808020507020735040507050435050408044303066701
10003020300030200070807000200070006080403000405000500050303040000060308030003000701
10408042508070736750608730507440735020303677804822503060505042654630505350255550601
10200030004080600000500050600000600020700080007000005060302000400050405000600000701
10487320572260603654774040604353803352527550304025658870704355206070642025732333301
10000000700020408000005030200000600000004000708080000000300000507000300080000000001
13285678803055606087674040625377875887702086473060453852334450605686405060375252441
10000000004000002000000070000000000000007000000050000000000070007000006030000000001
11111111111111111111111111111111111111111111111111111111111111111111111111111111111
