11111111111111111111111111111111111111111111111111111111111111111111111111111111111
10000000000000200000000000000080000000002000000000000000300000000000000000000000001
15704367783480338360203355642036704037302760706042704330565040608845628283534878701
10003000000050000080600000003000603000200000704000407000500040304000000000000030001
10604352632070584070474788703560307580763565233250407054603670265060735332875070641
10407000200070502000300000800070807000300040008040306000006050003080000050007080001
10402030406060202488405040386070202036302056803060704873327060208028576640503060301
10800080005060008000007020708060008000006000408000600000400070600050000000300060501
10284053833450538070523050304024845760727450308525744330503847483640628388353050701
10002050000020500030008040006000000040000040704000000030800000000000500000004040801
10308740504024506076204084335385266030572070403020335050557348667722605764703840401
10500050302000006000802000000060000040005080007080007020005000800000704000700080401
10857070304363735380707433443670508437302083336066306025508040706630402020538087701
10004000205000000040400000005000700080003070000040606040008050005000405050007000001
18604765305030803072888347522023622070605070803270705080542040787037758070703836301
10007000700050203000007060004060800060605000600030007080008040006000005020200000601
10527750404370232044408040308060704770606747427254277060702060707365705070453860441
10000000300030004000800060500030004000500000000060000050303030800000400050000070001
10525648202043403354733220557320653030824877334080786243203077885870254562274730201
10000000708000800000002000500050200080700020400070000070008000300000800000000030701
10468870447560627786308038465060502266305050406646345070845230804282504458547047301
10000050200030700000008000000050800000002060003000005030000000203000806000200020001
15438730504050306085775755708727702870477047377067457080788364832030808050205550701
10000000607040807000000000608000600050005000002000004080000020004030002020300070401
10446653705030802876703620477030858053676830503543508058244040506073823080444020471
10200040006000200000700060600070004000000050600000502080000050605000000070400070001
14502060604747843580825380408688504034425062802730705044848840608664652467302048701
10005040703000000040000020807000008000007000303000803000000000300030002000003020001
10676080877035558076467043505040322366503470407062202662707373626030706050637070621
10005000600080007040005000508030000070004070405000503000300030003000200050005070001
10505433203060702040624640746075823060566050645260204080285086607052833786306045301
10200040008070800040000080004080000080700070000080004040400020003000000070006040501
10226080763050568726558080608030242420303646675073328820807280704478656080533040801
10305000600070000000000030608040800040007020008000000080800000204000000080006000201
10408743507028745586653340602020308044428040604086238030577586655045477660604778701
10300070205000000000000050300070003000005000306070005050007000000030000020200000301
10403040608034782352854020807077342750205865202060407063504436438250878070643480601
10506080006000003000005050302070000070200040004000408000600000000080400050000060701
10657040684645703078603040203030285072556030655266205460603474533020607066448020401
10000030006000504000200060508000500040000020000000306000400070000070803000006020201
10763863207067608080687660804884246770302663772540804037484540306728806566435030401
10400000502000006070008000600040000000800080000000305020000000507000003000600070801
10803330503222487367883037677070232732665870547843406080207648508072326050504770601
10004000507000800050008080008070300000000020006060005000800060702000008050300060401
10464066305040304020205040257060402086846047505040606280666070705476204073435050401
10005000200060406000200060006050006080006000005000400050705000504000402000008030201
10507620225570807734632583603056882740308487582337548050403030405020202436703040201
10400060800000200000200040004060000080300000500080008040203080606060200000400050501
10453050807853865330706030332040787060604470703020606080808076804060487360333080401
10008060502000300060506070000040005000703000707050800020407000406080000040005020801
17475080402050505030305082257637308044803083204030337540702430308072384065507040201
10002050608070002060205000300000606000202000802050600050005000807000805000804070601
10607040406030332560208470602320404230203850254080285045535225802260502030503350501
10600040802070008000604000304000702040505020005020007000000000800050308030500050201
10764880306064604057403057802063403050208050708063706326652330404080305050343050501
10500070707020003060007000005000004000206040400050700000000000705060707050006000501
10502030308077523040207625804648282727208050486260307357278844707060402076603853401
10805000706000005030500000700050008000006060000000300000003000007040606000300000301
10304676504272505060503850735030305082873032852550507842422084833020602742866020501
10802000302030003060203000400080302060004000800040405000006040300030700000004030301
10606650707050478040404075806480407020507630203050228058407050202730303486408050701
10406000500040000080207080003000204000500000406080500060002030600000500000804050501
10802078276536574630405025854020503646665763808062303520403070843885763630705570201
10500080006000000000604000000040200000000000203000006000308040000000002000400000601
10362780602050284555404466267354745578675440744788463080802068785582703053233384401
10000000600040400000300000600000700030000070000000003060803000000000504020003000301
10635244735760305450202420704360504020877022837730203020303222262730208027608080401
10000000000070805000400070002000506020500040000030200040500000006040004000002070001
10666280247550208068558046556020438080603580638044644580506482406040333634256065761
10000050008000504000006000800080400050400000800040000000700000406020000050000030001
10856045206075606834808735805825206720726720207350273355685550402024547060374850601
10008000802000504000800000200000807000200060304000800080000080700040000070000070201
17404530208560703030845630775580404030205022505074578020587580338470607643468053301
10002000800030608040000050000060807050608000808000008080600030004000300000005000001
10608077873050408068305047764020807047306280403058704040407088704034454770608485501
10203050002020008000202000006020008000200050002000804030604030005060000050700000301
10388046707022445740204276325084526630287052583840308070408020252070483073724030321
10002000702070000000703050000050003000800050008050503040708020400020300070002030001
14404440708050702857805040874540806050704663406020307030403020262840502370705078701
10006000503020300000200080000000605070400000004000600080005060003030800000503050001
10482028305060204880642734246773807080456662265847273463786052502020404478303630801
10004000006000400080000000000000700050000000000000000000003000007000400000300000801
11111111111111111111111111111111111111111111111111111111111111111111111111111111111
