11111111111111111111111111111111111111111111111111111111111111111111111111111111111
10003000000060000070000000000080003000000000800000000000000050000000000000005000001
14306080725030363050375584805080603067573840608440805476307650507532376357306080401
10000080500020006000800000504080500040000030003000600000700060808000700000508020601
10528530404834602032262860803070872430303072252048553740674050808040203640702050701
10006000200000003030000030206000700000304000800080000020400040200040303000300020701
10808058547365384370708020206432605545304460804540837020706860706420302662686420501
10305030000020000000302000400030005000600020300020004020300080207000400000002000801
10207040853060685888542750328080503044244050742057674020442050808045776340407732301
10602000608060500000600070003000705040000080706000600040605000804000700050404000301
10402843403060506368308043278047706080252870706380506630402776607320304057808080701
10700000007000500000705000004000406000400000600070008000608040005000703000706070001
10855566687586675220208473802023404446204034426080664032807030722045807560304063521
10000000000000000040300000202060005000408060004080300040003000400070007000605000001
10786460875523467020876560308070388440708560204050508520302357405070584053604683701
10600020000000400040000000604060000030500020300050500000200000307080005080004070001
10308074587060602237732476204086267080756060504240406372637688404836706030777040871
10007060007030600000005000002000004000305000506000600000003000200000602000600020001
10467030403030484233204020576756703865208076804052284237567050687640702056607030301
10003030503050500000500040700020400000005000608000004000000030000050002080006080601
10802070407060403040808737406080784222634040506833205070582052357028838680207037401
10804030307080003030508000604000800000006040200000200080006000005060000000507060001
10703052207045463020657020608533737273703040872470234874306668504080804685303040471
10404000007080000040000070003000000000003080803000700000405000306000406000804080001
10802766542032803553525788372030373753757060605086705740385030403370802030204038601
10206000008000407080000070002040000000008030807000007050003030600020305060002000501
10702078807250504080604040407050467034604030506056643085803350362060707020755460301
10600060008000700080805060700070006080005050205000200050004000603050608030300050201
16546450542080887260706070847780403330526020603020802770755070303070407032706050801
10005000500070700000606000400050800040200040008070600000800030200080502000504000401
10756045603353307085505348773036485080305830337460344327305050386775405070203836501
10000030002000003000200000004020000020200040300060200020003050000030004030800000701
10547840885063342860457782807050748680602024608040403080555080678470527020635320201
10000020000070007030005000305080004020402000708000507040608030200000500020005020601
10825072362060203040307020605030303040432050425648603030206078603426378083202050201
10804000003070400040800040800020600060007030400050007000804000700020002000600060501
10805054508020344230805770867748202882802860806040286856604440503060507040858470501
10707050008020007000500080000000600000300050002000400000800000805050203080000060301
10408060678578507057827355285470884684844040746383806080688444783022803065737360401
10803020000040008030002000400000400000500030000000602050000000002000308000800070501
10506037347060624030607030707343607780808078866748304043868280605760207086205070801
10005000007000705020400060002000407000704050000000002060000040400060805070008000201
10682364604854607080624382676070675034506530207736538055624030882760208040756358701
10000000300000002030000000400070003000300000200000802060000060008000208080000000501
10727780476427553070824880605043206770678620245280502030607574585026308063456350401
10000060002000000050000040507000500000700030005000408000400000800050002060008000501
10477020702077577876202050406080434533733050336027704070522740704770868050503023801
10007050204030008000708040303060000000006060300070007080003000403000800070300080301
10304088608050808420532040707663532037706076708640508023603037304084604040475470201
10607000508000800070007040407000004080004000800000607000404000800030002060000000401
10504020405567852076403050807083207070374830406874635830373360638560682570284876401
10307080200000003000402070603050005020000020204020002000300040003000800040600000701
10805030353244608730504080705050865056886060606020305042607048703056306045404064601
10602020000020802040403070004080006060500080400060200060007000207000003000008020001
10707730243050307030806066837338304020505660506330256340803280704276386424683050741
10200030005030500020008000500000007000807000800060000000500050800000000000400060001
10646026568050467736757260802063445272604053488234404233343050707032768840657720501
10004080003050300000000040007000007000006000002000406000200020208000300020000040201
10302050202050302025833050524856806046275083605080252030704670504436804030655070301
10405020700060407000700020700000808040007060005060008030004000800000802060004060401
10202020385560404060208878804070666080203740882043705022332083742560575080503045501
10407080000000304060406000005050004000700000800060005000700060000020008070507020001
10405033468548406880508038848077307367367354807880476730803367877063803073807060731
10607000000000600030600080007000700000000020004000200000400000000070007000706050001
10706484653430385080565748602070457360323085288063308034485828654540677520738070601
10200000000070000080000000007050000030804000006080006000000000000050000000300060501
10536855785087622638787560476024532040408063803060502028274377473080242276605082601
10000060007020500000000050600050800060003000500060407000004000600040000000306070001
16386080704070807357736050505250404678237047852580306847445030605662684740205080271
10004050707030704000700060500000800000006050000000608000200080700030002000207050001
10557030407020702080307560708256388327605650778360625080607460448020704063804023701
10000080700070005080007000700000000000203000700060600040004000802030708030003070001
10457370608458848020356050347242856280707065803083202772547066202040403720823050741
10005000503000000080300070000000004000504060607070004000700070002030500000400020001
16368060265040407570607564552685302040805040503080434040403070742020404045803063801
10008040600070800050506000200060008070507000307000500040405040000080803040005000301
10403083204020788230303730803230326050508236302526408020304024574250308650864340801
10300060002060400000400030800000200080600060006000005050407000600040504000500000501
10232480857780503583842040602287302877263480802063242630404628808070454036262435401
10000000400030402000008060200000500000006000407080000000200000808000300050000000001
16643853506073603034758070383366444663704056554050482652454670505527408050277858651
10000000004000008000000030000000000000005000000070000000000030006000006070000000001
11111111111111111111111111111111111111111111111111111111111111111111111111111111111
