11111111111111111111111111111111111111111111111111111111111111111111111111111111111
10008000000020000030000000000060007000000000300000000000000080000000000000002000001
15703070768030232030823254307040805065553720507230704436704280208336382883603040301
10000040700050002000400000703050400050000030006000800000400040603000800000702060301
10473480508644808063542450302020482550607085558072563580254070706060407440708060401
10002000800000008050000080804000400000305000200070000060500030600070707000800060801
10503052252485765430405040403353704228508830302680532070705350504740803753837230401
10304020000020000000202000700070004000700080500050007050300030506000700000005000201
10502060353060273484565360482080208025225030525034567060744060303066887380204483501
10508000408040800000400050002000503080000070306000300080207000607000800070306000401
10406748504070202634303027473045603020767780607860507280502854508220602027504050201
10200000003000500000202000005000202000700000800050006000604030006000303000807060001
10557343774455326880603457502053305873208023686050534054205030557036202870405038771
10000000000000000050800000808070005000202020003080800060003000700050006000204000001
10736530364328653030684380307060654530504660308060703630808323704040872022702784301
10600080000000300060000000606080000020800030700070200000500000708030006020002070001
10407058855040402463458286604078887080487050305470202732836546303873407060736040541
10002050005080300000007000002000007000205000502000200000005000700000506000200070001
10284070507070867876508030376857802348504048305057532865374040465340806054807060701
10004070706080800000400080200080300000007000705000004000000080000050008060008030801
10304050602020608050407352507040454766572030805243708080737086384043768870603022301
10204080207050006070604000208000600000006020700000700060003000006030000000805020001
10305052305027255070487070402374866858805020557340353367205752606040704638306070551
10507000008070000040000080002000000000003080504000800000202000203000207000506060001
10704322762032508546427533548080827484877050308075404720737050805440503080706053401
10604000007000708040000070002060000000004070702000007070007060700080407070003000801
10805076504670202020307080504040864082706020804038265063205560848060504040648620501
10200070005000500040604080200030002050004020807000400070005000206040307020700070601
14856540543070842330302050766720403460447020706030807880773020302050404032303070201
10008000200020200000807000800050400080200030002040200000800060700030607000206000501
10273035504748702075804866783074878080707370322560282637203040842677505070603777601
10000030004000004000200000007060000080300030600070600050008050000070003040500000801
10635360634086486770658854502030435640408073606030504030535030837560246080572560501
10000080000050004040007000303050007050302000407000703070203040200000500050006020501
10788024322020704070807020502040803020242020245378305080705025403662385086807060601
10802000005020800060700020700040200080007040800020006000306000200050003000300030401
10804072203050865480302680464853407873205460202080246764808420802070505020376870801
10806060003080008000500050000000500000300030004000400000200000607060705020000050601
10704070855532605076346262355240885247265050237285203020753828576053207076224560601
10504070000060005050004000500000600000300070000000305050000000006000506000400050701
10804036526060578040703080606786706640205076375485508048272720206540808027508020701
10003000005000407060800060008000804000304060000000002070000070200020604040007000501
10387747703353705070222584746020327056804420508545636043628050476580508070672653301
10000000800000003060000000600050008000200000300000807050000020003000608080000000801
10742480277872752060742470606042308460437520564550704040602332347085302058343230501
10000070006000000030000030305000600000700030008000805000500000800040005050003000401
10737060307058572634603080507020672633268020554088408040374250305640466080402026701
10004080402070003000306030403040000000007060700030007060003000503000500050700070601
10408036206060707460227070506523638082405072608840504025707043304084803030282740701
10503000402000400050004050702000008080002000800000607000805000400050008030000000501
10202070302786578024807030407042804050774860802457754670377360235830668260675535801
10407030300000006000504030403050003060000030502050005000600030002000400050500000401
10808030468432608250204020703060285022332030602070406078407087504048807046406027701
10203040000020603050504060005040003040600060700060300040007000303000002000006080001
10307820353050604020607027755742702050503720703780445830603860608542758788723080731
10600050008040700030006000600000007000303000300080000000300040200000000000700020001
10432076868050668253442780404026625222808054383382408865253020507067634630836260701
10004050002050600000000050003000004000004000002000708000600050407000400030000020401
10404040207040705063564030752232602073283074705020477080708520505628606020277070601
10803020300030703000300050400000406020002030002020007050006000700000803030008060601
10405070373380603060706378506030277020605860546063204023535057636560664030507036601
10202060000000703030308000008030004000200000800070006000400030000030003030602060001
10702062855687606750404065258036705827437722407530738360802385746038304035506030841
10607000000000600060800050008000800000000030008000300000400000000060002000706050001
10307352826650838030687554302060353720654037283083408086722726878280344470826070701
10500000000070000040000000005020000040502000003080006000000000000040000000200060501
10453278823036724377358850785028863050505042305060202033635853765060334455507068201
10000080004030400000000020600020400080003000300040308000004000400080000000506050001
15838070503070403643434080704870607532438023576850507588253070207546862220805060451
10005070402080707000500060800000200000005050000000806000300050200060004000405040001
10677070504040507020803560302564433432507630728740585020604440652060406068804023701
10000060400030002070006000800000000000802000500020800080003000706080707040002040001
10542380203268642030453080658883242850807037403037305874224085607060408850685040251
10005000806000000080600060000000003000803070402030005000200040005050200000600030001
14455020627050506280608558255386307080603020802040256020706040383080206025508087401
10002070600060700040503000300080004050202000402000600020808080000080804060007000601
10202074602030676330605480803480827060506537305762208030206037243480505740787220801
10600040003030200000200070300000700060200030003000006050804000400070607000800000601
10324280748680404754277070306755208777862780802074466220206258804050764078432283301
10000000700040808000006060300000400000004000604070000000300000306000700050000000001
14237867305047306067553070375662383476602045648040438557778680208773502020867773421
10000000002000006000000030000000000000007000000050000000000030008000008060000000001
11111111111111111111111111111111111111111111111111111111111111111111111111111111111
