11111111111111111111111111111111111111111111111111111111111111111111111111111111111
10003000000040000080000000000030002000000000300000000000000080000000000000006000001
16202050848080344020527268507040304045325730702530605584308580506288553652406050401
10000020600070008000300000808020500070000020007000200000200070706000500000706060301
10563870602646603047866350508070645570406037625076437440883020308070303570602020701
10007000300000006030000080202000800000704000300080000030300040200080208000600030601
10806027333743724480807020403656504635202320808660652080704830308870506258446360801
10306020000080000000503000500020008000200070300070003030300080606000400000008000601
10806020645060328246733260668030603076523020866073474040365040808053383520302762401
10604000803070700000800020003000408050000060607000500080704000705000200020807000801
10703755403070704234407035752057607030867240503570405830308666704480705044508040401
10200000003000700000707000003000207000800000500080007000803060003000307000808060001
10782856768525562650804532606076302533804033826080883043402050782086302240808025851
10000000000000000030500000605020007000305060005030200070002000200080004000305000001
10532450676264647020845840302040827550504850804080704740808373203040824086705872201
10600030000000800080000000608030000030300050800040800000400000407050003080006080001
10806052427020204745425762408047383040587040607630807372564788307464603020333070841
10006050006070600000004000002000003000806000503000800000002000400000208000700080001
10732050502070785786507080865558305385705033707047546825478030427460806047603040701
10004020403030700000700020200070500000008000808000007000000020000020003080007020601
10702060506030207070305738306070734246544040508842502020246043354085784820804085501
10308070306040008040803000503000200000004020700000800020007000003040000000805080001
10407054407086453020224080803537768453307040635550627852506858608020204374704040231
10305000002040000070000040007000000000006060708000300000403000703000304000604070001
10305666688067406254535762644060645747743050506088602630727040402620204030406057501
10608000004000706050000030004050000000006050704000007030007020200020402060004000401
10205042604840502020305040703040752052803050306047228072603320283020405070677670601
10700030008000800050505070300060003020007040207000200070002000704080604030200020701
12424260763040563250204030275220206330642050504020205470582030605040504063608080501
10008000400070700000607000200060400040500030006040800000800070500030603000204000301
10486068802344506074502432267076862020803260558720247364708040444756207040308242601
10000060006000003000300000003080000020300020600070200050004060000080004080600000201
10435740548068673620737742205050243650502084808050603060462050226360544080826230701
10000080000080006050004000205040006060805000606000804040306060200000600040005060801
10424063753070404040508060602040508060733030266555302020802022205464858048806080501
10707000003040500020500040500080500070008060200050006000206000400050008000300030801
10306057606050337850507770724628706356805350403050773775604280403040404020668220801
10502060003040005000200020000000200000800070003000200000700000607050608040000020801
10307070743365202082388483588250843884274080867374403050662844436027603065623670801
10208040000050003050005000800000800000700060000000308080000000004000204000400060501
10407085332060842020208060803636404380306052478728608037368420304520406063406080601
10007000008000308070700040008000604000506070000000002050000080500070307080005000801
10638676603338203020482464742060865045502560407787772022755040437250607070254844301
10000000400000003080000000200070007000700000200000303070000030006000402070000000701
10383580263837666080472860504045804560867260384740502070508735568087504082563320301
10000040005000000070000050208000700000800060003000405000200000700040007050008000201
10224020406082755258402040208060448636243060484052305060875580205360586080708084401
10003020402060003000704060703080000000004040700030005070007000708000800030600070401
10706023208070504270233040205747377075805038504480406028406067507068704020787740301
10402000304000200030004070307000008040003000500000403000203000600050002060000000601
10204020508364682077402050504023702020722280302336735360266370722830832420568643201
10502060400000007000807070602030002050000050606030007000500030003000400070200000201
10703080888824206360508070406080364075332080507030503048308065204024504052403055801
10502020000050308060204020004080007070700080700070700060002000607000002000008050001
10605830665020408030803058345873204050208840404820565350705780508278268364427080271
10300040007070600030005000600000005000202000500070000000800020600000000000500050001
10467078883060663443336530606078758447202078728764303547748080606058678730563730301
10004040004050500000000030008000006000007000006000404000200040605000500030000080201
10403070207020402052347080727747706035425045407080865020806230502577604080756080301
10303070500020604000500040300000605030008080005050008070008000200000407060008030501
10603070466550405060206888803040468060404340728083406052423068845540446070708076201
10508080000000403040403000002020007000200000200060006000600040000070006030602030001
10205054432686407350202046567023304558283455507630335450703335872088807075807080551
10706000000000500080600020004000200000000060007000500000500000000040005000606080001
10703482786740368070348772405060343760632036386057207085758562852240353480275040201
10200000000070000060000000005070000070303000007050003000000000000030000000500040501
10266532744026855777843330637053565050507027807060505086627742337040772377305043701
10000080006020500000000070700070700080005000400050406000003000300020000000705030001
16362070706060803626837020207230402878737054876580406277732040807622623830406040281
10002030405030805000200040200000600000008040000000305000800020300050003000804020001
10542030702050806060507620606452733327207640826230885060703780575030607047705033201
10000040200030006050006000200000000000603000500060500030005000405040807030002070001
10328360205626874080223020372343846770404056607024803624465066205050707840468020721
10004000706000000060300070000000002000505060606060004000800080008060200000600080001
16453030354060708650502838373772402020803060705050528080808060348030704054806064501
10003030300030500020302000300020003080705000503000800040803020000030802020002000801
10404063407070477670304630408220888070404544206235703080707087672520305440455860301
10700040002040300000200040300000200020300030008000008030808000600040208000200000601
10227640853530502885672030202882304736743330202058225360803564606060728077286328201
10000000700030803000004070400000300000002000302020000000800000206000500070000000001
12856448705052208047563080242674228483604026627050477254556520607678303030248636251
10000000008000002000000070000000000000005000000050000000000060003000004070000000001
11111111111111111111111111111111111111111111111111111111111111111111111111111111111
