11111111111111111111111111111111111111111111111111111111111111111111111111111111111
10006000000080000030000000000070008000000000600000000000000080000000000000006000001
14203070573070775020254875306080806026574820403760306562304620604222353636404030401
10000050400040003000400000306030700020000070007000400000600060405000200000208080601
10272260306476203054754270204050366840607053234046536460743060406020803760802030201
10006000600000008070000070407000600000705000800020000060400020600040705000500060301
10304044723455336850305050406844707837803630202380827060703450506470508486548270201
10303050000080000000406000400030002000600060700020005080600030504000600000002000801
10706080264020786574352540258070306045352070765072685040267070506024464860304556501
10302000603050300000200080006000302040000060307000300030202000604000700020504000201
10704384605060606725403073748062202080464640608760802540706748204450405053606080701
10200000004000800000503000006000306000300000500060003000607020004000803000608030001
10565225568883523260308877302023606533202068283060853063408060285047703450403072721
10000000000000000020800000808020002000602080004070600070002000200070008000602000001
10526730648523424040736480402080444330707330307020803450203676605040248046508455501
10600070000000700030000000402050000080800040500030600000600000302030003070004070001
10608024524070507483788678205045378060876080302620206664687237702687704070253080231
10002040007060200000003000003000008000608000306000800000008000300000408000700030001
10427030805040557767307060646466204676302042405047324733446060548730604045605040401
10002020206050400000200070700080500000004000404000008000000080000060004020005040301
10705040804040607080302878506050843247472080205435805060262057564074258280307054501
10307080603070006030307000406000600000006080500000800060006000003060000000204060001
10706055705024766040374020308877478847402020768440845878706255507080607534407030481
10207000008060000080000030005000000000004060508000400000505000703000405000303060001
10804488636032807678573333738050685323528040702028702430236050604750708080605045701
10505000006000708020000060008040000000002070206000004080002060200020305080006000401
10306045707840207040206030506080322036807070406046844065505440787040602070553730401
10700080005000300080603030400030004030005060703000700030002000806040705050300020401
16242720264050226540807060876460608850474060505060306840433070807060405024507080601
10002000300060300000808000600080500070300020005080800000700030200030608000203000701
10687073408747204034605325742033274070805240335680552366204060552367404020302226701
10000020004000007000500000002070000080700060700030800020004040000050005040400000601
10736470287037278640837558402080887360305023408020503040368080634470887060454260201
10000060000040006020002000604040002070708000804000508030703060400000200060004040301
10763054784080403050507040804040308070467040482825603080504052302487263057208060401
10508000006060200040600020600070700050002020300070002000302000600030005000800050501
10807038508080332650405240568522304245808260703040653744707880508080308030665370301
10203040008050007000600030000000500000300030002000300000400000204030205020000030401
10302070573346507068573356638330688373728050786646602040523667832023402088736840801
10502030000020008050004000800000200000300040000000205040000000007000503000300030601
10304053665040272060806070408787205250502063727364402066475860603720602044403030601
10004000003000606030300060008000404000305020000000002050000030700020705040007000601
10664362504424303050265553686060444052807780402634866062723030885560308070577664501
10000000600000008050000000500040007000600000700000503060000020002000708070000000301
10323440484368383050772280506078804340566250284470808040705452678022404083864230201
10000050007000000080000080802000700000600080005000805000300000700050006070005000701
10333070708085237534605070502070232375667080388043203050236780206720643020304047301
10007020503050006000607040303080000000003050700060007070007000202000300040400030601
10605085703050802520655070205547732027204042707540408074206035205045502030335480201
10303000703000800080006050506000002070004000800000808000303000600080002040000000401
10307030802655577038607020707023608060862860703354336230364260277280488840332884801
10308040800000005000707030305060008080000060207040008000400080007000200050600000801
10707020228746503380307030606030732052743060602020208046302057307083607023207034401
10803070000070406050805070003030005030200070500030500080005000606000004000004030001
10507750275030307070807055536483803040602420802530542680607580503832386557755030751
10800080006020600040004000700000003000202000600020000000800050500000000000200080001
10224046322080767477782860204067653853404038757467408444547060703022742370322360801
10006060006070400000000070003000003000002000004000804000600070207000500040000080201
10302040608080305054244080736367604076456034708020332070407540207883605020643060601
10306050400080203000300030400000206040002020002060004070004000300000808050008070601
10202080848650704050807466304040778030204440832056502065866083475850356060508072401
10604050000000308040304000004050004000600000600040006000600030000020005070303070001
10302032322834508480602078687085405666474825303460577580404263687086602022404060641
10206000000000300050500070008000200000000080005000300000200000000060005000808060001
10708323837360766030547287308080224470444032835025204028682738782240667260333050201
10300000000060000020000000006070000070705000008020006000000000000080000000400040401
10476686656046863347372240223038285080207045603040803085525877258040627686504072701
10000050003050700000000070800050300020006000400070403000007000400070000000306040001
18233060502020804457535060608720307382744043342870306754234020208548554580208060231
10003020507070802000700080800000700000004070000000306000500020400040003000606060001
10653030204020608060604460705684874736303220826540442040305440772060702042202067201
10000050800040004040004000200000000000505000500070200070005000404070806050002040001
10225420406743637030874030667482654850502074707065806366352023506030504220253030751
10007000402000000080800070000000003000404040206080003000200060006070700000400060001
13556020333060202760506522482283703040603020507050672020203060375070205045802088501
10003070200040600050405000800080004030307000203000500080508050000060803050004000201
10703056207070826450604820207680556030804278406423605050303062678560503480333420201
10500060004060800000700060200000500070500080002000002020806000600060807000300000601
10474280658320304878587030608844408742233820803034446670205552704040365045354837201
10000000300030704000007080600000800000007000604020000000600000203000800050000000001
14257584607056305067282030628345238883605038342020347587852450506442505050586264461
10000000004000008000000030000000000000002000000040000000000070004000007080000000001
11111111111111111111111111111111111111111111111111111111111111111111111111111111111
