11111111111111111111111111111111111111111111111111111111111111111111111111111111111
10000000003000000000000000006000000000200000000000000000000000005000000000000020001
17202032807036837877405430688088602030308025553078458462866354306070865780367030701
10408030008000000000300070000020008080502000006000200000000000308060200080003080501
10305320352456737660703020547370778730306453307080202078363430304020508048303620601
10700050000000000000402070008000200000400040004040008070002030400030804000800030801
10586060608442232543743020402044204522577540378040646260602020568746708040204020401
10800050607000000000500060406000206000007000300060300000400080600000404070605000601
10702570767062854680603060705260572060805088402258706058323020707660707640507645301
10200050006060000000805080304060000020300020400000008070002020403000208000500000801
10637080806030885337403070402058847460264850806065857075604050207027305078386480201
10000070600030005000004040500020002000500000202000006000004060702000002030006000401
10486250504373253060248060655528305044302282402033802774607070408084685030504860601
10002000700000600030300070000000006000206000404000500000404050002000004000300040601
15303028264373404733703068335853473080204620207630646220608086256720803567578040501
10007080000000508050005000700000006060003000600080000030502000000020800000300050601
10573040546840705030607560604485708855602088505027505040624767488036522230206662301
10500080800060306000505070700070004000505000805000408080300000300020006000200060001
10802040603040408075603030346070734080683570464470202050806660205050806076362070871
10206030308020008000200080005030008080000080007000504080400070304060500070006020001
10504070605083728233505638605030206226575023406047604040885060202030347550404044401
10807070005070007000807000200030700000006070300030008040604080002040000000502000601
10407426822050802070305070432030545586408030707880275060702074888763245085584830501
10600000008000706060200030008030004000808050400020500070008000000080005050003040601
10657274327224404020424460807668603040802020486020802848386645537030204620205080501
10000000800000006050200040800050005060600080007020700080000060000040602000308030301
18864030502583284050703030785050777070372777406080202030338070507620605046803060801
10002050500000006060008050703040000080000000606030206030600060300040202000206000801
14402230503865608060443040506040867055328530308050303080807640777220204580205750601
10003000805000400050003020702070005000000020007060802000804000400020300020700060201
10302048273080288684308050402060405724777676583880234253605082202030302070622052701
10506000000030005000003070004030506000300000000000500030004040006000706030008000001
10703377225525506043878020426065404040306085447452502080288020878523425030807044261
10800000700060002040000060400030007050007000007000405000308020003000007070508000001
10638642204050538050508480306740677037723855603080602852204023507068503034306055801
10400020002000600060600050306050400020000000307050500000005000507000404000006000301
10403020407758704350603750502040805572888550226070704742626040604220706274722030801
10005000205000006000608000308000507000000030000050200080007040605000300060006040801
10282046508056482044474057808783504020276057476370555070704080602080834065602080801
10007000203000600020005040005000600040005030000000400020203020308030006000805030701
13603772808060706862602030678040773272204060306727805338505020803030803270303520701
10008000208070800000602050000040200000206000400000600000003040300060602000700080601
10656050808060687260206058554870587440768437368230338047706020366528706070706020301
10200060007070000080008000000040700030800070000080004000408030606000208030806000801
10406528525050783058482340624040403070505040863060405220548030404050662040686734401
10400000400050006000000080300050005000606020800040400040700080007060000070003070001
10305370607522504224465030404886227757475060605223232068605054288025705765805030551
10804000605050006000002020600000005000005020800000000040006000007000400000200050001
10644070502030606040847040778745307052405075306832427770407236448420603570502228301
10700020505000708080300020005000704070008000604000000000803000003000307000606000401
10305242607852244040206650508080603060845670367087637776245068504046365072702020701
10500000400030000060600070600020600060600000300080000080002000800050007020202080001
10853420457020705045333040872060502550806086208030352060205070405420708060807060421
10000070005000508070000050003020408080005070006080004000407070300070600080005060001
18772062308486405080563733807650606047335230306088506648805760535070745448858073301
10002020003000003070008000205000400030006000208000400000303000800020800000007040301
10203020882254868063402650303052757560806086737774503220708030506850206282708060801
10602060600000005000200000704000000060402000400000200070300080600070505000307040801
10226030336872505470704646708247806050506050804460273840433874367050504064705020601
10003020003000003060600000200000602000702050500070000000600000008060002020003050001
10805062505024462050288764663570848383506070566024885723228583702045882020335075701
10307000704050000080000000000040000050006070008050000000000000707000000050006000201
10607820305030204554435556248040285080463688354040284872548850208262525845508880361
10400080400080500000000000700050700060000000600060600000007000500000000000200020001
10464040776850555320658570605232707046335780403340206362304064323722607620724053701
10008000300080000070000070300000804060000080400000602000707050000000600050000060001
10503358204040236067486050277070604020307020223062502050208045704870202072326830631
10306000002030002000002050003030305040808060006070002060303000200030606000000080001
10205025256064585033702252707340602260288084507720774023207020682660808275326023601
10800020200070002000305000807000800000500060702000400020004040000060200020002040801
10676650408340507543402080882070743785702240605060407630468030225030808020685030301
10600000300000300040005060000030008000003000600030500050805030006080305000400070501
14802034275344255060574040864250542088873040767730403020303080847040405372507820801
10007000000050004020500030000030600030000030200000303000300030200030305000800000201
10604855343088503050202078537030707780608450705454845763772030305220707080202855501
10400000002000008030606000700060800000804000700030000000006050200000203060600040701
10766766653088225060505644303358272663606083464350407855606060357854478050647060401
10000000004000400030008000003000600050008050007000308000003060800060600020002000501
10575637803445704083365065583650304030422070707043304083242070605080203844803533301
10005000300030003050006000000030608060500020808000507000700060007000600040002000401
10706060874070408080604825637080705660805840804740688460844585686875683030357070801
10500060008000803000300000003000300000800000800030000070000000000000000040000070001
11111111111111111111111111111111111111111111111111111111111111111111111111111111111
