11111111111111111111111111111111111111111111111111111111111111111111111111111111111
10000000006000000000000000002000000000200000000000000000000000003000000000000040001
17307046205063245852805860458087303050406027473022725484476748703050442660788050701
10305070006000000000300060000080004040706000007000200000000000804030400070003040201
10207260347254542370707020668870855270804554306080604076253830506030306026705680401
10200070000000000000207080002000800000500030006050008020005070400030706000300050301
10372040703527278444762020307054204467324820524060224670506060685647206020703070501
10800070208000000000700070704000404000004000200020700000700050700000407050305000801
10603420862023224650602050308880356060802043208823408062886020203250606520807656501
10700040004020000000306050208030000020200020500000003040006070303000402000400000201
10264040203080737588503030608066544680335570505036358057204030704035608046245330401
10000070800040003000005070700060008000800000305000008000007050207000008080006000701
10424850408478456030855020566252707025203723205048202278605080406026325080706280601
10003000300000700020300080000000002000405000608000600000507070007000004000500060601
16405073244533307578506072283853656030303560807580266620803047785440504246727020301
10004040000000707020003000800000005030007000500060000030503000000080400000700020401
10838060734250403020502530304368406345708077708064207050332253787054336860503547401
10700080600060703000702060300060004000404000802000707040500000500080005000500060001
10603040805070302034702070682020468030553740583450708020204680302030203072582020531
10402070602030003000400050007060002030000060003000604040800020303070700050004070001
10704070208083485727508773703070408283326035804064506080232080504060627740703076601
10207040002040008000207000800070200000008050800080002070803040005070000000508000801
10708376644020405050608030276020748378805080702730282020208078447438274036475750201
10700000003000805020800050005040005000805060800060700060007000000030006020002070201
10677822282245802040737750807245306050407040386080704288835586883030407550703040401
10000000500000005020200030800030003020300060006030200020000080000050307000508050201
14626070805876255070803080437020753060488374306070803040427040206650507032508070701
10004080700000007020004040305030000050000000803050505020800030200060703000302000501
12306740308455803080547040607060254028273540203050706040204750535430705440205440201
10004000603000500020003070808020006000000040007040407000606000600040800040800030801
10403032856020523434402030405020803376376356887830485353304028402070405050753088601
10403000000020006000004060006080202000400000000000500060007040007000704030003000001
10202454686428405076767030466082206050303075558242402070272040456643724040304074631
10600000600020003040000020600080007030006000002000408000404080005000006080304000001
10886635403020652060807880403680287057353883304050808378208052605067704057607032801
10800080002000200060300060504020600030000000806060400000003000402000204000002000201
10207060404545206530305740604080205564778260377030308484787040703630704252376020301
10006000302000004000308000203000603000000020000060200050003070807000200020007030701
10343025303083384075638072306243605020528056232730874060305040507020862077608080301
10007000203000600020004060008000500020006030000000300030205060504070003000606020701
17605567308070702537502080345040735757406030208637606834202020706060203570402670501
10004000202040500000205020000070800000602000200000300000005070600060205000500040401
10483050407040356530706064433640856620885338358580765034405050877786305070307040701
10300030006040000060003000000080800070800080000040005000408020708000208080702000801
10702727773050444048278560873060702050508020685060308740864030606030735060353425201
10600000800060008000000080700020002000306040700050600050700060007020000060006060001
10305270505872805733647030805727664365855070506533756068504023763052305835305040431
10303000304050008000004070200000008000004030500000000020004000008000500000600060001
10378050707040507060586080627642406062504078308624777360502586252740503280507782801
10500020802000308040600060002000305070003000205000000000804000007000407000203000301
10603745402886886020704770203070604030285860624084342783888032408068565088205050501
10500000400040000050600020800020200030400000500030000020004000500050008060404050001
10555420533070305086466060375050404530408035507030884060302060607280402080706070421
10000020005000404060000060007080304060003020006020008000708030800050500060003020001
13444087205232705020377448408540202032876560704022306353308260726080652522725024801
10006080003000006080002000502000400070008000203000300000506000400040800000007060401
10708020265563648066407750403052752580508065663732203680303040603340808427705050301
10302060200000008000400000204000000020607000300000500020700080200040604000708050301
10386020536736502780504277704466406070603070207650278520244242542080402062205070501
10004020004000002040800000600000402000307050700020000000800000005040008020003080001
10608053206088534020232265857670242487607020564086647283252337708073635050262022201
10202000505080000030000000000070000050004050005020000000000000603000000050002000601
10808570702060503632678776488050827040224468768070232375425230507768836428608640881
10600030800070200000000000600050500030000000800020500000007000200000000000400030001
10353080565570466250237320504333208037337460606570703836704038878334605340236087801
10002000500070000060000070700000506070000050200000607000608070000000300060000050001
10403663403050258037684080774030602050608070475064305060507077603320205048454220481
10808000003060003000003040005050804050702060003070005080308000700030507000000020001
10408062374028457064607485402760702280753074702670472068203070335230502555363046801
10800080800020002000606000208000200000500030708000300050008040000020400070006070201
10378420204770708527805070482070836482302220202020205870556070567060804080388060201
10400000700000400050008030000040002000003000800030400050605060005030302000200020301
15404068456732664080866040388560687058633060242260705070605050786040404365506260401
10007000000070005080300060000070800070000030500000806000400040200080805000300000301
10305377237086606030604084447060608380203320305448368373583020306330506030308346401
10800000007000005080806000700060700000706000800070000000006070400000303080200020401
10826372657036527070408358308335546853302055852820208424708020427276363030445040601
10000000003000800050005000008000800030003030002000503000008050800050400070005000501
10886256705553804076734077884580306020868030707082204087546070508050602258304472501
10007000200080007060005000000020204040400050506000702000800040008000800030002000201
10405050643040304060504345564080606770306440802240843340727567674687568060787060601
10200080005000808000700000008000400000500000400040000070000000000000000050000080001
11111111111111111111111111111111111111111111111111111111111111111111111111111111111
