11111111111111111111111111111111111111111111111111111111111111111111111111111111111
10004000000070000020000000000040006000000000500000000000000080000000000000002000001
18504060476040684030638243302020402035385470807580802882307560302425277652703030301
10000060300030006000700000404060200030000020004000500000200020307000700000803040301
10332230302723502028864480805030725630604058332033742550724040803030208560507050601
10005000400000004040000050208000500000403000500050000040500070600030306000700030601
10205054477288884630208050303268704782307370502550858020203380302670505865773780801
10406030000040000000705000500020002000800050300060005040300070508000600000004000701
10507020785070335772265430835060206066658060843085674050578060407035784330502773601
10307000305020300000800040004000304030000060807000800020605000508000400050604000601
10308268208070605675405086864043205020258250202340306270806778807240607064808080801
10500000002000800000602000003000405000400000200080003000208020005000705000808050001
10757856736274386760602438807087805876604074635080852082203020247087805830802077871
10000000000000000020400000505070008000507020008060500080008000300060007000407000001
10567670845726586050336730206080276730402360703040607270205856502030847058704453201
10800080000000700020000000302020000080600050500060800000300000808020008030006030001
10805053645020805245482456804057682080833020702260808327346828204365406080262030741
10007050008060500000006000008000006000602000506000800000008000400000707000700070001
10845040605060734823805020526572705665307035502076654682836040568470302057406080201
10002050202040400000600060300040500000002000308000003000000060000030008040003020801
10704020205070503070808783403020852555347050307836504080358046576044538760204035301
10306080303030003070607000608000800000002060700000500030007000008020000000202060001
10508042606022484040464040307322783287606080655630523472508768505020608743803070531
10702000006040000080000040005000000000005060605000700000706000505000207000608060001
10608787586045804553765384842060443535843060804034402820742080206880207070505042201
10602000002000606050000030008050000000007050702000003020005040200050506020007000501
10605048403620206060504070708060764038705050507032577066606360256040805070335750801
10600050006000200030706050800080003020006030707000600030006000403030306060200030501
12374220272070832750303050224320805350762070808080207350763080204030204024708050501
10008000600020400000807000600030700060800080008070600000300020800020303000607000201
10374025705272504082706326228065367020803620538730672786307030868275608040605486601
10000030007000002000700000002060000080500030500020300080005080000040008070200000201
10664570425037832820474777703020787660203043507020504070256070227220565050855850801
10000060000080004020004000805040003030204000406000605050503070300000700030006030701
10253066752070405060302070707020606070366070637435602060602088305563827088805060301
10607000005070200080500080200050300040008060800050008000502000500060008000400070501
10602048403030226330506750443345505644508720408060856583603280604080808060772450601
10303040008020006000300060000000600000300030007000400000200000206080702060000050301
10706030364734606024275335637770643385774080634524703020786482556037403032385570201
10708030000040006060008000400000600000500020000000602080000000008000307000400050401
10408047855070454080706060303284608630503084258643202064336380308850204075408080501
10007000008000508030500050002000602000704040000000006030000020500060306060008000701
10565823508332605060525823236060784084608860205442543038728020585660306020722467501
10000000700000004040000000300020007000700000500000205020000080004000703050000000801
10838760334327378020246280802076606260685520443830507070805737262057604073755730701
10000020005000000030000080607000200000800080006000302000400000800080003030003000501
10586030604038568276308070204030485242326070223057504020378380402260524030706046501
10007080804040005000305040506060000000008050600020006050004000306000800040400070601
10705057507060308250232050507825778034407046802460607088403052605038207020325320701
10404000406000600080008080206000004050003000700000803000703000600050008030000000301
10208060702362636085603050502077803050556250305825488460265580653730887420382845201
10506060300000004000505040504050006030000080407060006000700030003000600030600000501
10204020754468607870805040205060646026872020303040406054804068404063708035402074401
10804080000020503060608050007070008040500080400060300020005000605000002000002020001
10806360762060806080408032227578603040408320508850544720702450607238537673872080261
10500030007020700020008000600000005000602000200040000000500030600000000000800070001
10556077264060526245472420403048362655508058275678303332638050506088824280736570801
10005060006020800000000020007000007000008000006000206000800050407000800030000020601
10807040205070508042784030262578205036342076608070343060202850802365708060562030701
10706060500040605000600040800000402040005060008030006060008000500000807070008080301
10306070732820703020308384502020322050708350756033207038647076488780436030404045701
10307050000000302020504000007080004000300000600060003000400080000070007060207060001
10202035733462605360802063388034603284445775703680557220803522656046202057708040351
10204000000000200060800060006000300000000060005000500000400000000020006000807040001
10603624777320236080858855804020274630325082338088203022767533234860535440227080201
10200000000050000060000000005070000060603000005050005000000000000080000000500040201
10552465578083346258758830253053736060707058704060508073253848867060883448203036401
10000050002030300000000040200030500070002000600060302000004000600020000000705060001
12886070403060707733552050704350704656558045888250404465575050402456555340402070351
10007040604080502000800070800000200000002030000000304000300070200030008000405050001
10357040206050804080504420707344375668608670456670428070204620758030205087407058201
10000070500020007060003000200000000000706000700060600070003000504040802050005030001
10887270704748364060766080268677637250406057603056203283556082706020208860428040841
10005000206000000060400080000000005000403040304020003000800030004080700000400030001
12265060238080502840507387422358405050204040703030526050403070358040203065504043201
10004040400020800030808000600060002050203000708000400050703070000030508080006000201
10705063503080246350408870703460825080807464705428306030608057665380507260386780701
10400040006080600000600070500000800070300080006000005050604000200050807000400000401
10583630565550304626332060407453508352523870404077456470804725206030363054544287201
10000000800040602000007080500000800000003000208030000000400000605000200030000000001
17557854702065208077565080633254667475304052643070754668827350702565806070823728821
10000000008000002000000020000000000000004000000060000000000060004000005020000000001
11111111111111111111111111111111111111111111111111111111111111111111111111111111111
