11111111111111111111111111111111111111111111111111111111111111111111111111111111111
10006000000020000050000000000080005000000000600000000000000060000000000000003000001
15805050726060843030246777506050408043374680503250202822304370806378543634405060701
10000070700040005000600000307070300070000020002000300000200070807000200000207080801
10636560406867504056848640504070542730806043567046586360534050304080206780503040201
10006000600000008040000020603000200000805000800020000070800070300040704000500070301
10708034564367374750408060706867303278308580304460327060708280202430503623542730201
10304080000040000000704000700030008000500070500020004060700020606000800000008000501
10505070767050276374762870222060206038676050556022262060752020608076253830803778801
10507000308060400000300030005000603080000050202000800070808000604000500060307000801
10603572604080207278503066268087806040463370203560206640504655304830202066404030701
10400000008000400000202000007000203000800000700070004000505020004000708000208060001
10646686568785562230604677407033303772804064864030336028808060725023804770606087431
10000000000000000080500000806040007000602050006050800050006000800070005000307000001
10328580543456566070256460806070632480208660605080207550206448706040864078307542601
10700060000000800060000000602040000070800080800060800000700000408020002040003070001
10806035732080705456544365303063683070285080402570707386752776302446603030564040271
10008080006030300000008000003000002000205000706000800000008000600000705000300060001
10378070502050353756805030427547402738402038207028387586527070456520706028203020401
10007020606060700000800050700070500000002000702000005000000080000060006080008030401
10504070304030608050602872405050488755274070307365307070333037742027727450307048501
10204030808070004020808000803000300000005020700000500050006000003020000000802080001
10207052802075688030824040605542543438206070328370684468502436505070204223405070831
10703000008040000070000080002000000000004020205000600000508000406000707000604080001
10205842347085404575286432634040467286362040405046306340445070208630702070502084401
10202000005000208020000080008020000000007070207000007020004040400020307030002000501
10307056207740805050506030308050784053202070508024286082405680432050202020233440801
10600070008000400040803080200050003020002030802000700040006000505070502020800040501
14666340344050774340602070626830407550822050207030805470875070302070205067602040501
10005000300070500000508000300050200020400080008020300000800020500080305000607000401
10635062708365608084808488464056773060302560467330327846605050676742706020606778701
10000060005000006000700000005030000030700020200030400030005030000060005070200000301
10268780638043784640636746307060723230808082804060207080268070844430753060622740401
10000080000060003020002000607040002030305000205000502040805020500000300060004030601
10658042428050705060606020502070704020865030764527608050603084308327874033805020301
10802000008060300020500080700020800080004050200040002000303000400050003000300080301
10407023504030386550603640585888203366706540402050784548704350705030803050876220401
10402080005020002000300050000000600000300020002000200000800000808020403060000030701
10502020485338405025738463886820525877266030658323306050274267425046202082635850701
10505080000020008040006000300000400000800030000000302050000000002000207000300070801
10305058434070877040202040806787206860407087374273203052258760802470202086603060301
10004000005000807040700040005000204000305060000000004040000020400020407050002000201
10722357604322205030237373774070264043605780205528576022642030473850504030678245201
10000000500000007060000000500060007000600000700000603040000040003000608030000000601
10286450657876476080275450206037304740787370653830708060407765738043603066825860601
10000070002000000030000080703000500000700050005000206000600000300070007070002000401
10467050203075836582402060708050257333347050574085206080874270708820534080208074701
10006070402030006000404050606070000000003030800050002050003000303000200080600030801
10706036207030402550626040408575647088804036308370403025407027503052202060828530501
10505000208000500020007040203000005080005000600000404000704000700030005050000000201
10203080805576786035802050707027505030578850606232583860272350763380887270382735301
10405020600000003000306070206060007020000020505030002000400030003000800070700000301
10505030657373506250406050404030525052663040302030407047305075808058202036208026201
10204040000020206070702070002030008060300040200080800060008000403000008000003030001
10508460552050504040704065734422502080202740406250733670505450302525645532746070421
10300070003050600060002000500000004000304000600050000000400020700000000000800050001
10554055282060677786433540303077886363306056533782303722337030407062622220572440401
10002030005050300000000050006000005000007000005000607000500060703000800020000070401
10608080206050806066558040258682407058548054208020838030803670508487507070543070701
10803050500020207000500060200000205030002080002060008020008000800000804060006060401
10808060428680403060308824407070388040203250477052606086587026225550267070503027401
10204080000000808030306000006040007000600000800030003000500070000060005040702050001
10704042662342805730203025743087803275753354602360835630203238685072602052707060221
10508000000000600030300080006000800000000020008000700000600000000070002000205020001
10603484684460524060847454207080625350646046562032804073427533885250273350634040401
10800000000050000030000000003030000030207000006050004000000000000030000000200030601
10556343848072855632464780752062534030503083702040605055548257343020627822806027301
10000060006060200000000040300040800050007000400080707000004000500080000000604020001
14654020508070803483773030708460807285852022545420404887465050507587837770206070541
10002060407020406000200080600000400000003020000000203000300040800020002000206070001
10675070502060605060505370407457428485507870484830673030308730785030206076605088301
10000020800050008030008000600000000000605000500020700050006000806030708030003050001
10344860503585845070372020848557675360308086408032408223455066802070406220823020451
10003000703000000060500060000000008000503080505050005000800060004020400000400070001
14632050778040806330805835227874705040805030404080743030808070422030805022406068501
10008070600060300080703000300040006020708000806000200050703050000070605070005000801
10508035708060745670705620605550324050208675805648308020806063527450602280823870301
10500050005080300000600030600000400060500050008000003070606000800060802000400000201
10477670884470305863222080702563808572365770807035265550304843803040624078253234501
10000000700020205000002080600000600000008000606050000000200000807000300060000000001
13487358308055403046545060852263266727405025758050346665582520404328603060622258871
10000000002000004000000050000000000000006000000080000000000030002000005040000000001
11111111111111111111111111111111111111111111111111111111111111111111111111111111111
