11111111111111111111111111111111111111111111111111111111111111111111111111111111111
10002000000080000060000000000030007000000000500000000000000060000000000000002000001
12306080787030256020888785306060403032326330305840703825604280403278448328605040701
10000030600020007000600000506040400040000060006000200000600070808000300000608030801
10762750603486702024346630204070833550204038788086862480654040204060207820603040701
10005000500000005080000030708000800000204000400080000070800020300040304000700080201
10703047222884475770407080403263507223305820606250656050303620702630803476623770301
10303050000080000000606000300060006000600040300080008070800050804000800000008000201
10706030668050423628226430732080204083633050483026753020872020506064238370705872401
10207000804040500000800030004000404030000030302000600020404000805000600040508000701
10306522306040407454508057235064607050833620502260407480405652402640307072405070801
10600000006000700000502000007000804000600000400060005000604070002000708000507080001
10427573537473253830508772308025405563308056873060857064706040345065608260205087671
10000000000000000020300000504060008000208040006030500050003000700060007000705000001
10372540266364727030647640706030878780406250602050603350205762606080856065607653201
10400020000000600060000000506040000020200030300080400000400000207050007040006050001
10203023353030704645748278302077563050726070307880402477763752508437802080678020421
10008080002080400000005000003000003000203000407000500000007000800000206000800050001
10264060802060364365308030685434807788508078308062846253642070564670805083302030501
10005050506020800000400050200080700000004000602000005000000040000070005070008020501
10204080303030405030204437504050258845833030205757504030326037845072663740403075501
10607040304070004020608000707000400000007060700000500020006000008070000000506060001
10506074504054668080675030502324353685705060534840764857506767203050605438708020321
10704000005060000020000050007000000000004050407000200000303000202000508000405040001
10707667385024705257733334566070462328627050502022707480542070604380203060603058601
10302000002000606020000020002020000000004060305000008070005050800080206040006000401
10708077204830403080803070603030657062505050305026874028808230374030208040556660401
10200040003000200070405020200070004080003050505000300060008000306050407080600080701
15438770544030687550206050362640705640667030506050207720247080604040705075603050601
10008000200040600000605000300080700060200050002050600000700070600060803000306000501
10252054707566808073306572364023885040802320653350466538305060365427403040806467701
10000040008000004000600000006020000070700040500080800030005080000040003030600000801
10225440258086328520466224805040687840404083607040808020634030784750765050467820801
10000020000020007080005000607060002020502000202000802040408030700000500070004030701
10556066365030803040207040407020503050743020434485302060508033406355438086608080601
10604000005070200070500030700070800040003080600070006000504000300050007000300050401
10704025306050874760407850787453608748602340406060677873502260403030805080737830601
10804030004030003000400080000000600000200020002000500000200000508040504050000030201
10607080658787404072728686324860385878638050227243308060846676433024702062737270301
10606020000080002030007000600000200000400070000000806030000000007000407000300060501
10203063257050238080406070407273504360806086247347607056663270302640308033708020701
10007000002000208020600050002000208000805040000000004030000080600070305050008000501
10545352603735804030774528668020885057608550304387656046575070627330205060752466501
10000000700000008050000000800080003000800000700000202070000020003000802050000000501
10765540425286388070244470608054806440575340668440408070604767278084207085874550201
10000080006000000060000030406000500000700020003000203000800000300030008080003000601
10427060308028855544803030302080888378455030285088307070585680303580284030704065601
10007050302060002000307020305020000000002040200040006080004000707000500080200070401
10502085405050705370733030207223444053504044604430606043606053506045507080748860401
10808000207000600050006080604000003060008000700000207000608000500020008060000000701
10204060208428265037506060603048505050447880503385545560654320268550464370465824801
10806040400000006000508030203050008020000070403040008000800020008000500040300000201
10702060386542704660604060402070283085584060404070602066805056503065708025706054701
10304080000030403050302050008030007050200080200030700070007000608000002000004060001
10607670323050302060407074878834807080503770705530653880708760804587487472858030581
10800050004040600080002000800000004000702000500030000000200080600000000000600020001
10858043638080242745336280607044657523703063525374602775688070507063233450878670201
10007050006040700000000070002000008000004000006000302000300020707000200080000070201
10702050304080403077533040732474404083585077603030782050305250202753404080646040301
10207070600080807000800070200000507020005070004040004050006000700000402070006080501
10203030825830803050303843803050863060307750322062204066735086877540872060304048601
10708070000000805030806000005080007000500000400060002000700040000020006030704060001
10504084873285508760407054878074707267368744602470727280805566354045204052405050361
10208000000000500060800030003000300000000070004000500000500000000040002000705020001
10604567273380665070267647703020648240877045886054803068328877346450687550622080501
10400000000040000020000000007070000020403000004050007000000000000070000000500050701
10777634357073838642756630254064564070807042303060805053365834577060522264206054601
10000050005020500000000030800030600040002000300030705000002000700050000000203040001
14634020308040205756223020803530605838775038244630702244727030507847572570802040821
10005040302050503000600070200000600000008080000000305000300080700040002000502040001
10563060208020308050506830703724227355807570773860847080703830367030408068605048201
10000060200020004040003000400000000000402000500030700070008000405080802040008050001
10234780505752635020547060345222663430803058302048306468672034502020508880562060841
10002000304000000020200050000000006000205040406020007000800020004030200000600030001
15465080782080704530302424722375606070602030404060672080203030587070502047403078501
10005050400020300070504000400060005080802000805000700080404020000020305080004000201
10608063603040237460607220508370472020504883507336703080405088263620703720685780701
10800050004070400000800080700000600080800060004000005060807000300060402000600000801
10382730838570408462364030206887408668858840405048862640303682806070352075367754601
10000000600020305000008030500000700000005000602070000000500000807000400060000000001
15527866804055605068424040475373788263804027733070252866684780803664504070676856561
10000000006000008000000070000000000000002000000060000000000060008000002040000000001
11111111111111111111111111111111111111111111111111111111111111111111111111111111111
