11111111111111111111111111111111111111111111111111111111111111111111111111111111111
10002000000050000020000000000060008000000000700000000000000040000000000000004000001
16405040387030842070424558703070304077833550403280205867505270304822754767704080501
10000030700020005000500000306060800060000040004000300000700060307000200000603080201
10752630703485605022472630204040784660207074846023435850473060305070602740608050301
10008000800000005040000040704000500000404000600050000040700030300050706000700080801
10203045855678283340206030207823707552407730207370484040607880502450305684548250701
10606030000020000000807000800020003000300060200030006030500020703000200000007000301
10602080767050748563584750823050408062636070855054254030564030304047864580502527701
10305000408070700000700070002000802030000060704000500080702000706000200020806000601
10603627808040806535306063555047605020322580305540204270205887506320205035204030301
10500000003000600000708000005000302000200000300070006000304040008000603000306040001
10325345333846787220402645706057205355407042536060483054704040673027508240603047441
10000000000000000080300000308030002000205080005020800070003000200050004000806000001
10345330846826336050234230707050733220407770507050504670705365706080248066807286201
10600020000000600070000000804060000080700040700060700000300000504020002050006020001
10603043734060704862722257807057447080578080408830304333877824205747707040753030221
10007030003070200000008000007000007000606000305000700000008000600000705000400030001
10827040606040645336603060457576507653205026403045853858855020554580206086608020701
10006040604080300000700070600020800000008000506000003000000080000060006020002020301
10603050504070408040608886402070282557228020206233505030277087437033343580605075201
10207060702080007020607000405000700000007050600000300080004000007040000000808080001
10705075307045685030487030402738533886603040442380467334503367807070307487303020261
10405000002070000050000020008000000000007070406000600000205000404000707000308020001
10807757764057704367464785464050765338577020408053202540257030804750603080205047601
10702000007000807040000080002060000000002050802000005060003050800060302020003000201
10205087706650808020206070203070542085504020502065823077303430727060804040874570201
10600020003000200080807030800050007060002060404000200040005000605020803080700040601
17633260276020557650802050342470308860753040606070604340656030607030508034502030801
10006000400040500000507000700030300030800020002080800000500060400070705000305000701
10663072607767506074305846484026534070506560227250582322804020243224604020203548501
10000040006000003000400000006060000080300080800050800030003060000030002070800000701
10227550488058855570582233604080667720304055807080202070557050822450373070637750601
10000040000060006030004000706070004040205000602000803020202020700000200050005050801
10328058856060708060403030308080805040777050257378607060608048608655545078605020701
10207000007030700050400060200080200060002080700070003000705000300050008000500030301
10707087306020523680805840544363207747803330305030784476504670208030405080775780401
10604070008060005000300070000000600000700080004000300000300000307060708040000040701
10405050634536702063347626862260748574278080658687408030787786728073308028232580701
10503030000070007080006000300000600000300040000000308020000000005000605000400020301
10407072275080433080802080605867806320305046276653306032884870504370203067405080501
10008000005000706040300080006000207000805020000000005040000030400060702060004000801
10383653603848408020667673632050282064304580304645865084736040745720803030563463401
10000000500000003030000000300060007000800000200000706020000030007000407060000000501
10832740626778522040547360506056305830384660638720203050604428882047205073686870501
10000070002000000020000060708000500000700050006000508000500000300030005040004000701
10688040603024827556206080807070586254276070767048207030455370504550244020706044201
10004080407050005000305060202060000000005030800080005040005000302000500050400050501
10708088406020406620473060205682253026702045506830208073404066408054206020624430201
10704000307000500080003020502000004070003000300000802000306000700060002020000000801
10603040202857643056403060204052405060247420504777588480227860225420673470786435501
10708050700000006000807050303060006060000080204080007000500050005000800060800000601
10507020577242408620205070407020657037675020402070207063502025302028703033506086201
10306070000050203020705020008040006020200020700020400070007000608000006000002060001
10604250656070202050407022243422405050303340703320637530206730404464672755643020631
10300060004030200070006000400000003000808000400040000000400080800000000000700060001
10276063582070465552363340302058734448706076647748603646875030707056352670522450701
10003030007030200000000060004000007000007000004000206000600050606000500050000080601
10808020803020604036868070533448607025626085802080654030605560405748403060546060801
10304080300020807000200060800000604040005030008070008070007000700000504070005060201
10608050645770203020804768407080265060702350384038206063572022542570864030605063501
10405070000000606050707000007080006000700000200080006000800040000050005050607060001
10206063388366806850204033464067803856855765706250727480802687665038802036702070781
10605000000000700020400040003000600000000060004000600000800000000070005000605060001
10802884486440783030856476305030475740578077657058206037683755335560682640235080801
10700000000080000050000000002080000080502000004030008000000000000040000000500080801
10464872434076664835884850472088723070502067505020408042325445822070586438504034201
10000060005060800000000040400050200020006000400020504000002000300080000000403080001
14234020605050608465562020207340403773265072376870505832486040708788737840804070321
10008070304050508000200060300000800000002050000000706000300060700040008000707020001
10742080605080607050303870408477578332407740274730325020208830267080305038604087301
10000050400070006030002000700000000000804000200020700060008000208020302030006030001
10752480305444857040747030867835646320403058707085705266868048403060603250278080521
10003000703000000030200070000000005000308080703020006000300040002060600000600020001
15455020548030804760805246823645607040602040408040447070507080674070605086605085401
10004060700030700030603000700030004040603000705000400030803080000060504070006000301
10706068708060373870703680206870388080602545308632305040803057447870203650825520201
10600020008030400000600020400000800050700060003000007060202000400040207000700000301
10367280575860402353652040407683403888562750405026776580203555302070728072255563301
10000000700070302000006020200000500000004000406040000000500000503000200030000000001
14723666506063507034732060543585874843208032464080368834482270303874604040467824771
10000000005000003000000080000000000000004000000080000000000030006000002040000000001
11111111111111111111111111111111111111111111111111111111111111111111111111111111111
