11111111111111111111111111111111111111111111111111111111111111111111111111111111111
10007000000030000030000000000070002000000000800000000000000060000000000000002000001
12704030343080358060275273505080603033355650702480804523407680508642656858408040501
10000050300080008000700000306050800070000060007000500000800030404000300000605030401
10766540802642504077476860703080882650204025677027875560286020203030402770208040601
10006000700000006050000020803000300000708000600040000020300080300080805000800080501
10804088577558784480303080205473604562308520803870864080502220508760807835865530501
10707070000020000000705000600020007000600060800040007030200050803000500000008000201
10805020857080655523532650662020407024442060474076387020537030604047462220602727301
10503000806020200000600030004000307050000020508000700030504000203000800060208000701
10606538805040308823405048253078606080425280402860607550407255405230408022806040501
10400000007000400000605000007000306000500000500040002000507030006000607000502050001
10438645326787438620603755507067708238305025536080822027805040283087606870306047561
10000000000000000070600000504020003000306050006040500020002000400050008000208000001
10443640767754732030448520404060374870406560408080804650307545707070555023305333401
10600050000000300080000000202060000060300080400080500000700000704060002060002080001
10706032725020708546866475205068536030724080407760503855543642704884503050336040241
10007070004060700000006000005000004000808000203000200000006000600000207000800060001
10562020208060576542507070684848806562707076608022657758274060523430403067404020501
10004070306050400000400050200040700000004000804000006000000080000060002040007030401
10708050703020507050606324606050348546847080808733202070585055278032484230603034501
10806030803060002070806000305000300000008040800000400050006000002060000000307040001
10306028808027338060265030605364552275406030878830854285503844405020807355502030371
10507000006070000050000060003000000000005080506000600000303000604000406000706030001
10405342234065203222434884622080668772273020404045307320658030803770603070405065701
10602000002000506030000060003060000000005020606000008070008040400060205060008000201
10807027808660307050703040803040483065308030405036526048406520476060302020568670801
10800040005000700050206070200030006050003070203000500020008000406060802030400020501
15467370552030355560408060328650706330747070803070308540436080608050205047403060701
10002000800040400000706000200080800030300050002020500000800070700050603000608000201
10452022202686207074703448355026676050604650654580847642804080373832204040708254301
10000070005000005000700000005040000080300020600050300020006030000030003060400000501
10234370558053275650534238404060346880505066808040405060257030273340658060484280201
10000040000040004060007000603030002040707000705000407070204030800000500080005060501
10345048874080402050302030704030302050255060746353204050602067502576787078305040401
10702000008060300020200080800050200080003030500060006000807000300040003000700030201
10505064503060858680302570754524208272507880804040368264502460607080802020787730601
10708060002050003000600040000000800000300040004000800000700000403070704020000080301
10203050242327608033738227476360424654242050878654303020238757443034803034466830401
10503080000080006020002000800000300000700040000000502080000000008000503000800070701
10602087727040238030607080703823603330804053486856804088654360407630405028303050601
10004000007000706040600040006000703000704020000000008020000060700030408020006000501
10375238207664503060878256736040535035204670605522825024343020556530406060365385301
10000000600000007060000000500020002000700000700000405080000070006000807030000000701
10637420338584874050632840303053703680632370565580408070805453457072407033253470701
10000030006000000030000080502000400000600030003000706000600000200080003070004000201
10636030405078826675403020707050774665748080482085206030645720307840676040602044201
10003080202020005000508030504040000000007020200020004050003000405000800060300080401
10502078704070208440756060803346556042307028606430202044707063808045307060756850701
10206000503000300060002060207000007050004000700000705000307000600080002060000000301
10308060203866622066307040502055507070227280403625886630823360452630626450758466401
10204030300000002000702070407020003040000060504080007000800020005000500060800000801
10406020642543308430305060308030687087357020607040206085702043405037207084505066801
10204030000080404020503020006040007080300080500040400020007000502000006000008050001
10208830248080307050505087385327404060505280205720482440806450404535883555388020241
10800070003030300080005000500000002000203000500070000000500020800000000000700020001
10232074286040358355625250308087445574805036733587803763657020803074227250324520501
10005030003020600000000080003000004000005000004000705000500060306000600020000020501
10204080207040805074258070333854605062843044808020884040703870403552606020882050401
10807020400080204000600070700000803020006060002060005070007000600000603060003080801
10803070486540706070704324302070467060803630883072504032465058724460827030805023201
10206050000000802040305000008050003000200000500060003000400020000040005050208060001
10706085757637705720604072374027203246433458405880833750406868733056302038204060681
10204000000000200040300040005000200000000070007000800000300000000030002000603040001
10806555733730357040332345503030353830782032533037605064783843745520847440463050201
10400000000080000050000000007040000040603000004070007000000000000070000000300030701
10724858386042665376427760256076525060506043308020607027258427747040483437607047501
10000040003030200000000050600030500060007000800040408000008000400060000000708020001
17244080306060405844827020405570405477547054287860806874278060604825455240602050241
10004060507020408000700050200000600000003030000000402000400040200050003000802030001
10764080708030505040605650208846526263706260643280263020402270887020708068306052401
10000030400030008050008000300000000000807000400040400050008000204020803070007040001
10255320307885756030448030485275435470508048205078307242334083708070807530457070541
10006000805000000070300070000000002000404030807050007000400020004060500000200060001
17786030437080404720806483438262703030303030606070368020803050838050202066306078501
10008020400030300040507000200070004080503000708000700040605040000060608080003000501
10706068602030222330206840407230638030306328804873702030507032437680207770867670301
10200050006060400000500060800000600070500060008000004060204000800080207000700000601
10554550727850703367642080608284804534384780503066535750308235608080262048847423201
10000000500080304000007030300000600000003000505060000000200000806000600050000000001
12552433308026703036567080562877767536302075456040266576552620207343203040863345351
10000000008000004000000030000000000000007000000040000000000020006000006080000000001
11111111111111111111111111111111111111111111111111111111111111111111111111111111111
