11111111111111111111111111111111111111111111111111111111111111111111111111111111111
10005000000050000080000000000080007000000000300000000000000060000000000000006000001
18403020554060483020334672507030208076826560504870803587202420206762858448805020501
10000030800080003000500000204030600080000040007000700000300070804000300000203080301
10738350604844404052843680507070888580504066378063753660338070303050606720405040301
10003000600000005060000020708000500000402000200040000030300040700040406000200080401
10805026736824226280307020607683205538608440706540256080606280204640302425222470301
10805050000080000000202000700040006000500060700080006080800060602000300000007000701
10508040725020454485742480834060306048426070865043274040526050505077565870608822201
10708000406070400000800040005000504020000030406000300070605000305000700060203000501
10208223706030406283602037325027706040466830402450607550502733605430704045302070801
10500000004000200000602000002000206000700000400060002000303060004000703000808070001
10554438356243434480806768506025202354408065745020776057505050444086407830706035341
10000000000000000020600000608050004000502080006020700020007000600040007000607000001
10722640327658754070373580402050872650506330502030607880408245804030638025508627401
10600060000000700080000000205060000020400020200040400000600000407060005070006070001
10603045836020604363738336202076384020687080402230406885754776705374605050552080461
10005080004040300000005000005000002000502000807000300000008000200000602000600070001
10822050604050747758808080873356307577202075606086827553547040787820804056303060501
10008040507030300000500060500020700000008000302000006000000060000040003040007030501
10205050406030704060508236602030665868556040607385508080872076634044544840408035701
10406030408020002050807000705000400000008080200000300040003000008070000000307070001
10203085403084873020265070407256456682302020437620885665306587308050703423503030461
10708000003020000060000070008000000000004030508000700000603000807000503000405030001
10407244258036708442878868682040562262486030302065203360445070708440807070806066601
10304000005000402080000080008070000000008040708000002030002020600070303020002000401
10703085408870408050206080504020866065202060308088242085308820277030308030872830301
10200080003000500020605080400060003020004020203000700030007000303060605080600050301
17326440533070552740207070723580303840367020307030305650537060206050506062402050301
10006000600030800000402000200030600020200020004070600000200050300030204000405000601
10246085707725402037706354473022628060403320763650824675403080236248806060302458401
10000060002000008000300000008050000070200080200060400050002070000040003030400000401
10888240288083742340238452408080255480608083304050503040282050665380626060535870801
10000040000030002080005000805070007030405000404000803020302080200000500020002020601
10885063374060808040602030504080802040684040558225804050507082705348788037502020201
10308000005030400070600030200050300050004050500070008000702000500040004000400050501
10707038404030558520607640484645807385707340202060754353705720808070304040423550401
10606050004030006000600030000000700000200070003000600000800000706040207050000020401
10704080652648803085854558447440445874252060583434405040886225326036303048244350301
10506060000020004030003000700000200000300030000000205070000000006000303000500040201
10407065434030627060205030305332404570705084544422804066577550402580808036703070401
10002000008000406030400050006000706000803060000000003070000080200070508030005000201
10884253606273505040366375337060874084407840804466286046823050468830206070787223201
10000000400000008020000000500020003000600000500000208030000060002000206070000000501
10753220345723733040437540706042407250828760464380505080703324355048403082565650801
10000020005000000020000050207000600000700050008000603000400000800080005080002000301
10726060508064582788504080704030878335824050475026808060378840505620337020408063201
10005030305080002000706070807080000000005050200050002060005000802000600040700080601
10405066707060308450352080805566243085202072804370407063206082705068308030573630201
10808000705000400070007070705000006080007000200000504000802000800030005030000000701
10802030602538268045404070505036303080354460504683786280542280755470227550768234801
10305070500000008000405040607020002040000020607080006000600050006000300030700000201
10706020862888504380305060702050658022368020407020706063608035303088407083708063701
10202060000030304050406070006040003060500020600030800080007000707000007000004050001
10602750276070608070805063423566804070802620408320557530804440702323433543225060721
10800030004040600030002000700000003000504000400030000000500020500000000000300060001
10538048527050463478232870307072786724505085666547308723538070203045638740735320801
10007020002030800000000060003000008000004000003000203000300050406000400050000040301
10503020608020708076337020653646804028834086507060723050203440804522602030377060601
10302020800050406000500040500000807030008080002080008020006000700000307050008040301
10807050637480305060205255303050425040604570636066205028364077538530268020506075201
10604040000000704080402000005020006000500000500080008000300050000020005060808080001
10802024455222207870404073884066207424468375308730248350806864768023607075506020721
10605000000000400080800020004000400000000020004000500000600000000080006000703060001
10406378473470245060322268606070252230428026645085505087325543532540724520365070701
10500000000080000080000000006020000070403000004040007000000000000050000000600060201
10455747588083447725876330764042322050202086707030806026837783482020273834205054601
10000060002040400000000070600050800050004000700020803000003000500050000000808040001
17462050302020505327447040502720206854436087485830307653253080202736588330806040281
10003080203060506000400070500000400000004060000000303000700020400030008000404020001
10684070606030807050308440703487435583704780454250258020703420652070506066503073301
10000020400080005050003000300000000000707000800020800020002000504080506060004020001
10338430208367244050337070332665427580708047405028604748722032605080204430573020651
10003000606000000050500060000000003000407070807020006000600020006070800000800020001
18527060785030707470806636446873505070306020805040223080504080328050608087508057701
10008070500020400030804000600030007020602000304000600080703040000060705030003000301
10506033507050643380608250504570787080706778205433505020803066638350308670234260301
10200050002040800000400020800000500020500030004000006060208000800040202000800000301
10828820585550502523682020508574405247285350708076588870307622605040366083653475701
10000000300030606000002070700000800000002000303030000000800000503000700050000000001
17823234503044602053636030742687685675808077822060384844332660706428203050566785331
10000000004000003000000060000000000000003000000070000000000080002000002080000000001
11111111111111111111111111111111111111111111111111111111111111111111111111111111111
