11111111111111111111111111111111111111111111111111111111111111111111111111111111111
10004000000060000080000000000050004000000000300000000000000040000000000000003000001
17506080283080485030445275403060302022245250405350305636306350606738284767807050301
10000030200050003000700000503050400020000030006000500000700020808000500000505050301
10373560808352207078582580803020287230807077584067285680837060807050208440204040701
10007000300000008020000080702000200000304000200060000040400040400070308000700020301
10206042334743532460208060406432804336305540308470734050806560608730804244837540301
10508030000070000000307000600070003000700050400070003020800030803000300000002000601
10403050528050327634586280854070804076457020355072538080722070506063532230805237601
10808000304050700000200030003000506050000070206000400080302000608000800030606000201
10806545505060703348605047486062606070862350203560302260202622702830306072305070601
10300000005000300000403000002000702000600000300030008000606070006000203000804040001
10342773373558777440804662303062602736503044852060646054508070835084202520604046771
10000000000000000080600000502050002000408030008040300070007000200020005000802000001
10388370853634443020268570608030375780702750706070208260508372704060586066204627601
10800050000000200030000000306070000020200040700060800000200000408050005060006060001
10503073456020408663564563206037685060374080608680504474784626405372302040688030571
10008070003020300000008000007000003000305000502000800000007000600000302000500070001
10333080402080884583408050276684406558504083205047762254237030567720605038807040801
10003030705040400000600030200050800000008000207000008000000030000070006020008060501
10308060302060604050506534608020732286576080206468203020774044337054843520702026701
10807080704080006020408000205000300000008050600000800040008000004020000000505070001
10503052803028623050822030404773853428205060684380822675802332204060504558408030371
10506000008050000050000060005000000000007060807000800000308000406000804000208070001
10506537668032605242682222788060427462664020305084205350527060808460504050803052701
10303000004000605050000030008070000000005040203000003030005070500070206050008000601
10407057706870707060606070603070832042606020805073642075703560883030305020877560801
10200020005000700040607050800040007030007040703000200060007000803060204080700040801
16472370225050522220704080382670407440357080306060505270478050206060502037203060801
10003000500030500000803000800070500020800030008030200000800080700030206000508000201
10446067308742204035604422258043566080605260573630273588705030263263302050408838401
10000050008000008000700000003040000030800020700040500070008080000040007020400000501
10557650555043472520847232307080655650807042203030807030683030354550846040282460401
10000060000080007070006000808070002040207000407000406060204040600000600080006050701
10764034436040206030802030608020607040253070678563506080602033403543328033204040701
10806000002040400020500080800040300020006080500030004000803000600050005000400080201
10707047504070537580705650858385508275305680805040866258305870305020402030288630701
10406080008040005000400020000000400000800080008000700000500000406020803060000070501
10308070364466605088278246435420633376325020843642502030672372287085502076743650801
10407020000070007050002000700000400000300030000000605050000000002000706000400080701
10307058576070652070603070705886207540804074534728605066446270702680605033208030201
10004000008000805020500050002000704000308050000000003050000040700060706070006000801
10782267708574607050332537487030466037705270207265564085647070742450207020633853201
10000000300000003050000000500020004000700000500000507020000060006000405050000000501
10637340227888827030326520705068804520336780468620405050602888534037404062655630301
10000060003000000080000070706000500000200080005000808000200000700030006070007000801
10225040804037254778807050804030578686344070257063504060566470604450272070804042201
10006020606070005000806060308050000000002060700080003080008000702000200040700060701
10203085607020402650227050603442732044408075307260504085804074203058302020852540601
10304000705000800040007070206000006030002000300000603000204000600050004070000000601
10606050705746555063608040303043207020363630706667328280542380572750277440547253601
10606050700000007000603060408060002030000040305060007000500020002000300080500000601
10604050273778605850307070704060734082454020606060307023204075605024302042704053501
10202030000030204060708050006040006070600040500030500070007000403000004000005080001
10207530484070208020802052663363804030406240703440863370702570608372538388666080671
10700070005040200040003000700000006000507000500020000000700070700000000000400040001
10436032383060364223462570505087544648307085277836806838587070804028727220427250501
10003070004040400000000040004000004000002000007000707000800050602000400040000040301
10708060302040208045826030868485304077255073303070547080508370703322606040647020401
10308030200070203000300030200000408020008050006060006060006000700000503070005040701
10408040226230504060202263704070634050704480285064403083758033434840624060206032501
10202080000000603030706000006050006000600000200020008000800080000020004030304040001
10407068754637707360808028547055205847452825806770327760403345742083306084402080351
10706000000000400030800080005000800000000070008000200000500000000070006000803020001
10307465383380436060625768207040525430733028888054703047823262336330644470653030601
10300000000050000060000000008050000060402000004080006000000000000050000000200050301
10785254484078427366488880383084263040804034803050508027647562226050535262507033201
10000060005030300000000080800020200070006000800070507000002000200080000000205050001
14646060505040206626436060603260403262232056432860803275256070305284883850703070861
10006050502060403000800060600000600000006030000000805000300060700020007000506050001
10323060307050606050802360706273572576606850686620423020208530662070408035702043601
10000080700060002020008000200000000000803000800060800040003000307020705030005080001
10824360608545837040354070424537238470806053304062508463576034607080608720753050551
10004000605000000060400080000000004000308020408020004000800020006060800000400030001
15632060737080207370707382765882704070205020503080455060206060343030404086608083701
10006070300020500020202000500050004080602000208000400080203050000070303020007000201
10507062804080643770606340408570557040307232802383303080203022575460304230428240201
10700020003040300000600030600000800050400020005000003030604000300040606000400000401
10843860536670805624847030808758407765428230206076884830807667302060277084438852601
10000000200020702000003080600000400000004000503070000000500000204000800080000000001
16736237604032305067265050645455875326302036232040852537755630506547302080228254661
10000000007000007000000050000000000000003000000070000000000050006000008060000000001
11111111111111111111111111111111111111111111111111111111111111111111111111111111111
