11111111111111111111111111111111111111111111111111111111111111111111111111111111111
10004000000040000030000000000080002000000000600000000000000050000000000000007000001
13406030643020887020756875804060807062774370606740708547303280504335556368405070501
10000070700020005000400000207050200020000030004000800000500040208000700000807070401
10627520704826508052727270306080242550403082864066677840484020504060707460606070201
10003000300000004050000070507000500000202000600020000020300060400060303000500040201
10206058756638625780307070303348402654205380803520536070503760708350507558363430701
10804080000040000000406000400040005000200060200070004020500040303000300000004000201
10204080456040848847384360642080805022537080282083836040254030803033874420207358801
10308000308030200000200030002000806060000070808000600080404000204000800030303000601
10802562608070402783207035237082806050755440804740303330605268406520606023206020301
10400000004000600000608000005000603000800000500020006000606020006000807000605080001
10637384273443523550502862603035702822508086348020486056802040423043205630805047751
10000000000000000080400000708050007000604050002040500080002000200080008000802000001
10224220283834453020374680205030672640502330207020407380602683602070635062202672601
10600030000000600050000000403060000020200040200020700000800000307020003020007030001
10305038857080402273438823507035868040773080307450506347286673506666507060562040571
10008060002060700000002000008000007000702000308000500000008000500000208000500040001
10485060502040468665403030354673506284508076707084345822357080523270204074602070801
10004080803070500000500080800080500000003000505000004000000020000070008020005070401
10207030207070505020205434504020653282467030405282603060268033724027687550808088801
10804070507070004040604000505000700000004070600000500060004000008050000000502040001
10208038304056723030348070305632458527407020735240443676708884602040505866308070881
10307000003050000080000050005000000000005040803000200000205000808000308000203040001
10204444675058706326224285673030685426335040607064503380827060707650503020308058401
10504000005000706030000020005060000000004040705000006040003050200020407050008000601
10502048607520302080804070808020446054708020705038254057608860478020403030477740601
10600080002000200070207080600030008030004050207000600020002000708040507060400020601
14844650533030475850303050386350206560765050206050803560458020807030708065606030801
10004000400060800000603000400040700060400080003070700000200030800020407000608000401
10228075203267803052507337475024875040407850245330286764704040776436804050808274201
10000030004000004000800000006040000030600040800030500020006060000070005060300000501
10348630864057575830485383704040547430407043504080705060674040435260685080526740501
10000060000030005060002000205050007060308000207000503060508060700000700060007040801
10847084463050703060702060607050707020833070367722507050504048807656648045208080201
10802000006060200050300020800060400070007050700050004000206000600030005000300070501
10502054602040246260207420443773405468306470306030353628505780602060508070473330701
10606040002020007000600080000000400000500030007000800000700000304070408060000060401
10703040566322608074224375284670288637857060722264804080235452258022306044887430201
10807080000070003070006000300000200000600080000000608020000000006000607000300040501
10403076337020457040505070403533208850406034343268304036436340803820504087805050201
10004000007000303080800060006000808000503060000000007060000040400050805020004000201
10447253602285703040422686863040353058402260302428374088325070487860303030673822801
10000000600000006020000000600050005000800000300000705050000060005000207040000000201
10446840846236832030375670603052203260536350333630208070402444644064604043777480501
10000050005000000060000060308000300000700020006000702000800000400070004050008000301
10238080305082728835605050406040853872622070778033405050336670408880855030504057801
10004040605020005000806080602050000000006070300050007040004000502000200030200020501
10704053204040504560333070303227848073603024503650204078205034502022205050433680201
10702000808000400040004020406000005070007000200000507000606000800050004030000000801
10804020506475644058205040602073304050434340404777778460726340437280682260277437501
10307080700000008000707030708080008050000040404030006000400080008000500070500000701
10304060838233306460407080303020888037526080403020404038203084405028805024403085601
10604050000030602020204080003030008030300080700050500030008000606000007000003080001
10703570674080402040806038345347602080207870303470568560506840806785274484843020231
10800020006020400070007000800000003000508000400020000000300040700000000000300040001
10246032555040466387773740206026224273203054668352507625824080204053878860262430301
10007020007060300000000080007000003000002000004000705000700080603000200030000070501
10705060603020408078634050623383608085344063202030387070308880203826605050646040801
10408040700050507000700050300000505070005040004070005060008000200000503070005060501
10506050378840705060202825204080886060603880556022306067637023756230238030807066801
10207020000000603030608000003070007000200000500060007000700020000040006020405030001
10804047585525402620404043755067604367885878707560863420602234365068708067406020671
10304000000000800080300080005000400000000040002000500000700000000040005000706080001
10205358743650532080442772308030535730423078558036702023736344858840645330887020801
10600000000080000030000000005080000020205000002040002000000000000020000000800040801
10677777334072545774422660588077483070408063607030204057737728562080765223403026701
10000050008020200000000070200080800040004000800080508000005000600080000000505030001
18224030502030606566423020305560306245574035326340702235638070704667766880806070241
10007080707070308000600070600000600000005060000000702000700020500050005000307080001
10584060202060602060705770404767563433503840332870278020506230338040608028603042801
10000020700020003030003000500000000000303000800060300030008000204020506080006050001
10267720306584457030632030353236628740504035804068507573684054602060207830447060541
10005000602000000020500060000000008000702040304040003000700030006070500000200070001
14245050425060302670405353456474602020508040302020278050302020778020305027808056201
10003080800020300060202000800060007080605000206000600050405040000070606060003000601
10408066506070763870302350506270577040604834605286703050807047357670802740236770401
10400060006030700000600070400000600040600070007000008080403000700040606000300000601
10658660722620206866688050504736405656373630808085623270504528405050673037867383401
10000000500060302000008050200000300000007000706040000000700000407000500060000000001
16844558406084706048277020457743638557807032342060664856844780504337506050657543761
10000000002000002000000060000000000000005000000030000000000020002000002070000000001
11111111111111111111111111111111111111111111111111111111111111111111111111111111111
