11111111111111111111111111111111111111111111111111111111111111111111111111111111111
10007000000040000080000000000040004000000000800000000000000030000000000000006000001
12803030233030757030246477302050305033724550706440402355604270408568747645805030701
10000040800030007000600000203030300020000020006000600000600030604000400000507020201
10866240502362303058852560708030744660408073464046646260534030606080608740204040501
10002000400000005070000050705000500000207000500070000020800080700020408000400070801
10203048372546866640403050504358607737805560507570652050404440406440308745383260501
10806060000050000000702000700050004000500020400030004040400040207000300000004000501
10603050585060845522363440682050805028377080384036757080233050506034532260202847301
10504000604080300000600050003000505080000080604000600070306000608000800070605000201
10303268603030603426303023786043503020525350403320508260408852504730704076707050401
10300000004000700000802000005000302000600000400030006000803070004000502000303060001
10566835645536226570803882505064306447708032752060625037308030537074303580607043361
10000000000000000050400000306020004000308050007040300020008000700040006000307000001
10588670756372457070656430804080653730705430605060205420704822206050885072706677601
10700070000000800020000000506060000060500060300040400000600000603080002050004080001
10803046572040302853875658208025776020252020808750503858752834307232505020877050641
10006050002020500000005000004000005000802000204000600000002000300000808000300070001
10762020807040785843503070223242204378605037208087772426463080365230802073307020801
10007030308040200000800080400060700000005000308000005000000050000030002030007040501
10506030604080506030605372703040642836464030708585708080653085747072548730703053201
10707020302030005060205000703000400000004030500000300050006000007060000000708050001
10608075804066357030885030207752585232706060276340276277303655504080608562305030331
10408000008070000070000070006000000000002030305000300000303000205000406000403030001
10202767766066405288777455433070623464625040603065802830872020702730705070205042401
10504000006000604020000040007050000000002060608000006050008060600060203030007000601
10507073705770806040302030706040687028206060608057433062602840588020502060576630801
10700020003000600050405060600020004030008020403000400040005000707070708070400040601
15557380866070583430206020532870403320368020406080704430474020505050404086605030301
10002000300050300000604000500070300050200070002080700000600020800030706000706000801
10535058605634807088802327343082246020504550363340878425205020333486503080503565701
10000020006000003000700000003050000060200070500080600070005030000030007040200000701
10544430438054483750867637307030866720208033708080805040474040486580582050226340401
10000030000080008020003000504070005040406000506000802030505030500000600060008050701
10446078536050404020802020504040802070688080883236703050803037405625684082307030601
10304000008030700060600070800020600020005060600070005000207000700040006000400070701
10205086606020363670403350755557803526507630308060646774806860402060602080464770401
10302030006020002000300020000000700000200080002000200000200000602030606030000020201
10207020637538602027332458885270426482766040356248203030653256875053804025847420301
10206020000060002040008000700000700000400080000000704070000000005000607000600040701
10807046863080764080608030704844807380406053676247504026787250404730702078703060701
10002000006000603080300040006000805000307060000000006070000040200050206040008000401
10484568605272202070286724238040586074405650204763465055563070586330808040666535201
10000000400000008020000000800060008000800000400000604080000050008000302050000000201
10388380645757253020786620304075203670665630378250604080204526764074702063286360201
10000070003000000020000020606000700000700030003000804000800000600080004030003000301
10882060706032582437807030705050385274424070576037807060886820402480526040608035301
10004080206080005000205060803040000000003050800040003060008000606000200030700030801
10305037603070705520524070203787238026306066406630804073203035604078507060856830201
10402000602000500070002030205000003030005000800000205000807000700020006030000000601
10302040608346435063403070807073503020732430507346434540526530427380863640336268601
10305040200000008000504040505050004060000080706040005000500080005000500070600000701
10406040624757602350602050506030485077222030407050704066306083806052305063702074401
10405050000020308060805070005060006040700060500040300060002000208000008000008030001
10702440876040406030706052258237707080704240205570335330804860404436883335363080331
10600060002040800040007000600000007000403000700080000000300050200000000000600020001
10332063265040452227772360507035262623805034752367205662873070808088284270623850801
10002020006020800000000040007000002000005000005000807000400030804000400030000040701
10305020205020803088545060546654305055335047406030627020605760703868405080387030501
10603080800060604000800080200000505060008060002020005080005000800000605070005020801
10603050775420208070207774402030264070307840735023304044443038324730688080303044201
10403030000000707040703000004070002000300000200040002000700020000060002070702060001
10705034755738304770607063223044505646575258603630235840404448275045706044304050281
10406000000000600040200020003000700000000040005000500000600000000020007000403060001
10802746624630642070858353408020547230844042532068705067458787382320482460853050301
10200000000070000040000000008020000070604000007060003000000000000080000000200030501
10577886358047383343635580557062777070807025807040203073635728244070573486205083701
10000040004030400000000080700080400060003000300020707000004000800080000000707020001
13622040604060702435338050307280806324552055847750805486688030506222667720708050361
10005040305040302000200060300000400000003080000000705000500050400040008000206080001
10266080407030203080806750503785536574704280488870433030602680484020803074308063801
10000020300080005080002000700000000000308000600020700030006000604040305060005060001
10246360707225354020733080783447682760402043404068805466533022203050303270836030831
10003000508000000050600060000000006000206040408060004000800050004040300000800040001
14836050328020706470607822534266604030702020808060337080506060735050307088208072601
10005020700080800020205000400050002040708000705000600050506020000020207060006000801
10708083203050438630306540504360443040403474403746703060707048334740707730564630501
10400080007080400000300070300000200080600030005000003080502000300040302000800000801
10573540353580803342488040506766703353275270203077374670508377603060843042338434601
10000000500040204000005050200000800000008000508030000000500000507000500070000000001
16222657402074804087633060576765543547704027738020822235463280302477308030753525871
10000000006000002000000020000000000000004000000030000000000020004000005030000000001
11111111111111111111111111111111111111111111111111111111111111111111111111111111111
