11111111111111111111111111111111111111111111111111111111111111111111111111111111111
10006000000030000030000000000080004000000000500000000000000080000000000000005000001
12207030858030528080284676802030803088844760206230306426408460803462243277703070301
10000030300030004000300000707070700030000070007000700000700030202000200000508030501
10533270803435606036465270307050275860403047737032774850263050202060507350308020401
10003000200000003050000070802000800000302000400080000030800070300060205000400070801
10508065466637732770404070607576704668307440507850288030503250606640208786467460301
10606020000020000000606000700040006000300050300030008020600070305000600000007000301
10204020486030468288547620435030807023875020822027368030533040405056637620805748301
10503000407030800000700060008000804020000020806000700060806000507000200030205000401
10807885304080604224604027842073802020434720407520707460702725606780307088304060201
10200000005000500000206000006000206000800000700050006000403020006000203000705040001
10464578843476885760604784507035708467802082627020646083707070667052206260608048241
10000000000000000070300000302020006000207070003020200070003000500030008000208000001
10773280853352687070343550303080624620406830707080707260202348502020345046803874501
10700060000000500050000000505070000030300070800040800000700000207050002050003070001
10603024732060207654236852807042648040828070207760808582726667703882304050426080321
10003020005040700000006000003000002000606000407000400000006000200000804000200050001
10734070606020452577403040273764608232306023605077386675563050434370704077203050801
10008050503060400000800060500060200000003000602000002000000040000060004080003070801
10607060206060208050606562303020272865228040204834502020565088437044242430608026701
10304040504040004050304000407000600000005070500000500080004000006070000000606060001
10404052805025426080552040602247465546402030675530546838806364308030602535607030651
10603000003050000020000040004000000000008040203000700000307000307000505000706060001
10708823675085604625778576767020582767436060705084504440453060705670206040502023201
10207000004000506080000050003080000000008030308000008080004080600020506040006000401
10605073606580808070403020307040726024705040302023277047703240355070303050486270801
10300030005000300080806040200080008020007080608000400030003000304050407030300030301
12787250272050246560603070428340408650676040308080705680635070304050606026205070401
10002000400060200000703000300050700080400080003050600000500080300030606000703000801
10777078306643808047603566446067866050704640328830487673504020447426207050507746301
10000020003000002000300000002030000080300040200040500080003020000080007050800000501
10776520353057638270837257803030677550308086602040806050885060544580235060234320501
10000020000030008060007000803080006050707000803000506050304080300000200030006030501
10636055555040403040702050302080403040347050425256505030302043305662323024207080601
10207000002040500020600030200040600060005060400060005000306000200080003000600020501
10202088702020523220606860248537706523806330303060846274802740506080606070866850501
10404030008060007000600050000000300000500070006000400000600000405060307050000070601
10202030462685708067266665356520537266788070264845405040652358447025303057227740301
10302030000020003030008000600000500000500040000000308040000000005000805000400070201
10702044338030272080208050205633507830708048827326507087852740303350204036706050601
10006000002000604020300080007000603000407080000000005070000080200050204080006000201
10235422708335603080782757756060224062808520805687863064477040878280607020345648401
10000000500000005070000000300070002000800000200000805030000040003000204030000000801
10274220528633745040582420408023508230527380462560603080403866352032403087588380801
10000020007000000050000040806000200000400070008000507000700000300080006050007000201
10286020408063772424508040802050332444527070658077807060283430305550547020208057601
10003050507050007000707040703020000000003050700020007040007000205000700030700020601
10408067306040507640855060405656858022204077807270206067404024508074403040647570201
10702000508000200030002060805000008020004000300000707000506000700050004030000000201
10803060505267588032602070807023608080853630704347266530228830547460545640483845801
10403070500000007000707040702050002080000080807070004000700050002000500030600000601
10407070322575306720505070602020477087566040204040307077607087804086504052207025401
10803070000070705080202020005060003030800050700070200030007000204000002000007060001
10407630447070204040808062582332707060502630506280265440502470602233857684646060341
10300030004020600030006000700000002000202000800030000000500020700000000000300060001
10288055438020678784328820608058287356307054632828702536883040802045677360336750701
10003070005060700000000020003000007000008000005000308000400080607000300060000060601
10703040607030602085257030724378804023846075806050253080402460405345405080435070301
10607080600050706000800050800000706080003040003050007020004000300000602050003060701
10605030327870608020407376504070752050406220347077708086673042453370354060305025301
10708050000000502070207000002040005000300000800050008000600030000060006050304030001
10202026652667803440707042427043505874837648508360458540502555782086306072603070221
10405000000000300020800020007000300000000080004000400000600000000080003000704030001
10307333373870556030687686307030536320836044732068608058882437636630743880478050501
10500000000040000020000000005020000040202000007050004000000000000070000000600040201
10883445584026726284555430646088863020504028405040304065232323673030637866303076601
10000080003080600000000050500050800020005000200060703000006000400020000000207030001
18287080603060307773323030505530503328362047254680304542367070503825447260604050231
10007030602030203000400070700000600000002060000000805000800020500040004000703060001
10385080305050604060308680308435824787306430338860258020302540386050808058702035501
10000020300080003060005000400000000000405000300030400020004000604070806030005070001
10625640707554244020535070573556346380705054502067207868552064203080206520232020651
10005000402000000080400020000000006000403070302080005000300020003070500000300080001
15438020276030302530605346536738303060708040308030677060202030242040405024704035301
10007070600020500070806000500080005020303000204000700080704060000050703050003000801
10502078207020732480505570405840852020605376508235804070302065444440508780787830701
10600030003070400000300030500000700020800030005000005070203000300030708000300000301
10562480757330602457488070708725604885473580205065343760605787506030672066562386601
10000000200050306000003030300000500000007000704050000000500000804000200020000000001
12547888507068802063735060278533856776608043556080547252373460604255503020422288761
10000000005000002000000050000000000000004000000070000000000020004000005050000000001
11111111111111111111111111111111111111111111111111111111111111111111111111111111111
