11111111111111111111111111111111111111111111111111111111111111111111111111111111111
10007000000070000040000000000060005000000000400000000000000070000000000000002000001
18208070684030477030343588302070503036467260708730603682804760405623857848302050201
10000020200080003000500000805040400040000060007000700000500060807000700000604080401
10383640404325705034266720406020668230408082845034236860733030806050207760808020201
10005000200000007070000060602000700000204000700040000020400040600080306000600030801
10602044784456348450803030808643304482506480606240656030304820203830308632335670701
10306070000020000000204000200060008000700020300030007080300030605000700000005000201
10404040545040255572473760752050607052832030262077728050576060403048233480507286601
10705000807020400000600060002000605060000050206000600050408000403000200030204000701
10306838505070405228602024365024707040736830305880304870708223208460807072608060301
10500000007000700000803000007000205000200000200020007000208040007000804000704080001
10773838283726637740503857604045304354208036855020746052602080834026807720408067241
10000000000000000050200000307070007000703080007080500040004000600070005000502000001
10726570524354742050648520306030658580503730306020805650706636607020576025703558201
10200080000000300020000000502040000030500070800030400000700000706060002080004080001
10508045333030403886275467307056832070485080505760707752785252204733405030666060861
10006070003060800000004000005000004000506000202000300000004000300000705000500040001
10888060404030574544208050243725808452505088505057223462775020284550404047602080701
10003070502050200000600070600060500000004000206000008000000040000040008080007040301
10602020406030504050705338506020345852284030505265307070664075248035322520507077801
10607060607060004020306000705000500000008020500000300050004000004080000000608050001
10505085805074242060455030407727866552606050736520327848705383708060804477605050561
10206000004070000060000050008000000000004080604000400000404000705000704000605060001
10304585228084203622347868854080583368588080305022807740668080705820406050503044801
10208000002000703080000050004070000000008080605000006040007070400030203050006000801
10502037804570505050803080602030267063306060303077724056606570224060204070376430601
10700070008000600050704050500050008020004020305000200070007000206040706080700050201
17256850752070354830705080273320503480732070408030505630274040506080404052603020701
10002000700050800000508000800030700080200080008050700000300050500030504000708000401
10665085402448505067404728272056677060602280453230585642407030848834504080208738701
10000050007000006000800000004030000040300060700080500030007040000080002020800000501
10683640784026847220584232205020852420405068206020804060232040634880558060357660301
10000080000020002070006000407050008020208000502000708080502060500000300030002040701
10377066778060803080706070706040207080776040684654506080506062608775487027805030201
10807000004040500050700020500020700020006030700030005000602000400030006000800060801
10803028802040577520203620643628705755506570805070628866304860606020204080276720201
10508060007050006000200080000000800000800070006000800000700000202050203050000060601
10703040887832205045476272478350763588823070723268602070787838534058504084258640801
10802020000040008060003000500000500000700030000000502020000000008000807000700060501
10605088872020272080306080302324408270507037483573808085866220406320704088807080801
10003000008000602020700070002000205000207040000000007050000060700030508070008000401
10238548603425308080857526283050528073807640604576346035332070338740306050277572301
10000000500000003040000000200050006000800000400000606020000030004000308060000000801
10386860866678787040246450308054305830758550852720207070205275454077608026344540401
10000080004000000050000050405000200000200070006000407000800000800060002030004000601
10635020605057225238205070206060472478867020232064404050274520204420455060404045401
10007050603050002000507030807020000000006040500020005030005000508000400060200030801
10206058808020503470647040604738242063404034406270708046803064204072702060845250601
10507000508000200040003040806000007080008000700000304000707000200040003070000000501
10503040203587673072206040402078708050634830303727373660826840324540776540282344601
10702030700000008000708020608020006050000030702030005000300070004000300080300000301
10804060636438707260307050306050232044662080805030403084502055203042507085407028301
10405070000080604040408050006060008020800060800070700030006000202000002000007060001
10306630532050508020305065823524508080407450202540473280606220404675588547776050671
10600070005080300020004000300000005000306000800080000000800080500000000000300050001
10345022744060246478278750608074623223702055777764204734623060307036375320456540501
10006020005080800000000050004000006000007000003000406000400060704000800050000070801
10602080205060404025686080888485608057874023305040273080805520807433708050756040801
10302080600060803000500020400000404060008030002020002080006000500000503020002040301
10702040858280605080204263307040267040507650287078603068655084785380738020803086401
10403070000000703020804000004040004000600000800080007000500080000030006050505050001
10602082767428403650405024358025207565722382708320226480307576747024404036302050361
10207000000000600050600050003000500000000040008000800000800000000070005000802040001
10804628428630835080345364305080466370356034376032403025628448455880846370456030801
10700000000040000070000000004030000080404000004030003000000000000030000000800040601
10257468628083624488728230775066888030608028404060707024736746326070626372706082701
10000050003080400000000040400080800070005000600070607000003000200030000000802080001
16253030504070804765735050402220704758587083873360202783225040204453786820804050351
10004040507030805000400040700000500000008030000000505000400050300030008000706030001
10237050707050306070802380302875675225805340483760237030605630245070806047507084501
10000050200020004040003000300000000000808000300050600070008000602060807080006080001
10428240405434452060524030447757248350408054204088708736862053508060507430737040271
10005000704000000030600040000000006000303020704060004000300040006020800000600040001
13365050356080405520305555837632706070705050203040447040403060436040405023708023501
10007060700060500070207000400080006080208000206000600040508060000040608050002000801
10206024405060537280608520805270265060506446804675403030406067383220305480663360701
10800030006020400000400070600000800050800020003000003080702000500080308000600000301
10723530723580402557353070507822502554486860203073233220508888508050626026886655301
10000000700040304000003040700000600000005000702070000000600000205000500060000000001
12878728204078402065858020272433584625603027575080384687422830506686306070788655721
10000000003000007000000060000000000000007000000020000000000030003000006080000000001
11111111111111111111111111111111111111111111111111111111111111111111111111111111111
