11111111111111111111111111111111111111111111111111111111111111111111111111111111111
10003000000050000030000000000070008000000000600000000000000070000000000000002000001
16808020422050465040674886307060406064838620507570208733304870202854257854302080701
10000070800050007000600000204060400060000060008000700000700050405000200000306050401
10733780404467307066342580603070568250205056787037863720274030204050803660406070301
10004000400000003080000070804000500000303000700060000050600040500020202000200050301
10608024388432754530508040605478305232707320708620756060506540604820205277558540301
10404040000020000000607000200030008000500070700030004050300080303000400000005000501
10504050444030548323787560374040604034673030226067424080365020803045842530606763601
10804000504030200000400080002000804040000040706000500030708000203000200070706000201
10407733303030706825305022353043306050438720408440704270504275406480503074602050601
10200000004000800000605000007000605000300000400080007000707070005000406000808070001
10587785565566623780403847304066805883505055876070483038404080638034206680407047241
10000000000000000080700000603060002000806050008030200080006000200020007000306000001
10643820583847657070344830203060562740202520706030202430306852804020768033507725401
10500040000000200070000000502030000060500020200020700000800000408070004080003030001
10302062367080804583262388702028258080372070807680605734425544502554808080624040671
10006040008050700000002000006000004000603000302000800000005000500000202000400060001
10786040608080773548407070823748605744806045304087267455825040385640504033302030501
10007030704040700000200050200070400000007000704000006000000040000040008060003030401
10804040806060307050706875205030646664573030607274304080623073654067758460803057601
10703040508070005080808000806000600000003050700000700030006000004020000000405070001
10303037404076878040577050803843256522504060436830642578206235407060205386602040751
10503000008020000070000050003000000000008070702000500000603000404000608000605070001
10206227827038603656434764424050436863557070804067302220345070504340704050702046601
10705000003000208020000070006060000000005060405000002060003040800030508020007000701
10807065603230308060408060206070738083508040505063374037805780662040503030864750401
10800040005000600020404050800070007080003070404000700020003000302040806030600040701
13673580425080754430808050455480204730562030407080508670745060305040803082703080801
10004000300020700000805000300080200080200050008080600000300060500070605000803000701
10386054805773603023604326344066447070604630468760275368806080253332508040602385801
10000040003000007000300000005020000040700060200030500060002080000080008080400000301
10658740455088484860622834702070473520408024304020806030765030553660684080446740801
10000040000050005040005000408040005020504000606000403060203050600000300050007060501
10577035657030708030607050307030602060625030835252402050804087508434362036507040201
10805000003040500030200080700080700030006030300040006000408000700060004000400070201
10707055607030385570804860372747206425305770703060684633506670503020404030278330201
10507060004080004000700060000000600000700080008000300000700000402040204050000040701
10308020443542205042334336673820763835384050473226307050458247374033403076522360801
10607020000030003050002000400000500000600060000000705060000000002000807000300070801
10702022734080574080508060405873308480608024356483304077832270808780604027707050701
10006000002000407030600070004000205000504030000000006070000050200060208040004000501
10722853303856803020647674825070578038504550404734832027722040655830206080662777801
10000000400000008080000000700040005000200000400000706020000050008000703040000000601
10784360325826544050227420602023307470473540246840204060807683736087703057574560201
10000050005000000030000070307000500000700070003000203000400000400070002080006000601
10767080407032537266207050206020342822852070532084804050457220708830826070402034301
10006040708060007000702070603060000000008070400080003020003000704000400040700060701
10208072408050207270824030605556388082408063602850505035406053707053307080746650601
10508000207000400070008050703000004050002000200000205000202000400040008020000000701
10804060805376864027208080207035204050476260203387387640772470325440822540853774401
10403050600000006000407040208060004050000050406040008000700080008000500030800000701
10504070323575308220408020607020338063783050607030607033508046207082608053804024301
10403040000060507050202070006060007070500030600020700040002000802000006000002060001
10604450682030504070503046385886204050506280308340775430205230402852563823627040551
10500040003070400080006000200000003000507000400080000000400020500000000000500040001
10466036723050574336482530504054235878807063382332504622842060306065284230563580301
10006020008080800000000070004000003000005000002000302000500080706000300020000050801
10708050204040406026382040334664405068373083307040888060605280408748406060484020301
10604050800050708000800070300000305070007060006020006040008000600000802080005070801
10805070522330504040802772208080386070802440758037707054725066555730562040708053601
10507070000000505080206000006060006000300000600050007000700060000070002040703060001
10204066833577207530704073428088304432625877803730874850205635848074205066503030631
10302000000000600070500070006000300000000070005000800000200000000030004000204040001
10607424828580834040657657307040724270758053723026202088226844864760542320825050801
10700000000060000020000000003020000050702000003020008000000000000070000000400080401
10284732743045653788227470563072255070708042507040805077787364532040663428303042201
10000040008050800000000060700070700060002000700050204000003000300040000000204060001
13538050306070408227552040704320306687453035543620703247848050204556753220606030271
10005070504020406000600070700000600000005060000000207000800030700020005000804030001
10658080608030505020202230503646275533806570735270854040504820542060704058202037401
10000020500050003050005000600000000000406000600020700020007000506080505030004070001
10233540403563863040556060337646777880406024206088806372654087703060807850346070521
10005000304000000030800040000000008000707020404040008000400070007060200000700020001
14647050244070805720805627475788207050608050304080662060304080236050406056802074401
10008020700030700070803000800040008030206000607000200080705070000040703080004000201
10708056208080558840706520605480337030508242306444503060407085826720607640273670601
10300030002070200000500040300000600070400080003000006040506000300060508000700000801
10722730484530202338764070704437807587857280405067872540706726304030555036822877601
10000000800040403000005080700000300000007000806080000000500000607000500020000000001
18872347507043408078246070486435326285603072432020627525323530604462402050468454231
10000000006000006000000040000000000000006000000040000000000070004000002060000000001
11111111111111111111111111111111111111111111111111111111111111111111111111111111111
