11111111111111111111111111111111111111111111111111111111111111111111111111111111111
10004000000060000070000000000040002000000000600000000000000060000000000000002000001
17808040643080824030748425203030808055822320605740806864208870307727385445404030501
10000040400080002000700000608020400020000060004000600000200050502000300000503080701
10473380307743708072844840707040374320307044347082363840364050304060608730805080301
10003000400000005050000070808000300000202000300020000020400020800060706000500080201
10202082682277543840305040608562505326608330603720872070406420806440503246286220401
10305020000080000000505000800070007000400040600060002030300030208000300000006000601
10702040356060278682632840626020704078245020263085372030252030407068362680705424301
10306000303060200000700080003000702050000080306000400070302000808000500050208000601
10805653806020305653605066268077207080483670302520707580707843707720305044506040201
10600000008000800000808000004000502000400000400020003000608040004000605000505040001
10225866735375386230208465504053302432702063265070654047808020268074308440405086381
10000000000000000030600000504040007000404070003030400060002000600030003000606000001
10864340735554845070672440703040867830506740503040303860402862707030735024803473501
10800030000000600050000000802020000040300070500040500000300000502070003050003050001
10202076224030302368478823806083767020433030206880408422566634706273704030664030781
10004020002080800000007000002000003000305000807000500000004000500000408000500060001
10354020304050724644308080652765605827205043205036343287566080546720207048602020201
10002080804080800000600040200050600000003000607000003000000050000030007050006080201
10204050802040305070604462806050647764436060408448506080248037363043223240403035201
10603030604030003060402000707000800000003030800000400040008000002080000000703080001
10802026806058352020776060706626847387607070722860436442407455502050608556206080661
10603000008050000070000060008000000000002020208000400000204000706000506000303030001
10803428354048306274372532628080222628348050605063502280485030705420403050305045201
10808000004000406030000020003020000000006060307000008050004030600060503040008000501
10208042505350807030505070204050723034504040707068378066204420333030702040235450401
10200030005000400070504050700020006060007080706000200060007000808060506050300070201
18724270428060434680504020858480806550627060508040204570323060602030205086803060501
10005000700030300000308000200080300050600020006070300000400020400070408000608000501
10587073608284806057504754375057872070408330836420443283604030433433503080705434701
10000080008000005000400000006030000050300030700060600070006040000030003070300000201
10874560722085477460387624603040424820508033208060508040744030876670262030282670701
10000060000040005080007000304020003030606000507000808040207070800000500060005060701
10656075853070605040206020203050304030827020665882503050802087205725424034403080801
10303000005040300060800060700060500070002030300060005000202000700070008000200060501
10503035704060547520403670577268408248806440808080854236708620803060706060348840401
10705080005020003000600030000000500000600070008000600000800000502030808080000070801
10805060346768402066365262875660757556262030726725504080872275373035806044854720201
10505070000080003030002000400000600000500070000000305050000000007000608000800050601
10203036586050773070405080202884802630205052266488505088763720505260602058605080301
10004000003000802080300080007000605000403040000000003040000030800030408040004000401
10273822402274408030778363452040875027307570506656752064583030632680208060445628801
10000000500000005060000000500070003000600000800000508050000070005000708040000000701
10446540443556744070375720408046205880232550355680605080605752782083208056866570601
10000070004000000080000080604000500000200030008000607000500000300040003080007000601
10432080602045486268608080804030738522675070875072805070637440604460365030408083701
10007070607040008000203040403030000000003030800060007050008000204000600040200060201
10405047505060308280723080608563782053305048704850205043402022708085708040538860401
10508000605000300030003050706000003060003000400000806000708000200020008070000000601
10407050507767344034607050402042706030553540205887682380442820647740867630252572701
10803050700000002000802030202040002080000030408030003000700070007000800060200000401
10804070856325606840703080608070675028423030606030302064702064307064706088605044701
10805030000050307020307030002030004040800030800020500080007000803000007000007020001
10608360264020202070404048577228404070506770704220487440805360305237268252822060641
10600070008070600020008000200000007000706000300040000000800060800000000000300070001
10235065427040736563383580408047557458803047547847202257523080205057525420262430501
10003060002050600000000020006000005000006000004000403000800060408000200040000080501
10304080507070405037535030245235705046828074408030558030707460604474307050222030501
10307080300080804000700030400000808070005030003020006040005000400000207030006040801
10508020673570505020803488407020843030608470836087302055245056524380773070602066401
10408030000000204030707000005020002000700000300060006000400060000040002040405040001
10802083254366807780305028226052403667648334408820346250303343357065207058208030831
10704000000000800030300030008000200000000030008000500000500000000040002000608040001
10608776533820475060276343405030645220848026782083202072234785264630352770836040201
10600000000040000050000000008040000020305000008060005000000000000080000000400040301
10742724628023377553862450423027452080207057806020604024485375675040565826808047601
10000030006050800000000060300080300020004000300040405000005000500050000000202080001
18868040805030208836564020702240607675672053434480303543345070508528778870606060831
10008060706030806000300050300000400000003040000000805000400020300050003000504080001
10575020705030704070405380702377468824805340378320585040505220567050703067804064201
10000020800060007040007000600000000000807000400060800030004000307020503050004020001
10338540703456548070655080288223544440303044507086204776586072403050206460533060741
10004000606000000040200030000000005000206040603030005000200060002060600000700050001
13385020874060803670204435678275505080608070502030238030704060528080204027302078201
10004020300060400070802000600020004060307000608000200060504020000020203020003000301
10406064306020386760704540705450636060205355506856805080307064232550504650554680701
10700080003070200000500070300000500030700050006000008080802000500020403000600000701
10448760647260205535232060707522503452868780708063866630604756607070665038838872601
10000000200030208000007060500000500000003000804020000000500000605000500050000000001
16555755706044206062238080324388465727807028578070644573563650503235205050328684761
10000000003000005000000080000000000000003000000040000000000040002000007070000000001
11111111111111111111111111111111111111111111111111111111111111111111111111111111111
