11111111111111111111111111111111111111111111111111111111111111111111111111111111111
10002000000060000080000000000050006000000000600000000000000050000000000000003000001
18503020657040734050858442605070804076863320403550806767603240504576375874308070201
10000040700070003000700000607040500080000060005000300000400050505000200000207050401
10648470707434602038528480205030254670707038738075834540884020504080502740708030601
10006000500000006080000070504000200000204000600050000030200050400030504000700020201
10207042625776648860804070607327404433203520303570348030702770402870405234386450301
10506070000050000000505000700030003000200080400020006080200030505000600000008000801
10605080873030657635737680235080504024286030452048258040778060607032528740303772401
10805000507040600000700020008000606080000060407000300030206000205000500070407000801
10705476706040507323207025753066304050565820805530802820208574302570203027205050201
10200000007000700000407000004000203000200000400060004000406030003000307000606080001
10762283476543466840507573806067405657507076774080683045705030386063502520205037271
10000000000000000080500000507050003000506070003070800040008000200030007000807000001
10366750826467444070277330308050472370802350504070406870502623206080348085505754301
10600060000000600060000000303040000050300020600030400000500000306070004040004070001
10702074456060206773488665706026673030856080502860207744758766804475505050784050851
10005050005070400000004000008000005000706000303000600000002000200000306000400070001
10828020802050555775708060565756605672703064306047826633236040855460804068803070501
10002060503080600000500080200030700000002000206000006000000040000060002040008030801
10506030408060407030504638405050673877257020308427708020228055448087326630504043701
10406040506050005030408000708000200000005070600000800060002000005040000000206040001
10703057703065453030443060508482464436402070874360242878706226805030706486803020271
10802000003070000080000030006000000000004070408000300000402000508000502000607050001
10404682248043708633263735644050442572267070406033803680234030308360306070703083301
10706000007000204070000060004030000000003060505000007030004060500060605070006000601
10502067502530308020806040707040436082607080204025377058305260272040308060267330301
10800020005000800030806070500050008020007080703000300030008000505060503040700070301
17625350466060674750404040772620308520368020602060504420763070208080603078805030701
10004000200070400000502000300030200020400050006040800000600060700070506000505000301
10663038407536804042207265658032464040408520638370533637807050642528304080305778201
10000030005000004000800000008020000060700030600070700020005050000040006070800000801
10587370482065383680458887305020758770604025707020505040635070444280582040766760301
10000050000080006020002000202030008070805000707000804020407040600000800020003070301
10385066654080708020404070406050705020788030267478704030708054203347436068405050301
10303000007080500020600030200060700080003080200080008000706000700040005000700070201
10602032808080562830205370273886406428403240606030525478603370303030702040388230201
10806030004050004000800080000000200000800060005000400000800000203060805080000030201
10307070233265308063225266622450877437738050384674706070847757366046408085657780601
10207050000030003030003000800000200000400040000000704080000000003000203000300050801
10205024663040352060206020806273702780205027842723706075864680705250808025307060301
10007000005000808050200040008000802000404050000000007070000060500040406070003000701
10385652704733607070338648565040436085308250808587443057267020482830203080628887301
10000000700000006050000000500040004000600000200000208030000050006000402030000000701
10734660558523428060532250302023407650765840282280305020407682747026204075467230301
10000070003000000060000020204000500000700060002000307000400000800040007030004000701
10234020503033824258305050708080465665243030747036803060447570802360685030306055401
10008040402030004000307020202080000000008080300020005020003000202000300040700070501
10208032607060502620627070403836755085604087805640403082803037502077707070527350801
10304000507000300050007030802000005080004000200000308000302000700060005080000000801
10207050304578523073406040407022305020682850508668752750582380876330767480327684701
10802070300000004000506060306080006060000070607080005000300030004000600040200000501
10607040882243702550502060507080347025453020602060307045307034807077703075206083601
10504080000030508060305050005050004070300050200080800080003000308000006000004020001
10808640342060702060207074884274702070507750508740572740402360605648274562873050231
10200020002040600040008000800000006000707000300030000000500060800000000000800080001
10862074586020242235848640704044353887403078353525505248558070406037365860324850601
10004040002030700000000050008000003000004000005000408000400040703000600070000020201
10407020504060506047787060384434506033753032605030738030705330607768405080678040301
10304040500020303000600050200000406060008080007080007080007000700000306030005030301
10605020728840505050704665803050538020808270626022205054473035827760324020206037401
10204070000000802040202000005070005000200000800020002000700030000070008030407080001
10404052726574408620408065728083502275356786502520256580403555244046508025303070781
10407000000000200050800060008000500000000050008000700000400000000080007000303050001
10202878755740357070528885202070267280456032453083702036868636822320548840247060201
10200000000030000050000000006070000020704000007040003000000000000030000000500030501
10858646532064663848462280635057585050802056608050804054533582235040867526608028801
10000080006020400000000030200050400020005000200060806000004000800070000000805060001
14624030302070403856335050703280403274523028558480606286366030408226428870507030231
10003030308040504000700070300000500000002040000000606000600050700080005000807050001
10777020308070705040605650604245366448605880484640655030502560652020507033503027601
10000070500030002020003000800000000000604000800080700060007000408060404020007060001
10735450606473472020628040824755434360608026703074202752826024407070203740642080421
10008000402000000060700040000000008000406030203030008000200060003030600000800030001
12662020556070408260505333575725405050804020407020632040308070234020207057208053301
10003030600030200060507000300030003030207000804000400030204060000040705030004000401
10408023202050327260802820408540853060407225802646302080405032428720308660766570801
10700030003030300000400050700000800070500060006000004080504000500080803000300000201
10633750484550802387235070704262702846335420406025732530508637704080355084854222301
10000000300080602000004040300000300000008000803020000000500000705000400040000000001
15262873603026207046666080666343426665506037487020222288272770804462605020587785231
10000000008000006000000070000000000000008000000060000000000040007000006020000000001
11111111111111111111111111111111111111111111111111111111111111111111111111111111111
