11111111111111111111111111111111111111111111111111111111111111111111111111111111111
10002000000040000080000000000080002000000000700000000000000050000000000000003000001
15508070546040374040782755705080703062432280705560704443608330408827225224308050801
10000040600050002000800000307030800080000050003000400000400020302000700000407040801
10267350207263306083425440307030474630306087424083545370248030706060407440505030501
10006000500000008070000070607000600000704000400040000020700040700020604000800060501
10405075563753272770202020808222803674706820805270343020602830602680308474638340601
10307050000020000000606000200070003000700020200070002020500020703000200000002000501
10505020857050578525363470478070804045737030355027478050855020302036722720302237601
10404000308060400000400030005000305050000080505000800030203000204000600060402000201
10708784603040405534806058538067504040485620304550604520802573504670403087507030301
10400000007000700000706000004000707000300000500080004000403030008000505000606040001
10372775426267584480602832408053506328804068373060387038803050556034504770506084871
10000000000000000050200000305020002000805020005040800050003000200030004000304000001
10424530865335832040858760304070483570206360203070602650803888304070458055802732801
10700040000000800050000000703050000080400040800050400000200000802050008040008050001
10407078888070703376254837407063253060763050502560608685578533802857403070333060681
10002080008050600000002000004000002000505000707000200000006000300000804000200070001
10327040405050736444405020554682702658705072504048827874648040624260302054505070201
10006050803040600000500080800070200000006000707000005000000050000050003030007020801
10705020604040503020804347204080884757832030706544603050447043634088743570404088501
10508080602080006080408000504000500000005040300000200070003000005040000000208040001
10704028408048822060588080805833562355603060443760664485208428403030604437207020671
10302000006080000040000070002000000000002020204000600000208000205000406000308080001
10403372254042503566826444645080858444676040803026405280547070603330607020607036201
10805000007000508020000060007030000000006080807000002050008050600050804020005000801
10208085507260502070208080708050587072305080202046337024306270675070502050375520801
10800070003000200060406030800050006050005070508000700070002000207020207080600060201
16654630382060688530407080276470603220448050807030303240533050603080808035603030801
10006000600050500000602000700070200040200030007080400000600030200030203000404000201
10245032605545302077802775425037626070705240574560633548408030774375503070803568601
10000030003000004000800000004040000030600040400050200070002060000080002030500000601
10353830645074462280837658408060454260308074403060704020752030653220566060464360701
10000020000030004040003000804070008070604000307000705070304070600000600030005030701
10537034264070505080602030708030203080672070732625708040803024703563243038404060201
10702000008020200060400020800080300080007050200060007000405000500070004000700040401
10605048508040673630402750437826306276207340303070387872306750703060704060227740701
10806050007070006000800060000000600000300070008000200000600000606070202060000050301
10704080224663708065486355332470272534285080828362707060785827647065404067342230501
10305080000020005040004000600000400000400050000000705080000000003000307000600060801
10405078227070357060706020504877208230707034573366805025368760802770507054806070301
10006000002000305040600070003000808000307080000000005060000060800050804040005000801
10345525703476804060226272286080248033204860708563867045474040424480406080745656301
10000000300000006040000000300030003000600000600000607040000050008000308030000000801
10357880655767885030456380708058206220786640723860604020406365824034303056473450601
10000080006000000020000070707000200000400020006000407000600000500050006020005000601
10335050604064534857408080703050664288562020364064308020538420803550874050807025601
10008060402080005000707040503030000000003060700040002030007000502000400050500080401
10506025308060603860434050202366532057204086704250802074606067303047507020873750801
10608000307000300060003060502000004080003000500000405000503000300060003040000000701
10403040705428473074802080703087307050488270708885453420378640362430247430786273301
10706040300000006000606040503040006080000060704070005000600070004000400050800000701
10205020257734505670607020806050738057266050608040408074306075503043706058307023701
10206040000060605070705020008050002060700080400060600030004000307000008000004050001
10204380375080806050305072883533803050804260408540482840807820504324547424842060521
10200050004060800070006000300000007000704000500030000000300020300000000000800020001
10636034457050887734634340706045462553607066842648304255523060403054284460334270201
10004030006070400000000060004000008000007000005000305000800050705000600050000070201
10805060405070206088343040474753604022522088206040526040802270703837205050224040301
10603040800070608000800060400000808060005050005070005050008000400000505030008050601
10804040838730406080608623205060226030807760523078805072526033285570277070406087401
10202050000000608020203000002080003000200000800040006000600060000040008060302080001
10402038256543305480407066248053704764286532207260688350408836554068808065406040771
10205000000000700080200050008000500000000080004000200000600000000030007000402060001
10806474448470775030255342706030836730775074222025604063486547236420727550865030801
10300000000060000020000000002080000030204000005050004000000000000060000000200060701
10282343234035877233378540643024276060602078502030603025466758738040878643802035501
10000070008050500000000060600080700060006000200060202000003000500070000000805040001
17583060503020407856264040608730502824562076855780805543553070504888223340405060551
10005050706050406000500080600000600000007040000000203000600080400050002000705060001
10274030704050208030606560502745583423502230673350436020406660224030505022205025501
10000060700060005020004000500000000000807000300020200060007000407080204070003050001
10236840206844746070787040525825728860605056505078202343463033408030508330328060681
10007000408000000070300020000000007000606030408040002000200040005030800000700060001
14626030665070205360406752687762303030407040605020724020403040276080508023703044701
10007060400070400020202000800040008020702000205000600030605040000040404040006000801
10304077303030346280708480405680243070607272402386206070806038325540704880463650301
10400050002040700000500060200000400040700050003000004030803000200030506000400000301
10367520867440407778467070508576605537726670706056366580708656203020757054663557401
10000000800020506000005080400000800000008000505070000000700000807000400020000000001
16545526408058406026475060266886528883504062485070654424464420307875206030733827541
10000000005000005000000020000000000000008000000030000000000070003000002060000000001
11111111111111111111111111111111111111111111111111111111111111111111111111111111111
