11111111111111111111111111111111111111111111111111111111111111111111111111111111111
10000000300000000000000000200000000000000000000000400000000000500060000000000000001
15866065205038557320533780302027475564303623548420304064567780283060503078622834301
10000070005070000070006000406000008000500000000060006050000020200050502060000050001
10503230406030328040248023202083207850705224735086532780206030204220405580544030351
10300000602070300070200050005000600000600060007000000000807030700000500000800050001
10253832455068307785203830506770845456548680702370678526704020627862467582204548301
10008000003000302000500000600050008000000070800070002000007070200070000000004000501
12407070205070404030832450834054802087682070536085605046836020702050508244426030201
10006060602030803080000080300040503000003030700040403060005050008030400000008020801
10425020403760605055584030308750804454404037605060204060202068558020725682302080501
10000050404000708000200040400000506000006000005040005070400040003020000060006030001
10533540804027202082306280403438203020225466553080645030546520702023834040406033651
10300070408030004040008000400000200050004080008070300080300000503000004070202000001
12607730408060855050668023867850753085408030707050202560704835607026302050544733501
10005000802000300080300070000080008000600060708080500020502000304040004030008000401
10322060408532387350702682282070707820567760676037637060308054807070627040306030701
10400040300000000070600060008060200050400050004080006060007000006040000040506040601
10802440658240676020203050606077482022707076407060804043674848407080787283704057201
10706000700030005000803020808000004000008000300040302050002000303070300000400050001
10304063687086205686887020608722302440774470808260765040606850804033208420704030381
10007060008000200000006000300000800060000030700040008000800000508000004030504060001
10634060708680302658203273605870376030787680204046303053426437504280638020403244701
10002050600070400030005000500080400040700030608000206050000000300050006000804000001
10245040334020507070688780502060705824707040305874704070355430853070635324402043661
10200030002000407040000020402020002000302000306000002000700000300080800000802000001
10504885204737408084724040705087735050406745533077728830208624402320703330368065701
10500000304000702000600020703000000040600000000020000020503000004000700030002000801
10604350705084407050308670603842622270708748463882362040305028363865224077804328401
10200030004000007030505000700000608000800000600000003070204000200000500030004000701
10573843466533883050803060253760702030266432504073608030406680807270304663343040301
10004000400000500080202070000040603020003000807000804070406000804000600060000060001
10504040702680304230702044226030307032524020804050302020304085506078686040764032741
10200050405000802000205000500040007000700050005020602070704000004000000080008030001
10744630308027746050605670402665884350503830868070206040802473484538302356207350301
10008000706000300030404000403000000000700070408020400060204000000000500000800000501
14203025504850302388305045324066464477686020305040854774707080237220333764502745501
10605040800030005000707020006000000000005030006070000040002030200050000000700000301
10705060385040332050504080203850565520806070237078404060744060408085624840328030801
10502080400060700020004000200020000050400040004000306050000070403000002030005030601
10508030303335403434853448443074372050654777485630773028433683503053402044604030601
10807000808000600000000000003020400030000030000030004000000000006000500040006020701
10202020206040308427766635404030204083236030655023604787656643204260826530776650301
10006030400020300000700000600040004000002000504000400000005000300080000050000070301
14433080587420484480802240307646664053808443604060524635708070406074406063338035701
10005020000060006070007000804000002000503050007020500080007050803000506000005060001
10673076434260702035336050804060703770708050258230305060223370306770287847332050651
10000040000070402000000050605020500060400030000000604040000000700040000000200060001
10678330553040207638702380405030828050853633374228304030627522285077886680307374401
10400080004040800000500020800040300050000000000000003050000060003000000040400000201
18602058207024207480207060857887704747374046722576454065306075304535576050232520601
10003030002000804000304050000000408000007000000000308000203000300050002080000070301
10448040805650827053804066447740308268605042407460606040204220474050402058362360501
10300020700060000070002000000040700000002000800070008080600020005000506070400000501
10375880502055836660822840367050236360284460467025887570568880803563604040502478301
10000070705040008080600030600080700080006000400020000050000040800000008030600050001
16658060506050308080404054307740873070502036648750472033725030408745556030307050881
10000050207030700050707000006000400050606000000050008050008060700000004000408060001
10464340202020207530607445874030806760407224707028704070605050675067525088887020501
10800000206050300070300050000040700030500000603000405080300050007080002000500070701
10806020502050774760407050875567283083862340308560802040807372604840708830206358501
10806050306030000060403050000000000030008000806000704000500000200020800020604060001
10202043702044232040383074677227686050402460843068703463603670785030278046704060701
10006000508000703000400020006000007020500040800060004000605000305030004020002040301
10666340204680605084305530508042202070405058404560685080854022605075305070752040621
10000030804040004000400000506040006040802000006000400040006000006000706000200060001
12433040604074386444284384804340263060874728848042306034703062255440806665402068701
10007050700050000000800080004000800030600040006000007020004000000030600000803000801
10227040422820206670708080376020607340305030307333466060388275267560657780206620301
10200050200000400040208080000070500070003060800020000030004000000000208000300050801
10205520302557405220208034854020832036533470504067248455507073875374202038775063501
10003000800000603000305000002030007000800040304030000060007000000000307030004000401
10354024827330607043205342405273263358607040802030708074457064503330408040203650701
10402030000060303030004000300070000000002000504000406000008000200030006060500000301
10805080708020506070362040225020306454276742483044706373407360225076848080608222501
10003040508000805070006020000080407000008000002000300000700040006070800080700000701
14675040877533603053202047575560876068402067407326442080688055707030503330342360401
10000060000060004060008000700030003040003000700000006030008070002000700000200020301
10422464435077343050508452702078706040346470308534607344848050377687303647203520501
10000000002070000030200040002000800070000000800000500040000060003000300000200000801
10678848505060343480362040336760682444656235373388665060628672647020562278844328301
10000000300030000000700020000040000000000000000000000040000000000060000000000000001
11111111111111111111111111111111111111111111111111111111111111111111111111111111111
