11111111111111111111111111111111111111111111111111111111111111111111111111111111111
10000000600000000000000000200000000000000000000000300000000000500070000000000000001
13287038208085766750233530208043543357205523776840808075738530362050403053423665701
10000030007020000020004000407000003000300000000040008060000040600080606070000040001
10707640204080236040374056807054304250506646472078684860602020405760504870827030761
10300000805020500020600030008000500000500040007000000000402060400000300000800070001
10435622487085206874208470206720244767854470605370387352408050756267876438405365701
10005000008000806000300000700030005000000080200040005000007040800020000000002000501
16503020207080604070244450373083804023674060355075403047846060206030504746234070601
10005030807030808040000080800030404000007060300070404020002080005060400000004070601
10835050708360307047688030506760705278502032508060704020705044668060738463807020801
10000050802000707000500070800000606000006000003070007040400060003020000080004050001
10233850607076807062508320305646703070423342648030486070537820402036334030208065581
10500060606020008060004000200000800050006080005040600050300000207000003060304000001
14507840402060367060232075758870758085706050708060608440305752405086805040433855501
10005000504000300040200020000080003000800060207030600030807000707030005080006000701
10724070308327463730205727483020502550784480824024868030503046203020543040408030501
10700060400000000080300040007030300020200050005030005080008000002070000030302070701
10707320664380365030802030305028288033405042802030704052377762204060282557706058801
10703000400030005000803070807000002000007000200040507080004000403060200000700060001
10408055444027508274665030803853604620482360808680524060606870308082602850806020651
10005040003000400000005000300000600030000040600040006000500000807000003050506030001
10438030303370503656306573508770362020628270808074503075326526304730372020704532201
10004060300020200080005000400070600070600060207000306030000000500020005000608000001
10372030474060406070675340203080408884402030503842305060578630525020688464602043221
10300030004000505020000040203040007000805000802000007000700000300060200000306000001
10804733506473806074884030806048685040207425225045383560504842504350408350668075401
10500000405000706000700080706000000040700000000060000070604000004000400080004000601
10204440703073506050402880708345378450705355422733525020508022638454754066805436601
10200070003000008070705000500000202000300000400000005080802000800000700060006000301
10756224826457263060607030256250802080444858705062203020206420602520308766436060601
10002000400000700030603040000070604080007000203000606060506000303000600040000060001
10404070804840702480706058736020505042747060807070306040405076207035727080468068471
10400060705000203000805000600080002000800070005030804070503000006000000060005020001
10666760202078746080403670608755268540208520652050608060304278835345706785805370701
10006000504000700060507000708000000000600030302020500030204000000000500000400000701
14205055302680204563302038467073656842656050505040744572307050365450422865205265201
10703050400040008000806070008000000000002030008040000020007070300020000000600000601
10707020822080845030205040804680574670407050626057603020655040708022226540435070701
10308040500070400070006000400080000040600070004000805050000030606000003020003050201
10704060703538607668688488468022762050347466346320235064775458702083702076505020601
10505000303000500000000000003080600080000050000030008000000000003000800080006070301
10406020804070703856752624305040302076782020578048704375447347605720242450738880501
10007020300070500000600000200070006000003000802000200000008000200070000080000080701
18523020737320452780405240407543862074606374403030665246506070705085708023447035401
10003060000070008070008000404000007000802030004070300060007060402000202000005020001
10743035747870702043725080204030302840703050623650808030722220308640777835655020721
10000050000060806000000070403030300050500040000000407070000000600020000000600070001
10265850726080205385608770305070354070422786622848306080338555576065457270605684301
10500040005050300000600070600060500040000000000000008020000040004000000050500000501
17206056307038505320506020354466804742348077375552244068405077404538242050845270401
10008060003000805000202050000000808000004000000000204000602000200020003080000050801
10722040805520448073504026234430704776407077608640508030708320564040205038624860801
10400050300070000030007000000020400000007000200030007040700040003000705060400000301
10852280806085435660873480842050568350374750328024657620762260708857604070608666701
10000080807030003050300020500050200080004000300040000060000050800000007020700020001
14387040402040403050504032708230442050305037834580488082755040405385627050602040321
10000080404020200020207000005000500020606000000040003050006080800000004000306070001
10323640204040506650708763755060507660403327802025406020708020748088347033372020301
10200000304030600040700030000040500080800000305000308050700060008070006000200060301
10708030406040632450308040627524368066278840603580802020803834707880402420802564501
10403060506040000050306020000000000060006000302000805000500000500040300050604060001
10602066504083224050784078757535757030405270435024406568403740538050227074502080301
10005000606000507000200030005000003080700080700040005000505000506050006040006050301
10242680602530604046704470206047807070207087307850534050648078505066504080637030321
10000050403020006000800000205060004030807000007000500070008000008000706000700060001
13732030802037385445765423208720487040547675638054204033207072826320404636303062801
10007020500020000000400050005000400020200040002000007030006000000050700000802000801
10528060223620303780506060434040303360608080806535778030377346668860634670206830401
10300080400000200080202040000050800030007050300060000080005000000000702000700040701
10704750306525706660502035836050426067545330802083646657605088646543604032664044301
10002000800000205000402000002050006000800060304020000020007000000000704020007000401
10522063856770404052506283804256676563203070608080305025483026607870702070305420301
10207040000080206080005000300040000000008000803000203000004000400050005070800000301
10707020505030604060773050436030706353836364356042502775306640683082825030305373301
10005040403000306020005050000070707000006000006000800000400030006040800040200000201
18372050237862402064207074774750632043702054302225783020446057502080702560445250201
10000070000080007080007000400020008050008000700000005020008050004000700000300070501
10262844633068845070706874305053807040776320707247704323672080565537502784805280301
10000000002070000040700040005000200070000000800000800050000030007000500000800000801
10826762408050567650266080447630234878868673474756443050358557833080424583766453601
10000000300040000000700080000030000000000000000000000020000000000060000000000000001
11111111111111111111111111111111111111111111111111111111111111111111111111111111111
