11111111111111111111111111111111111111111111111111111111111111111111111111111111111
10000000600000000000000000300000000000000000000000300000000000500070000000000000001
13588056305024878530537280206036488637406552847250504024745880457020704065677565501
10000020006080000020006000707000005000800000000040005080000080200030303050000020001
10807550404080488020886074702065702730405853485087875880602030406230805340852020231
10800000403020700080700050002000200000400070007000000000207030200000600000400030001
10588233436085202855306330704430686485557520303440462236405030735434655274408535301
10006000005000802000200000300040008000000020800030002000006070700040000000006000201
16506070702070706020254370368034307033365050378056508077866070205040604367648030301
10005030206050308060000060700020403000006020500050607060007080006020200000006080801
10235070205270407053223080308420306845406086807050506020406066227020675458402020301
10000020802000708000800050400000404000007000003020008030400060006020000020008030001
10565380804057802067502530203555704070756644834030672060338540303057578030703054541
10400060804060008020004000600000500040002060007030600070600000202000002050404000001
13502230503060784060682077827640238068406030708080302620604727503073306040276345701
10004000406000800050500070000050005000800030802070200040303000308070006040003000701
10232060607236824820207335278030808750868660325086573020608055308060266030402060601
10200040200000000040400020003080200020200050005050007070007000007040000060202060801
10706430722850434080608070404058636072205075506060403057336643702020368857803064601
10305000400040008000707020403000002000007000500080803050004000406040800000600070001
10804023828036208374324060205536208830873620205320853040307860606046407420407020271
10004040008000800000008000200000700050000060800030002000200000208000008080707060001
10435040303760506825308485203830737060858540402026306052383772304620474040807544501
10008060300050700060003000500040400020500030605000608070000000700040006000704000001
10672070638060305030574440707060402636502040604848407080537840536040667342302045481
10500080005000304030000030203070008000403000607000003000500000300050700000708000001
10708448404272303055843040508022862030807485544064777380303782603730604280585025501
10400000606000202000400060607000000030500000000050000020703000004000200040005000501
10802350504074406060303360402555227730402237587653346070708034724774448068606763801
10300060008000002060604000400000603000800000500000005080208000800000500080007000201
10545836458428557020205070636440307030286227302082503020205760805270703683675050701
10002000500000200060207020000070304080008000404000403050602000302000700070000070001
10505040404380303670503046682070503043867020704040805050603055507053558040235027661
10700020204000602000305000700080003000300080005030506080806000006000000060007020001
10223270207047787030308240207538868340204220774050402040208576473375608485403620701
10004000208000400080203000706000000000200040502080400030307000000000500000500000801
14508047603750503723306063822046467365846040708060235524503080756860432365408622201
10406040600060002000804040004000000000003050005030000020006020700030000000200000701
10504020782040842030402030206530556840205030662043808020588060204044887760257080501
10408040500060700080007000800030000050800020007000204040000070608000002020008070401
10608030606778408637835638255068363070278744772560553034225464605052604032608020301
10506000207000500000000000005080500040000020000020004000000000004000300060002050201
10208020206080805765464575707020205036862050645042706237482263508580238550345530201
10007050600070600000400000400080006000003000507000400000003000800080000050000020701
16643020724530284760503540508333346036203454203050243684704060408042508023635056801
10008020000040004020003000702000002000706060003070500070005030402000204000005020001
10746056837420508032223070506050204430704030844420507040232630603250643256342070481
10000050000020803000000040803050200040300080000000705060000000400020000000200030001
10235740562080804568203340505030734030384544666224604070775562327032745750203575601
10600070006030800000800020500020200020000000000000008050000040008000000040400000501
18704055203057306830802020244843608467377056376725232086602066204638523060666570301
10007080005000307000606040000000605000002000000000404000705000400060005040000080301
10777040802380225032303064586570706544504058702780304080505650342040302025482860801
10300030600060000030003000000020200000007000400070008050800080003000504050600000601
10774780804028238820667420734080676880837860242065577460766560208573404080602682801
10000080502020002040700020700020800030006000500080000060000060200000002060400060001
16524050607050402030308022406250862070406035665270834072353050304382536080806040271
10000040704050300030806000003000200060408000000070006030002030500000008000206050001
10348380503040805620502673255060505770307224506077206020503050282058476067538070701
10800000704060700060800060000020700030300000302000704030600020006030004000800070201
10202030304040862260202040245457438086824240307780203070208867808730707320807544701
10407070605050000070702050000000000050002000402000306000600000600080700020503080001
10203052307078564030662086635524343040504220652067306555504550853060523087308060301
10008000203000607000500060002000007080400060200030003000808000505070002060005060401
10248320802820804087606640507047403070402036604250578060478024606074307050365070271
10000050508060003000500000202060007020804000006000500040006000006000203000600020001
15885070604052363568336262502250653080446754648087504064704053838770203472604037201
10007060700040000000800070007000600080700060003000003060003000000050600000708000801
10682040375430303350208020623050705870708080305273682050436688457830573680704730501
10600080700000400070404050000020500020004060400070000070006000000000205000800030301
10308760706783703440508055463060426036552520202072864844307088338864808074347068701
10007000400000505000806000002020003000400060408050000060007000000000504020005000801
10482056424330203063408678504388677232302030603050405075364064403740504070604530801
10808080000020708080003000700050000000008000403000507000004000800030007020700000801
10503020302080207030252050888070303584663426436086308242506230567047556050307863401
10002020402000206040003030000080506000002000002000200000700020008030400040500000401
16663070535476404033703028723720778086303064308227758030523026304020503770585540701
10000070000070007080004000200030006020008000200000002040005050006000500000800060401
10628364865056586020307282808048405050652350308545703877724020672683302478602640301
10000000004030000040500030005000200050000000600000200020000070002000200000200000501
10626824702030573330323020255660872424866666488683752040784354285080682755754838401
10000000800040000000600050000050000000000000000000000050000000000040000000000000001
11111111111111111111111111111111111111111111111111111111111111111111111111111111111
