11111111111111111111111111111111111111111111111111111111111111111111111111111111111
10000000005000000000000000003000000000800000000000000000000000003000000000000030001
15505047204073546262403730247068407040307047777036832553587676303020642560774050701
10404080004000000000300050000030006020305000005000400000000000406030400020007030501
10803480822256884780508040762270534380707554705080306028835870802080407082403740401
10600080000000000000403020003000600000200080004050008080003080800050806000400020401
10248050407534352224575040504054502488852240373050534680308050647245703020207050601
10400050703000000000700070708000207000005000700040700000300060800000705040406000201
10503580564064365330402070504420378030806063208885805037247070805420304730303547401
10700030005030000000407020504020000040200070800000003050007030506000308000200000601
10227060706060857428505050605026486720655370708084876066206070508072807034632770701
10000080500030002000007030200070008000300000404000003000006050507000008060008000401
10357850403245233030565030873624508078507655805083503285602070807058523080407670801
10006000500000300030800070000000007000504000303000500000704060008000007000200020701
14206044823835803765806084572862763050707320405270887720708028687450403543265060401
10005080000000505020004000800000008020004000700040000060804000000020500000400040801
10857050364780605030306260606473504884603075702068704080576568583052457640804545501
10500080800020506000803060400040002000305000705000606070200000300040007000200060001
10802030408060606085607030262030726020536820324730707060503840505030605043268080861
10304020507030008000800040004080007060000060004000806040800050502030700030008040001
10808080607034354833507237308060206737558087405082603070587050308060562760504063201
10308040008060008000204000400020300000008040300040004060404020006030000000705000801
10705553777060202020705080635050384425708070804640337060202083337288343026664650501
10300000007000603060300080002030006000504040200030300060007000000070006020008080201
10555234445226506030752560302566606040204040735020802476572372536050702540303060801
10000000400000007080500050800030002020400080008030400020000050000060708000804060801
16445080405854732040806050754060623020752674804060404020576030302250208055803080801
10007050200000002070006070802060000030000000806050602080600050200070807000604000701
14803770202422203050662080507040756056632320808080207070703730566830205460402320801
10004000703000500060002050502040005000000070004050208000606000700030200070700050401
10705073345070777485407030402060806782476654886360774577507032703070407080474078701
10405000000030006000008060007080405000400000000000300080004050003000502020005000001
10604275443885508023882020674072308020402072686748605040885050235447364060704068541
10300000400030007020000050600020005030008000004000205000506080008000006050603000001
10537423808070644080704630802670635067426286704040802287202065605027604078306047401
10200050007000500020500080407070800040000000606070600000002000208000802000002000301
10307040603635705420507260305030604358584730242030406677526070608760206364258020601
10005000206000006000507000802000503000000080000030600080004020606000500030002040401
10266035202037863026254065207686306070574075875550757050404030808020678072206050801
10003000304000700040005080004000400050003060000000700080808080506070002000603040701
12504773407080408587806050425030463642404020508825203426308060803040405450202430301
10005000803050500000206040000030300000204000200000800000006060800050804000400050701
10823020302060228360305056457650643750875874822670478026504050462423202070405070301
10800040005060000020005000000030400020800070000030007000505060405000306080507000601
10806857467040463066488320656050308070402030233070604360782050703030233080686757501
10300000500020002000000050200070005000302080600030400050300060005060000030002050001
10708470705283506842457030304553833853285080808568728035807025647068604533604060241
10507000605020002000003070500000004000004020600000000030008000008000800000200040001
10688050808060503030762060845364607054206086302762323870402432352430608420608423701
10200020602000404050500070005000405050008000602000000000307000003000503000306000501
10403337502873583050703450302050705080665730536073747358668022702068335074306080501
10400000600060000060200030500080700040500000500070000070003000500080006020704080001
10532650472070506027654070588050204460606037805050768070402030303720808030402050671
10000050002000407050000030004080602050005030005070005000402050400060200020007070001
13554082705447306070786855503260607074437870402053502482803380368070723374742055501
10006060005000006040007000805000500030006000602000600000704000700030600000002080201
10202030344862533045607760406043738560206057448728402730307040305340306784303030401
10303020300000006000300000805000000060703000500000600060500060800040408000402080501
10276080537257408570208382504552807040706020203740585730538255243050308042808080701
10005020005000004040700000800000708000507080700080000000800000006060007050007070001
10702078607088284040374635762520225854806080865026688874684343504063864070553062201
10507000408070000020000000000060000040004060008030000000000000702000000060002000301
10803560202060507567344262353030665060343653358020353366548840408577562846803280551
10600030800020700000000000400070700080000000800070200000008000800000000000200030001
10267030472430553440457770402857203052285660603880305285204028788476603520842075201
10008000800060000020000040200000303070000080500000804000602030000000300020000060001
10504273308040328077883040488030203050308060426044307070702076207660404048665560681
10804000004040002000006040008060204050705060008040006040402000300040805000000080001
10308073644034653067808442405250606730482026708220483084704030424870804534446047401
10400040400030004000307000708000500000700040607000400080005040000030800020008050401
10688470803280807684707080525070556356608560808030205720648060448070402070248030801
10500000700000600050008070000050005000006000300040700040304050004070804000600050201
12707085483384747070254050532320444038386030635730406020605060765080602426502850801
10004000000070004030700070000050400030000070800000205000400030400050602000600000301
10503545638022603070208036528070702820403340306223778445654080202350708050608823501
10700000004000004040205000300020800000805000700070000000004040400000307080400050301
10225675554027654060508274208835445252702078436340405255706030335637633060583070301
10000000008000400060003000008000600060008080008000706000004060700070800070004000301
10777487607382404072774082424750204040558070502045302082583040802060607726506775701
10002000300060004040006000000030602060800070602000802000800020007000200070007000301
10604040427030802060308227342040607760804630304760243230353573633285246040833070401
10300040008000706000400000003000300000500000700030000020000000000000000040000080001
11111111111111111111111111111111111111111111111111111111111111111111111111111111111
