11111111111111111111111111111111111111111111111111111111111111111111111111111111111
10000000700000000000000000200000000000000000000000200000000000800060000000000000001
17445057608038788660283670604038635733708222378780805025562530832070605086827528701
10000070003050000040006000803000004000200000000050007070000050300020805040000040001
10607350406030485070668056303053607280602872256036758660702050804550706880868030381
10600000803040600040300030002000400000700050002000000000405040600000500000200050001
10425663625028504432404680405740743777334480506720648323503080877566354567603333701
10008000006000404000600000400060005000000070300080002000002020600030000000005000601
12608080706060805080657830454053207056343060857032706043574050508030504665462050401
10003080202020404060000060700020803000008050500080705050005070005070700000006060501
10827060206570805043575030606880606774303058507060606050304044638040584545706070801
10000060603000206000400070800000704000003000004070002040200020006060000070007070001
10388240602038604028407250206575807040427422876080756070743750702073246060304065671
10500060503050006060004000200000700080005070007070300060700000302000006060806000001
17407820602040847070334033843860548065706070507080802260708252708062604030588444501
10003000807000700080500080000060007000300020507030500070402000608050008040007000801
10677060202347834220402765375020402450354460674076653070605072804020262020207050301
10500080700000000070700050003050800070800040002050004070003000006050000040307040401
10703670545470272060305030806032234026203047302050606065688363706030672466803054401
10605000800030005000407060207000002000005000200030707040003000203040300000300070001
10706066374072307457363020602263404640665770702250455030808560403055307250405040351
10003060003000800000008000600000500080000050200070003000500000303000004060606040001
10634070602250403488205456205520578070788260403078304035228665402250688030206476601
10007040800060200050005000500030400020400040803000704070000000700020003000808000001
10572040388080403020438420704050605867507060604384503050662430746070656567805033241
10300060008000403040000070308040004000306000303000002000200000300040300000807000001
10307775708385207037425070407045786020304836635075858820807474805680505870626083501
10800000607000803000500070808000000060800000000050000050506000003000700080006000501
10707830408055303050308650804743462220802745643886875070408037384375248082504476601
10700030002000005050806000700000803000600000300000005060405000300000300030008000501
10486285587778665030206030428280408080522684304074306060805370805680305467533020401
10007000600000600020405020000070606040008000704000405040203000803000600060000040001
10804080505850308320406072584020402044584070304050605030502064403062637050458075281
10400030408000208000605000600040004000800050008050403050208000004000000020004020001
10727450306066587040305750803453347550705330558020705050603878832622806724406370801
10008000702000400080704000703000000000200030807080300080308000000000500000400000701
17302048402250206844404058378025637725856060503060366638407020564420675778306666701
10302060800070006000606070005000000000003020004060000050006030200020000000400000801
10403020535030438020503040803380324350407060487063705070666030406053663550653030401
10306050700040800020004000300040000020800070005000602030000040808000008040005040701
10404030803486508738473642224027565020887272485820536026854536508088307078606060701
10708000804000400000000000006030800080000080000050005000000000003000200020003050201
10306020607040703573588682203040505034856020874082705465754862208760467370526280301
10007020400050500000200000200070008000008000305000500000005000200050000080000080801
15474030454460667330302430808882772043605262803030844238803050808025405082433077201
10003070000080008080004000308000002000805040003060600050003020506000507000002070001
10587057757250706025332030802020302440506050243520503020682430307550556588588020661
10000030000080707000000060408040300050200020000000308060000000200080000000400040001
10632460664070207727308480204040877070645662622828702020886767624058866670405756401
10800040002080200000700060800020400040000000000000004070000070002000000080400000701
12704085505063503380702020672623306364525036473875388026602075306845367040532860401
10006050002000307000704040000000307000007000000000808000506000600030007080000020801
10383030807340687067203087877240502358402076705620503020507330788070504078356870601
10200030200040000080008000000050600000007000200080002050300040004000608040700000501
10725750504078434670454740675020728850585360353027846760637720307528704060308848801
10000030207020007020600020800020700040006000300050000080000030800000004030400040001
15857020502040605070805025604340775060403058653880275027683030805346838050707070741
10000020706060500020607000008000200060208000000080005050002040300000004000807080001
10254630204040403650506484764080502640508627805073708050808020253023565026784050701
10400000203030600050600020000060700030600000708000204060400020005050007000200050201
10802080407080235360604020272883585032242270707640803040605435803360706460608676701
10205050406040000070305080000000000030002000303000306000400000400020600030702060001
10608085705065428020856068887887768030604250434088706323702750354050378065303050701
10006000308000806000300080006000006030400070300070006000707000504040002060004040801
10826550407780602027302520307025303070205062608570888040438025508075403060863040631
10000060303060008000200000202040008030803000006000400080005000008000603000700040001
13285070205038553652287337503630465020346445568037404073506085227540203763806046501
10002040800080000000600080008000600050800070007000007070005000000040800000604000601
10685040737550808670202030563080308630808050408447867020528857553440238360502840201
10700080300000600060307070000060600020008030400080000060005000000000207000200050201
10405330505777304860308024475050284045328330407072525658703048225344405053664035501
10002000200000802000206000005020008000200080403050000070008000000000604070003000701
10563075323230206054802333306723576536502060805070507063843088802860408030802830801
10807050000020202030006000500080000000002000704000305000004000300040004070400000501
10604080204030707070775020754040508537545545638057803352807470236053546050604827201
10006030202000706030006080000080606000008000008000300000600030002050200060200000701
16543060622527503058602062352520474047502084804386323060844035505070807240375650201
10000040000020008020006000500020004050008000800000008030002040002000400000800040701
10584738854025868070602575205047202050682850403346203578627050565886803255408360801
10000000002040000070300070003000500080000000600000700050000050005000400000600000201
10873685603020866830365020678730248852476722323677734020578587683060578675627758401
10000000500060000000700080000050000000000000000000000080000000000060000000000000001
11111111111111111111111111111111111111111111111111111111111111111111111111111111111
