11111111111111111111111111111111111111111111111111111111111111111111111111111111111
10000000400000000000000000800000000000000000000000300000000000800070000000000000001
13683038202044568730788230404032563672404662656540204052265640782080404043274654401
10000060004030000040006000407000004000700000000020006040000070500060407070000080001
10504570708030448080862087805068505240707746673032287720307030802660404340753050541
10300000205030800050200020002000500000800060004000000000603020600000600000800060001
10885555276052808644502660802460353232352230604730863227406080625867848622306832201
10006000007000306000500000700020007000000030200050005000003080500080000000008000601
14403080303060203080344250742085805045632080668075304063427040603020204832336040701
10008070505060505060000050700070504000004060700050503050002080004030600000005070701
10243070304880202072633060802770402877404037707080304040504023368050254254505080401
10000070406000707000400060700000406000006000007020004060600080005050000030008030001
10625240704048804027705860603256707080233477628020422020375780604043455020606025571
10300060602070005050003000500000300060003040002080600080400000606000003040704000001
13203750603070488020575038275620574025805070305030506620607475703078505030376777501
10004000805000500080300040000040007000600070608030200030705000803060008040006000801
10655040403467837860202487668080706420457720278033776060405037804050737040706060701
10600080700000000060400070003080800050800060004050003040003000004050000070508060201
10602440765230335080508030502085882088507078702050307043632266808030336776708065301
10804000800070003000308050803000003000005000500060608050005000507080300000800080001
10606048654024203537823020708686503320548230208260625070308260205028508830704040741
10002070007000400000003000400000600030000020500060008000300000608000007020506070001
10848050605440404736702274204240564080538360602047805047324273607630246040302887601
10006070600060500030005000400060800020500030402000708050000000400050008000208000001
10627030333050404050668560802030804667603020308644705070523840866020257322804047741
10600020002000806080000060306070004000703000205000003000500000300060700000402000001
10408623807563503088386080807038873030206268454066375880308558803870706380758076701
10600000706000507000300080203000000030600000000050000060407000006000800030003000301
10402430207058802070504630702273888630407573845452642050702078425232563068506276701
10600020006000007040203000400000307000200000400000007050804000500000500060008000501
10734746335582226080607050763420305040584475306032605070405480607350408727882020201
10007000300000800030806050000050207020004000606000408050707000602000200040000080001
10205020802530207840204038783060704036882080607070605050608076605035523020463026631
10500020806000202000506000700030002000400030003070602070708000007000000070002080001
10674470702082548020704440803827745330203350524080308060707745426676302837202220601
10006000507000400040502000307000000000500050506030800040204000000000600000300000401
15204026708730805583807025447025575267486050805050348522307070532240588824804725201
10203030200020008000802040004000000000005020003040000020006040500070000000400000201
10507020762020665080506060303320562620302070643033606070753080307023326660766030501
10205020500030800060002000600070000080300040002000802030000030508000003080007080501
10507060305323706558358673286067884070484324587370268042553473403063304088506040501
10206000608000300000000000007060800080000070000030002000000000002000700080002060801
10202030805080205335468863504030303024845030378052406223564747608460573630465560801
10002070500070700000700000500080004000003000304000200000008000500030000080000020501
17672060453860778250202230503786743063604265504030374426502070707063502053642033201
10002030000030002050005000806000003000506080007020800020006030305000704000008020001
10488065572380703082382020705050703440607050242540604060474630606450678265332030821
10000080000030306000000030406020800020800060000000605070000000400040000000400030001
10574330787050802324403270507050345060722652546843204020552523722025285320305523501
10700080006060700000600070600060400020000000000000008020000070007000000030400000501
13404083406055804880205030445622505784277027528585763023504075304223668060427650801
10004080007000402000308080000000208000003000000000604000204000800060002070000070401
10878030506240673076208077244620205474605033307550804020203750284020406058673830501
10700070400070000040005000000030800000007000200080005070200020002000206030800000601
10668860803048636660277370655050683250538240843052855840882480505863708030504363801
10000030806080008070300070800020200070005000800030000060000060700000005060800040001
14372020708040605060708036708380764050304056474760555088635040406536643070306080651
10000050703070700060608000002000600060402000000070003060008050500000003000808030001
10828440307080205870207845224020505520408638605045503070505070638032687058643080501
10400000204070200040800020000080300040200000604000402040200080005030005000300020401
10504040202060265240408080574546222083528840803550308020605274603540708720307847801
10605020802070000070504080000000000070003000407000302000600000200070600040403070001
10502074603026587070285083427328543030705550573027208887302560454070647067502020501
10005000208000304000200040006000006050200080400020006000504000805020003060006070401
10445220206730208062605230706025308070407026808340848060683087205087607020586030441
10000070306070004000800000208040002040806000008000400020007000005000503000200070001
14786060306085233865786862605430477060328252323058408026602033438320204388707088201
10007060600030000000400050006000200020600030003000004080003000000070700000303000801
10868060282720403220302030474040307680402070503273368050357837662380524730803620201
10200020800000300020707030000030300060004020400040000070003000000000806000200050701
10703870807533607350806056455020724068625740807066455432806084848623806037776087501
10008000400000402000503000006060004000400070507050000040004000000000604040002000801
10823064572420402057404578503876255372407080708040607073626058302740703030302750701
10507060000040804080002000200060000000007000808000202000003000400020002020400000401
10505040304080405040735080865080602748638863343027204486208340324064256030703362401
10003030808000404070005080000020808000004000003000200000200060007080200060600000501
14887040284545702022605022836450756028807057504472746020322052304020305280553240501
10000070000040008080008000500070004020007000800000006060004030002000600000200040701
10565263585055623040706887204072805040327670708856303322767030442227402654404820801
10000000005060000080200070004000300030000000500000700050000060004000400000200000501
10563657707030887550374030523450753425737874688666363050747525362070388552635527701
10000000600050000000500060000050000000000000000000000070000000000020000000000000001
11111111111111111111111111111111111111111111111111111111111111111111111111111111111
