11111111111111111111111111111111111111111111111111111111111111111111111111111111111
10000000300000000000000000700000000000000000000000300000000000800020000000000000001
16825023306066743780246840406075772854806573758330505045248620842080202076664423301
10000040007040000040005000504000002000500000000020002050000040600070307070000080001
10205280402040443060332085603083202820405755283032633650303060304220303740355070721
10400000704070400040500060003000800000300040002000000000206060500000400000400040001
10247855848057706545202530204440733263385880407420475827405050338464855337804457501
10006000002000506000500000400050003000000030400030004000004040300020000000008000501
12206080605060306030556750753088408088762040474087806042383030605070804452432070201
10006040504030806040000050500080708000007030600060304060005060006020600000004040701
10874060402260405035826020302540303528208055804040205050308053782060748586604060501
10000060206000803000700030200000502000003000004070005050200020003030000050008040001
10446520603057408074204660206426205050322734224050776060346230205063758020607064321
10300060307040008080005000800000500050005040005070200020600000505000006080202000001
13407750708050383030358057237780535085503020305040202650308854407042404070582886501
10008000702000800080600070000050006000700040807080500030402000606040002030002000501
10877030203786245320608263262070803830333420652086378060604088703060466020803030401
10300040500000000080800060004060300080300060003080002070006000002050000030805020701
10607750665260764050808070407028258074205062308070305067334845807050687687304066501
10805000400020004000507060704000006000005000400060706080006000408060600000700080001
10503065573056408854837070205225208820235430804230387080406440204055308680807080471
10003030008000300000005000800000600060000030400050006000500000808000002070405050001
10543060202560303526603855202320347030422530402044406038634277205650665030607448201
10003020800030300060005000300040500040800060602000702050000000200040004000203000001
10565070468030405040543580504080508338704030408668604070625570588050786858702084761
10800060006000402050000020406080004000405000507000006000500000500020300000803000001
10203778606652503023284070307046352060706754625057287340703347802650603330882033201
10800000308000806000200070206000000040200000000080000070706000002000500080003000601
10302570703022708080506220804873473270703227664632343020502034674488872088803684701
10300040002000002080307000800000504000200000200000002020408000200000200080005000601
10757568236745675080405070634220806020827865708057502060305330406320307274873070801
10003000700000300070403070000080503060008000406000808060505000205000400040000050001
10705070803230802250606036575020202037735050604080607050703028307075438060864033831
10500070303000408000408000800050008000700030008080502050805000004000000060004030001
10836320806034573040605380306447644230506680434060808070302456537654202674202520501
10008000204000300020205000208000000000700030704020300050504000000000200000400000301
17305086402650702464408034553037484448277040803040562823406080648220448855608463801
10206050300020003000805050002000000000005060006030000080007040300070000000400000501
10306060223050685020502070408320776540608060878037808060768080202025856580576030601
10507030200040400050006000300040000040600020004000307030000030203000005070005050201
10408060504263606844454536456037344040878628282650632084485285806065205077802070501
10208000607000300000000000007030400070000060000080002000000000002000300070005030201
10404060603030205738724328807080506047474070557037507286343872603470453860782650501
10006060400060200000600000700050008000005000808000600000003000500070000080000080501
16677060652430642680706270705362463073207683803050225274708070706075506036776066701
10007050000020005030006000204000005000504030003080200070005020305000204000002020001
10577033535520608073377030208060803340505060387220704020462560205460538775255060831
10000060000080408000000030704070600030600060000000704030000000300030000000400080001
10835550257020306852706470202050832050488762537884406070774832838055828520706476501
10600040005070400000200080200030200040000000000000007020000060005000000060500000201
14404023602066708650203080776554808364274054545654832067406057708748577030635760401
10006030006000705000207020000000808000008000000000404000607000200070003020000030201
10738040305720376046807034545440404424507057607370407050706560488030708034835380601
10200040800030000020006000000030300000007000200030008050200040005000502040300000301
10747230804083274240658750522040787370733720745058483650686330604546205040504563801
10000060503060003060600030300060600020007000500020000050000070400000003060700060001
18243070607070606070606022706250773020703082363540232036344050306226572040207050281
10000070802030600020703000003000700080505000000070006070007060600000003000807080001
10523660707070808240607635324030204560608333404032803040707030874063636057824080501
10400000708070500030700070000060400020200000204000706040700080006070008000700030301
10806040306060582350803040233668635076433430306420605060504545802240407640806357801
10204070802050000070308080000000000070002000805000704000400000700050200080305070001
10602043304047275020752087272786363040807620237037605254608340776080246044705080401
10003000602000405000800030004000004040300070700030003000405000705060003050008030801
10488250204820802052802670303034703040607076203280332020233065604023808050485070631
10000070205080006000400000705040003050703000005000700060006000002000707000200030001
17822040804024224535485424808470257070386472533076808057204072726480805886503022501
10005040300050000000800080005000200040800040006000008020004000000080700000504000301
10628050424830304620302030652020303380803080708646626020273548863840757660402870201
10500080700000500050805040000060700060007070600030000060006000000000303000800080701
10407520207872207420708087764060346066478420304045832545605045666363207053556066801
10005000600000202000304000007040002000600080602080000050007000000000503080005000301
10785036436250504075306648202633823467207050808020506044285066205870306030804760801
10504070000020804060003000200050000000004000703000705000005000400050005030300000801
10602050708030504020858080245040606764742837745056806343305230386056388080602868601
10006030707000708030005030000030205000006000003000700000400060004030700040300000501
16456050677265707035405056385740343077302087308228284070657036203060606750488240401
10000030000040003020003000300050002040005000800000004050004080002000300000700030801
10854423532022225080303773508036302040228240402736402325657020682537704326602670501
10000000006020000020200050008000500070000000600000800040000070007000700000500000501
10546853406070362820385060264450257757254763663267478040355586862030442666634228501
10000000200040000000400020000060000000000000000000000070000000000040000000000000001
11111111111111111111111111111111111111111111111111111111111111111111111111111111111
