11111111111111111111111111111111111111111111111111111111111111111111111111111111111
10000000700000000000000000200000000000000000000000500000000000500040000000000000001
16646027205024564720283250708088634576208357824280405028777840288080506073764454201
10000050007050000060005000806000006000700000000020003020000050400050204040000060001
10207370304040665050458034607072307540808372673068268220502030708520503250556070871
10700000604080200050300070008000600000800070006000000000604080500000600000800080001
10325632538023308228803750704220264775654740508460856376704060364545383247305488501
10006000002000504000800000300020008000000070400060007000005030400020000000003000801
16802070702020202020568770435067305078354040325074708058754070307070405438885070201
10007050408040805030000070500050507000003050700060307040002070006050600000006040201
10254050406750203077767080407450806234606087805020507070502063255040735572804080701
10000030808000605000300020800000608000007000007020005050600020003040000040004070001
10867640805046208053702380704452704080656853654080635050466330405037588080702056681
10700030806030006020005000700000400020006020008060600050700000403000006050505000001
16204230406040486030238072283570326027702080806030203730306778803077706080673378401
10005000507000500060400080000060005000300020802070700040703000605050008080003000301
10546060702857536270503532365070607620274430642044466080703064403030734040205080701
10400080600000000070400080005040600050600070005030005080008000006080000050705030801
10504420752340283020803030802036583027804066607050703025673583602020426588408077701
10805000800080002000405060702000006000004000600070206070008000303080400000200020001
10702086584053802633624030705586403540684240807460337080802680504077803740606060441
10007020002000700000002000200000800080000040300030007000200000703000003020502080001
10442050406630805634602743708240526080572250706075705038388652506320238040807564201
10007080700040800020005000400060200020200060304000803080000000600050005000205000001
10653040866020708030423860606060605436706070406677204060746250762050487288408062881
10200070006000506040000050705060004000605000703000005000700000800080800000304000001
10506328503362307024264030602068556070404454735045433640504488807870403370362064801
10200000503000208000600030606000000020300000000080000050205000005000400030003000501
10806270303075202020506330807482336760405787522886745020302032663573853055307242601
10500030006000004020308000400000804000200000500000005020604000700000200050008000501
10643558535632583050404070435330508020228428402076505040304470303640702563562070401
10008000500000500060705070000070606070007000606000607060703000708000700040000030001
10506030808870704750702022446060305063288050608030606020407077606068385070364083441
10400070804000805000804000800040007000600080003040202020806000006000000070006050001
10544640405026574080805830606826442670508540433040304060302572342857708456505530501
10005000407000200020805000407000000000500050605060300050408000000000200000700000201
16604054705870704622204026373042278458344020304030375367704050248320526446408656301
10705040300060005000505050007000000000003020004070000060008040800050000000700000401
10602030562020652070806060508650644880404060848053708030268040604063827520378040401
10802020400020700070008000400070000040800040008000204080000030705000005020008030301
10302040507236503466683645777085578080548255637630232034353242702066407048302070801
10402000407000800000000000007080600020000020000080006000000000008000700070006080601
10508050304030806463223442702060702037455040767042304465666472708340786520224770801
10004080600070300000600000800070007000006000202000400000005000400070000080000040301
12546060843380833720302620205458552063406677408060843554305030206064403084348072601
10006030000020002030005000608000004000604070005070700050005020205000604000008080001
10823067468740205044847040607060205550602040263680806020266320703760386743768080861
10000020000060808000000050307060800080400070000000206070000000500080000000300020001
10646850658060204583605740605040566070368653648276702080378776382047634660506645501
10600030002060300000300040700070600030000000000000005080000050008000000060300000301
18705032206055506570508050247588802586222045732458435034608032302872743080442560501
10007060007000202000408030000000708000008000000000707000408000800070007030000080801
10237060307760837025408048524670405764502087504440403050802850547030807083225220601
10400040700080000040007000000040500000005000200050004040700030008000207040700000301
10846340205046724480566450884030235350838580483076854260457640607242807080805862301
10000080405050002070600080800030600080004000500040000050000040300000006060400030001
15356040703080503020705067307270736080507074452570547027482070404744582060505070221
10000060707080600080604000006000400070502000000020005030003050200000003000807050001
10764750205040503480806457782050602540707578806038204050207070567022822075863020501
10300000805040800080400070000070800070800000502000304020800020003060006000300080301
10608080606030224670605050737784328068785330504840204040606642207630507220304456701
10807030205070000030702030000000000070004000803000505000200000300020800070407040001
10305055802023346040838064685888777040808560735026605348603380484080246054403050401
10003000707000508000500070005000008040600040800080002000403000303040002070005040501
10232760605530807044307240406023307060802044705320587020552058304058703040754070521
10000060408060002000800000306030008040404000002000800060007000003000805000600060001
18322040506056448558236784203760244070266458422042405085604065273780304422605086701
10002020500030000000700020008000400060300070005000007080005000000070700000608000501
10853060477880304430602040547050704370205080602843344070576763522560867780705280701
10800030200000600060706020000050700040006040700040000070004000000000805000200020201
10408540406658808370203043764070526032878320507074765665308038836442303075834023601
10002000700000306000407000003060007000600030404060000020004000000000306070004000601
10635084234630304057402624808727665864205060807070606078222078707320204080407650701
10708070000020707030008000500040000000005000406000402000002000800050006040800000501
10603020607070508050887040848070502685223488383072507748604320368034636060504862301
10007060202000403080004060000060802000008000003000700000300070005030700050300000801
14463080575564507026508075733230225055506043507658327080763027202070705430767250501
10000070000080007030005000400050007080002000600000003020008030008000700000400060501
10775342225075244050306584604077208040852460804586307545384050238245202438606720701
10000000007030000040600030005000800020000000500000800060000080005000700000500000501
10643353206060325520782030442580536487786238745568577040247766438060574336662672701
10000000200060000000600080000020000000000000000000000040000000000070000000000000001
11111111111111111111111111111111111111111111111111111111111111111111111111111111111
