11111111111111111111111111111111111111111111111111111111111111111111111111111111111
10000000800000000000000000300000000000000000000000400000000000500030000000000000001
14752037404086632640458530802056423775608766234750606028332780553070802088326276501
10000070006020000060003000302000007000400000000030006050000080400070202030000070001
10603740206060777020346028302025608560503447426088256760808080705240504420864070231
10500000706020500060500060005000700000300070006000000000205070300000500000500030001
10535733444035806376506820308320654575426570603550657542702030847785864752604834801
10004000006000308000700000300050005000000050200040002000003020600060000000004000501
13705060208070602040262620832078205085684080255047406048775020302040607578884020301
10004060404020207040000080300030303000008020800070302020002040004050700000008040501
10826040605820602064345070604340608355302088506040807050203025565030548474305070401
10000080606000407000200060300000808000007000008070004070200070008080000070005070001
10384650407037606078607660503455605060856744752040653080353870404055623080602065481
10700050808040003020005000300000700030003080002050400020600000604000006020704000001
16302720403060674020755067283440227087203080407050608660604325808033703020338583201
10002000208000300070600070000070002000800060507060700040702000805040004020002000201
10477070707267868330304385325080706880852420766077433050703073405030233070705040201
10700030400000000050300020005030600030500030002070003080003000007070000050807080401
10304880866760747030603020508063236054302028703030404074584572805080472324402045301
10805000400070006000505070202000004000006000800020303020007000306040600000600050001
10308046462032803522727070308682703480665320303660643030404470508033203530305070631
10003060008000200000002000600000500030000020600020006000600000204000007060302060001
10226050502520707773702536302530347060342860808065308032343622805780327040506356201
10002030400050700060005000500080200070400050706000305050000000200070004000805000001
10664020857020805040687740403060607775603020803668805070435540228070454352507023581
10300020007000402050000080204020004000403000603000008000200000700050300000504000001
10504458806376604022463030208087875040203784886073756620607625606440802760255055601
10700000606000402000600050306000000060700000000020000060604000003000300070002000701
10706380408046508050205720406655463850208227788585343020802046887686256037805582701
10600080007000008050604000800000208000600000400000002020505000800000200040004000401
10323255372262737060505080765520204050264447803023507030803740506860402534826040201
10008000500000800040407070000020703080003000803000805030603000708000700080000070001
10803040506650502230807062734040402062643050507060503020704077805036837020558038551
10800020308000507000608000700020003000800030004050506070204000003000000080008060001
10353550608065547080602520504667467440308280836070405080407877468757408453507420801
10003000608000700050406000308000000000500070207030800020304000000000700000800000801
13803063507630204677606084786032488836655070408080747368306050273570656527705586701
10307020300060007000805060007000000000003080002020000080003080500020000000300000301
10808070627070337030306030705450473860507080334062603080784020205066736870878030401
10303040500080400060003000300070000070300080002000207070000050304000003080006080201
10502020202685405642244847764028537040677654452660878048343682407078205022506030601
10603000806000800000000000007040600050000060000070003000000000007000800040002040801
10502060402030707467535852603060308077345070752073202386428488307440447750386870301
10008040300070300000400000800080007000006000305000500000007000500020000050000070201
12562060786640286680408680807847557062407575203040338327703050407047205085365082201
10003060000080008030004000204000004000402080003080800020002060302000406000007030001
10255026672420404085357050207070308360607080237360407080868760206680832745345080521
10000080000030307000000060702050300020700080000000202060000000500070000000600050001
10374470548080407237602840608060723060286565676886807070442563655053232870404354601
10400060004060800000200020400060700020000000000000007070000060002000000030300000201
18206076603023302340603030445344702345676083835378344083605083803287262020825670601
10006060008000603000507020000000408000004000000000604000803000300030008040000050801
10746030403760332067306025345320706483204052203840303060604460338040607025647750301
10500080400020000020002000000050500000006000800030004040400030006000803040400000501
10488440702084575550586320356020778360723860635066683640225560704855405060408574601
10000050806060003030200060200030800020005000800030000060000030300000006060300060001
17627030204050706080604028203770274070705038567550448065387030805787226080506080271
10000080405050200030703000007000200080604000000040002040005050500000006000702060001
10526260808020808770206848384070702470605444603024806040503040825088362044233080501
10600000402030500080400020000040500080600000302000505080600070006050006000700020501
10202020302030878330704060837238337075562670402720805020706744303670304850802782301
10805030305080000050507020000000000050006000502000504000300000800050300030408030001
10307085302083868080454028274442525080804220354074708737502640764060653053503070501
10002000503000506000600060008000003080800070500070003000404000702070006060002040601
10484670304350604047308880302028306080206044203340246060283038708035305020836070671
10000060202030005000500000805080007020304000003000800040008000005000604000200030001
12667020407058462247683885808840228040337854388033806073808078324350204287607055201
10008070200030000000200030007000700040300020008000003080006000000040700000502000401
10282050355620505860502070278070707330707040504827366050256338568880658820305480501
10200040500000800040308050000040600060008080800040000020005000000000606000300020601
10703830205344402560302043423080835075237240407063345223506055447343302043266054401
10008000600000603000803000006020002000500050806030000020008000000000507030004000501
10272037727320607053205582205748424544408060606030505046337065302430404040704880501
10603080000040207070004000600020000000002000507000508000008000400030005060400000801
10403060604030305030746050745040205546743562828076205855208630783065568030703537801
10003070202000706060003080000070607000005000002000300000200030004050700030300000801
14454020377434805044504053334540325055507085205838732030564073303050802480646360201
10000060000030006030004000800050003080008000500000006070006070005000800000600050701
10868245453063826020206568207042203070483360302473505728242050652778408826305750701
10000000006080000070200040005000600070000000200000400030000060007000300000300000301
10354623808050624220655080824850562356552722235227483080727548344060628846376282301
10000000600080000000700070000040000000000000000000000060000000000050000000000000001
11111111111111111111111111111111111111111111111111111111111111111111111111111111111
