11111111111111111111111111111111111111111111111111111111111111111111111111111111111
10000000200000000000000000700000000000000000000000600000000000700030000000000000001
16872026306084446270242820508035428742506237745540507047837820543080208034752843201
10000020005040000070004000504000007000300000000030008070000050300060303080000060001
10603670603070542030733048504084307540703428225052462530203030308860805720576020351
10300000605080300020500020004000200000200020004000000000308020300000500000700050001
10478432484063603428606440405650436655873730703370577333607050254284577383308538601
10005000004000302000800000200020004000000020500070005000005030600060000000006000801
16404060202080303020744320522035305027372040524044305074434040608040403546328080801
10003040608080202020000030300080805000002080700080407080002040003060500000007060501
10452060503650403065685040403540802432506058208050803030207052286030675228805020801
10000050804000605000200030400000302000002000002030002050400070007030000030004030001
10486720408067808056406830606527504040327567482070736040566260308028486080605032731
10800020205040006080006000500000700050004020008060400050800000302000008030808000001
12805760603060558080878068477460665062403060305070506830603538608046703060556644501
10007000403000500030300080000020007000300070507020600060505000407070005040003000401
10325060808765526730303867657040604520234250274052884060308027405020533030504020701
10700040500000000060800060004020400080200060003070005020006000006060000050203030701
10602530233560586020608030304045728038707026202080402024826467202050262428706072601
10305000200050004000704020508000004000005000500060704040007000307030400000500020001
10504067355043207333664080807257408550453450508750843040304730406037806250402080671
10003070003000500000004000500000800040000070800030007000300000503000007080307040001
10664060207320608277403225707330467020728820802052203058835283302770562030802778801
10008080300030800060003000500020400080300060807000404080000000200060005000604000001
10243060266050302050534740504040606827406070808578206060837560325080828838206068441
10400060007000705070000070607070004000405000307000002000700000600040300000808000001
10507456607353803023865060407087283080505784438047328880407254202320304380376034201
10600000607000607000700080608000000060300000000020000060604000006000500070006000201
10305750406085605030605280807443844570508438425357777050606058565363563025504846801
10200050007000008080403000300000203000800000400000004030204000400000200060003000301
10332237753587724050308030254750408060573235504024404070206650605550508766756070501
10007000300000600080602070000070704030004000703000504080408000603000400050000020001
10608040202460803450507082653060206056664040304050603080807024504046674030253085361
10700070707000708000404000800020002000400060005030806070402000005000000040003060001
10485240807088538070706850604282563770507370672030604040207463865826503836605370301
10004000307000200030608000406000000000700030207020200020608000000000800000400000401
17207055307630305876402032648057555646282020808040573643607020322680764358703443801
10805050400060007000707030003000000000008060005030000070002050200020000000700000301
10803060822030226060706040304870554440204020357034505060358050208027655640626050201
10605030300050800030008000200060000030600070004000506070000050208000006080007040201
10806070402828805232337632253022636070274583885450235022558583805026607038506020301
10603000604000300000000000004070300020000060000080005000000000003000300030002060301
10208050704080706654372736702060807087646050225042806768855466603830466250723840801
10005030800060300000400000500030002000007000803000500000002000600070000050000020601
12468080448340857230306580207742732035203344506050735763406040804025708077347053201
10006040000060004030005000807000004000808070006070400080008050406000705000007080001
10838073328770307023738060603080302460306070287680303060322470303330734783674060531
10000040000040506000000030207040700020500030000000704080000000500030000000500060001
10354860433020807742506340704040476060886434845575208030433545324072884750507638601
10700060003080200000300080700040300030000000000000007020000020004000000040300000301
13807083805054403320207070277772708475853056572743836048202044506488435030367540301
10003080004000302000507020000000506000003000000000705000304000500060002060000040601
10858080306550388067405024358220303756403028807430707020803650355080807044848220401
10500050300080000030003000000060500000008000600070002040600050008000504050500000301
10575830508038848350268580233080573650522640257075277770788240305324204050504566501
10000080602050007040600060500020600050002000200020000080000070300000005020300020001
15836040402040408060306088607780628070706063325680728062477070705223887060705050751
10000060708080300040508000005000200080205000000050007020005080700000003000506080001
10847430706020807880302236636080707320806343405084205050505070243057646024477060301
10200000505060800050500020000040200030500000805000804030400030006020002000300040201
10402020404030527360505030655743576067282560404370605040308777205250305320403678601
10406060807020000050302020000000000050008000506000708000700000400060300040802080001
10307023202085373080885033878745465050206350354032205562405740246030622088607080201
10007000708000608000200080003000004040500020500030006000403000405020002060002070501
10577330608740306087208260802072502070704025304320225070286023407082203030877050761
10000080307070002000600000404040002020804000004000700070004000006000703000600030001
14663020702083524632522234806260576080585786467025706022406087782560403857308056801
10002020200050000000500080006000800030300040003000005050007000000040400000707000201
10366080772520707380706060334050304420703050703862783080788425787420574360703440501
10800070800000800020202060000050500050003050700030000080003000000000608000300070701
10307620502266802420203047624070866072235850505073844334302037825435307085323047401
10004000200000403000804000008050008000800080303020000080004000000000202080008000401
10228085775360606084604255806577745332205080208070302083535087308550505060205850401
10502040000080308070005000400040000000006000303000708000003000400080004080500000801
10503030602030808030725030847080502467487227388042505355402320247056652030807537201
10008050404000606060008040000080504000005000002000700000700040004060300080800000601
15545070328766503028205034358220585048803085606846724050843056406020405320627340501
10000060000060002030006000400080004080004000400000005020007050005000300000400040701
10883542754053772060803733404045204050864680804623208285387020422686408333704250401
10000000005030000030700040005000400070000000600000300020000070008000400000300000601
10633423305080556660578040236230645522568835268683864080647574763070846858656877501
10000000500020000000300030000040000000000000000000000020000000000070000000000000001
11111111111111111111111111111111111111111111111111111111111111111111111111111111111
