11111111111111111111111111111111111111111111111111111111111111111111111111111111111
10000000300000000000000000500000000000000000000000600000000000400060000000000000001
17657087403055566850536430206073672282803666443450702037575770876030506086358687601
10000030003030000020005000203000006000500000000020004030000060600070706060000060001
10707250505040637030274027507087807860308576237042728450807030808680505420623060821
10700000203020700020500060008000700000200030002000000000804040500000700000500030001
10733486585067402383608370802880842447532430807780722726307040844874233287608744201
10007000004000606000800000400020004000000080400020008000007080600050000000002000801
13802050605050307030438220234052305068446060285083407035838050207070407368676080401
10007080504020505040000070700060407000006080600060506020003030002020400000007080601
10488040208780405064347070507370204584705064402020206020706056536060425377802070801
10000080704000706000500070500000308000004000006070005030300070002020000080003030001
10387550405042506033802330807277804060333465825060353040546280402088224060706036321
10300050502030004040002000500000500060004030008050300020300000608000004020504000001
17603360608050325080266064867270222046703060606040702280204323402072803050644276601
10006000704000200080800020000030005000200030506020500050304000606050007050002000201
10684040607677276820205634568080304430458460635083755040403087708040735030302060801
10400050700000000020200070006070300060200050004080005080008000003050000040806020301
10408570242460832030702050807076786058508063408030703082857477207060476548704037401
10504000600040006000605060304000004000008000400030606060002000204040300000400070001
10606022285068407486788070602337706850357270404260555050804640302067802350304020321
10003040008000700000002000400000200050000030800080008000700000204000004040205050001
10478070702570203836307686403840874040877870508064502088685425404830252070603726401
10005080300070500060006000700060500020800060708000703040000000500060006000707000001
10366060823080204040638340203030503748504060607425406040357860237060256365603065741
10500020008000604080000020406030006000705000507000007000400000300080400000402000001
10503755404888707032675080706065786070402336837084488340308567304820707240846072701
10800000803000202000500070302000000030200000000060000060205000003000700030006000601
10205430503087504030308660408542273860207585754547633040503063227853524047704848401
10300040007000002070706000800000706000400000700000007020808000300000500080002000401
10337375486237845020802060368440302060353663403028307070305360803620603288645070501
10004000800000600030307040000070508040004000508000503070806000603000500030000030001
10403060804720304420302082877060204043775020703050202020704034306064472050284054271
10700040408000303000507000200020002000600050006080202070805000003000000050004070001
10255720507064344050603830306466528740606420534050308080302686264568202423604560301
10003000704000600040204000203000000000300080404040300030403000000000700000500000701
15704043205880505684404022728026335286874070302030544557402030777580683835407243401
10204080200070005000204030006000000000007080008080000040002060200060000000600000201
10708020356080373060403080206750836550805040325034404080684040503082658540425060701
10706050700070800040006000500040000040400020007000403080000070408000003040007050801
10702020208225203474828285772084358060755746367280277056752445202062502035307050801
10404000502000700000000000003050300050000030000070008000000000008000200020003080501
10706020404080803682378777806080706033675020836037203762465226705440573760674260201
10008020600040400000800000500030006000008000807000700000004000300070000060000070601
13522050235640447580607570505885257045508363403040884836705080404047706025678043601
10002040000020005060003000504000004000405050007050500060007030406000404000003040001
10272036763860302068623020807080302640403030464630502050454820406620623835287020451
10000020000040604000000080205080500050400040000000806050000000600060000000200070001
10746460485080208885402340406080435020565853387688706060466433525075233780505335301
10300080002050200000700030500080800070000000000000005080000060005000000020700000701
17408026303052802380402080782762303485472027826655848027504048207346543050623540701
10003050003000805000507030000000205000004000000000507000403000700040004030000080701
10462020407250653086403027865250207457602036507370602050304830675030308074845320401
10600050500070000070003000000060200000004000300020002080600050003000308020200000201
10556530803044545650827530475040323840757240347046373270555520407222502080604626201
10000040808020008040700060500020500070007000400020000040000040400000006080300070001
17544030208060703060607023504830655020404078272740472024222070808857478060305030841
10000030304030800080203000008000500040305000000030007030003070700000005000703040001
10445450802020202670303637537080203420206283205047307040608080887065276057345060801
10200000706020700080200020000040700040400000703000805080500020002030002000600020501
10402030302040822570305080844878557065424530504280305050708446705220508670706367401
10308080305040000020202060000000000070008000206000708000400000400030500040407060001
10206032302085787040243022724842868040606570372067803345206750237030833085403060501
10003000306000803000300050006000007070700080800060004000404000205040007080005020801
10455680404880608042508440504052204040606065602720488020867023806033807080683070751
10000040306060004000400000405070008060408000007000300050004000005000707000600070001
16248060403024472275644256508430845040673226458053202055405083847630304454405055801
10002070400030000000300030008000400040300080007000006080006000000040400000603000301
10538080622470305270406070285080304350802060203778784050275728624430248720302580501
10400020700000400050805040000050200030007070700030000030006000000000406000300030301
10707570506466802480706027453040865033644430806085743785606063228646506037357088501
10002000800000806000803000003040003000800070506080000050002000000000703070008000601
10754034368730707065302528307687454287305050702060407055525036406520506040703260301
10606080000060603080003000600040000000006000205000703000007000400070004050600000201
10708070808060803030323070478050503268433535434037606874303660873038488080205258301
10002060706000608080005050000050505000006000006000800000500060004040800040700000701
13722030656565305074602035547830775024602085402734424080423054506070607530346470801
10000080000080004050003000300020007020004000500000004050004050002000800000600080801
10783482748074436020805258608043406030378540403353507264572070587235708424307240501
10000000006050000030200060004000400040000000800000500030000080003000300000400000701
10443444203040333750434020573440627735674652346828283060867237476050786255472452701
10000000200040000000800030000080000000000000000000000050000000000040000000000000001
11111111111111111111111111111111111111111111111111111111111111111111111111111111111
