11111111111111111111111111111111111111111111111111111111111111111111111111111111111
10000000500000000000000000500000000000000000000000400000000000200070000000000000001
12646063506064748470685280407075375577806363658230407022736360833040808064282734301
10000020006030000040005000202000003000500000000020006060000080300060403030000080001
10503530203040432050678036605023603680506828433055855570806050804240508250528020781
10400000806020400060700040006000700000600020008000000000602080500000800000800070001
10636275735032407854405320407530832374426220708570388274204080375477548544505832501
10005000007000505000800000700020003000000050200030002000003070700020000000004000501
18802080304070206060267460642037205026226040657052306072365070706020805376326060701
10004040605030707060000050400060203000005080200020402070003050008040700000004040301
10284060703680802055766080203260602623306047305020606030808072664030687253608060301
10000030703000503000500040600000707000004000003020006080500030007050000060002020001
10673780207024302086704670703336208020763488675070622060655350603032325080808075631
10200040302020008050003000300000600060006020005040200040300000802000006050803000001
18403770402030244050326024648830336036402020508020406530807253603026402060567566501
10003000304000300030300080000030005000600050804080700040602000705020005070002000201
10582080703483666650805836882080705440373440666052745060605044508080468030305040601
10700020400000000040200060005050600080400030007030003060007000004050000020306080301
10502280873670326020202030305026463084503072602030505067882658704030525752803057401
10606000500080004000805030403000007000003000500020604070003000202060700000800050001
10205073885066505725332070505567607470363280308460562050507550705032807450707080731
10004060006000800000007000500000700050000080400050005000800000707000004020405030001
10862080504820608243806775604720854040427430404078406022383562506280484060607265401
10008060200020400080004000800080800030700060603000507030000000400040007000705000001
10876050258050304080838630507040604442802060507386205020634620275020738226503074451
10600020008000207080000070806030004000707000506000004000300000600020600000204000001
10404767504227202032276020805033664040303525226048667420304672703430202640528044601
10400000507000802000700040205000000070800000000030000020703000004000200020005000801
10608530502045203080207830607573822880204787728248862070607057736436442067203728401
10400080004000005030303000800000206000200000600000004040203000500000800030003000701
10768283822422337020208040622880306060445555406036808080302720404870705343274050801
10007000800000400030306030000050403080008000505000402070605000807000200080000080001
10508040608480404850503082422060702032574050304060408030506042403048282030235033541
10300070605000705000307000800030006000500060008050708050307000004000000060006020001
10724460506084437070407680605833668570402860256060204040808448524477505443407830801
10003000405000300020407000503000000000700020206040200040806000000000700000500000201
13708027506660507463703034674054624433562060405040684258608050233880572423305272801
10408020600080002000608030008000000000006080003050000070004030300020000000500000401
10205050267040272060205080803360288850605030856045606030365060506074263720766080801
10304070800060600030007000800040000020300050005000503080000060203000008070004030501
10503080304237806445353352682023636050224263778630627042345727305085304064705060701
10707000802000400000000000007050400020000050000030002000000000004000700030002060501
10506040207050808223843474207020202033248020853044407467224863408370235260867250801
10002030300060200000300000500040005000008000305000700000005000200050000020000040801
15588070742880772870703650808836464026605383503080275825207030507076407042868087601
10005020000030002020006000204000006000203030003050600080005030403000202000006080001
10647037343680204043723040705040602320407070523430208040483780202250235282643030521
10000030000030302000000080708040600020600060000000607070000000600080000000800020001
10866470526030407625604340505030585080242226735346705070842486254052862320403274601
10600060005070200000200030600060500040000000000000005050000070007000000070300000201
16506078604067807440807060348586507888353042382746758035205037206442745020766440201
10008080003000605000307070000000303000004000000000505000602000600070002070000020401
10736080608880872065506045578250606362302054202740505030305580273030804032874320501
10500050600080000070003000000020500000003000600060008030700040008000406070500000301
10338740805032865880575630653060536750885330534046825430522640605387704040304537801
10000030803020007030200020300040600030008000500020000070000020200000003080600040001
12577060403040205060204053504770268060505066257370772063426070703745355050807080241
10000050402040800020807000008000300060302000000070007060008020700000008000503020001
10643830704060508440404878745050705450508682208052406070705050764035338054445070401
10300000807040800020500020000070800030700000603000505030600020005070005000700020501
10508040802060765370706080868832776033552850305840602080203674406440803870605464801
10802020602030000070505080000000000080006000303000207000700000600060600020803050001
10707086704083386040574043245323422070508550773075606356705650273040556057508040701
10005000306000406000600070006000007060200040700070003000805000404080006040005080501
10562560202330703052403680708078602070407052704430733040538082702048704030434060541
10000030304060003000600000203080008020705000004000200040008000003000302000700070001
18744060606036763526888372502860244060855576625076203064202052843680205257306078601
10006070700050000000400080008000700030500070007000008020008000000050200000604000501
10664050325220202330806070465080304650307020408655857070276648373640872260206660701
10700080200000500060202020000040800050004020400070000070006000000000205000600050201
10205820302587408220206028472020834078684340605027678846206037677568504054227045201
10008000800000507000803000007050007000700050205040000080005000000000205040008000501
10376083366720804066805662403226836623504080304080403076647046504680303040503280201
10606070000070208060008000300050000000004000507000703000004000600040006020200000701
10704020706060408020777040647080304434348336256054705663305840235078825020802237501
10003060705000405040008030000020807000008000002000400000400060007020200030600000701
16654070648732705065707055865870287053208042805834826020874044404070703840583820301
10000020000030007030007000700040008060008000500000006030008070006000400000200050701
10557735763057663040406253803066806040362770508863502335288040633263804784604260801
10000000004040000050400030008000700080000000700000700080000060003000500000800000701
10883478205040435460877050568670666534747535542363473070682638772020235453234266201
10000000700070000000300080000030000000000000000000000060000000000030000000000000001
11111111111111111111111111111111111111111111111111111111111111111111111111111111111
