11111111111111111111111111111111111111111111111111111111111111111111111111111111111
10000000200000000000000000500000000000000000000000500000000000500040000000000000001
14244062204025753670324860603078832356502322442250808052375330235020302047853338601
10000040002080000070006000803000002000200000000080003070000070200070304040000050001
10408540602060527050236066306028406530308373265042454780602020502720207460255050851
10200000607030200070400060002000600000400080005000000000605020700000500000400020001
10376547462043807778706760408580622288647260804820677362206040324824744233407478701
10005000003000506000300000500020002000000020300050002000003070400040000000005000501
16606080504060204040446380788064203045283040365087307053847060502060702783758060401
10005070202050506070000030700020202000006060700030604020007040005040400000004050701
10558050506570707036438060408350702225605047207080802080305026856080522744502040801
10000040606000208000200040400000204000008000008060007040400030005020000040002080001
10884570208087504027805740505246403080573457568070882080763240405082747030303048581
10500030407030007030004000500000800020003030002020800060500000607000007050306000001
12808650802080586040762042732250232074507060605040207820605586304083508020867386501
10004000603000300040600070000040005000600080408050700070605000207080006020003000401
10627080503728888540505857724050308640527720784027424060206086502080687040806080801
10800040700000000070400030002020500030600020008050006050004000008060000040508020301
10206750742330436050703040505027544076706028307030504088655433507050546734208064201
10407000700070003000302040502000006000004000400030203070003000207020800000600070001
10205064584043407428663080207272704880324420202760537080308370505027402560406080281
10004060008000600000006000600000500080000060600020007000800000604000006040806060001
10843060704760602276206854304270252030884860505076604036773323703740536040402387601
10005030300030200030005000600070500070700070405000807060000000200050005000408000001
10764030835080605080565670405040706374302030502542404070283250662020737583805046781
10700070003000306030000080805070008000407000807000007000300000200050300000504000001
10703858703333804036337080707078243080307557223054756880406757303440808650442065201
10500000203000307000300030705000000050400000000060000040303000007000600080005000801
10306660603058808060205730306585883370403424262747668030706037585557582055205836301
10500050002000007050206000700000404000400000800000003080404000600000700080008000501
10547665685775572070808080754760603040848252803075708050603850804640605476342060701
10005000200000400080403040000080604020007000808000707040506000207000400030000030001
10402080608240808670804042674040503025274020608060204050708066405022543050654037741
10800020506000405000303000200030007000400030004070802060502000003000000080006060001
10274870205023275030206440603544235720506650858020805040802647768678808656606870501
10003000302000600060504000208000000000300080808030800030704000000000400000700000701
18404052503880605563505036358033765875573030607020557485802080266370242353608683701
10302080400020005000406020008000000000008050005080000020007080800020000000700000701
10808040842080332070807070304470386640205080558032603080587080607082567560383030201
10502050400040400020004000300040000040400060007000707020000070508000008040003030401
10804050306845403468743678788048752020445444485440358066556767708067305087306040201
10404000505000400000000000004040800080000050000060002000000000003000300030008070501
10508020208020803847638777703030308025623070377044505824275532603720222470564480201
10007060400060300000600000700040005000003000704000800000004000400020000030000060201
16872080577860647870204440307587683067507484504080738833205070605064606052476034301
10007030000080003070008000702000002000202060005030800050003060308000405000003060001
10433032666380403027572080406050606270405050623850606030422250402340644375548040471
10000040000050404000000070408080600040200040000000602020000000300030000000300080001
10554250886030506864306720806040553070332744575555708070647463777064645360707524701
10800040005050400000600070600030300080000000000000004070000030005000000060300000201
18605052703076302360302080385343402275577036263257278028407043304845344040232660201
10003030002000802000702060000000207000002000000000207000607000600020004080000030701
10228020602760253026507037765370502438804083804240406050703620242040705087425520401
10700080300050000030004000000070400000004000600060004080300060002000403020500000201
10235240202024583540343330754080633420664860773084455420435840608586606030403276301
10000030602080008030600080500080800030003000600030000050000040200000004070500060001
12365080407020807040305035802730284040406075425340256073388060704424486030203040421
10000050505070500040306000006000200020306000000050003060006020700000004000305040001
10682580504020202320706736426050805640306858204084208070507020372022484058343080801
10200000308050800060800080000030800040200000302000503030300070007050007000700040301
10208080608050288330507040225678646032824450503870505080606875508380202350702343701
10504020308050000030805070000000000020003000403000307000200000400080400070404040001
10705087302064847040546056846755728060808870365046203374602670745040363052302080601
10002000304000706000700050005000008040500040200040006000505000407060008020002060801
10365870802250802032302360306027505020808037505750646020682077407074207070532020331
10000050307030004000400000205080006080405000004000200060005000004000802000700070001
12866070205025652286324636306580226080453244823034808078202034458660507573408033701
10003030300020000000700070008000400040600070008000004060004000000060400000506000201
10526020754760805850805070556060302880503060502733888020472854483530334760606330501
10500080300000300060802050000060700080003050500020000050005000000000407000500020801
10507830404734403360305067532070346053273660204072584646604064535672806028775044501
10006000300000303000702000002030007000300040402080000020005000000000707030006000501
10674056587440607043803688302667753327805030508080808085882026606820703070406750401
10603030000080208020007000500020000000006000504000306000006000200020004030200000801
10602080505080204030842070337050304845836463734037703836205840523032725050402822801
10008040706000407040005040000040608000002000002000500000400070002080400080700000801
14262040248273408066705036868840826067804078805846273040727062305030606730253560501
10000040000050004030005000300020002060005000500000002020007080002000700000800070701
10635338747082367020203876202065608050256830705283706836646050373445607562502660401
10000000003050000030200070006000600040000000600000300020000040003000800000300000801
10824482208040874530726040368520777635542278463626557080446485887040573673728274501
10000000400030000000300020000060000000000000000000000070000000000080000000000000001
11111111111111111111111111111111111111111111111111111111111111111111111111111111111
