11111111111111111111111111111111111111111111111111111111111111111111111111111111111
10000000002000000000000000003000000000300000000000000000000000006000000000000030001
18804046607042428558707640364078408060302037548084233626753263606020346460268020301
10605040002000000000300080000040007050504000008000300000000000306040700040006020201
10707520857336284820707020646470722450808747304020703078676780504060405056503230501
10500030000000000000202070006000800000400030005080005080006030200030202000200030801
10426060204634325278567040408027204724382360752030342570407070234564505020406080701
10600030402000000000600060207000802000008000200070200000700040600000604020605000201
10407530438083244650806060503720656020402063808888807083467050305530308640703426601
10200020002070000000404070807020000070800030600000007080006050302000805000200000701
10852070405030482367208060307027883430426670807023777064706030805073808036748520201
10000060700060002000008040200080003000200000805000005000002080403000007080003000701
10372520705564652040266070354488704064605366402062708787307040302082368020808780701
10002000600000200020300070000000003000204000204000200000402070006000002000200070301
15602063888827507224503077366767674050303420405570357640708038774440802862726020801
10006060000000302070005000500000002030005000300050000060807000000040600000300060501
10577050738450703050807870604228402822602063405048703060727772777073666750603373801
10300020600070805000406050400020004000807000608000206050300000200070006000200070001
10305070208070605072807080557040876060848880852320403050402270604050407058826030331
10402030506060008000700020008070004030000050002000206020800070208030300040005030001
10406050707082757275603286703040505426253034208087502030544060704040842520505028801
10803070005020003000502000700020800000006080800070005040204030008040000000208000301
10406665453080303060203080333040752256307050204720753060402083653635228054825860701
10200000006000406070500020008030006000404020400040700040007000000020004040004060501
10332585552475808060326250607864602080508020837040308423666627426020604260505050201
10000000500000002060800020700020005020800030008020800080000050000020507000203060601
14256030608236436080703050674030655040843247308070204040376040405860208026305080401
10006060700000004060003020305020000040000000206030503030800070200030604000508000601
15407720503383406030768070603020743068473820502020407080605430884220707680607680701
10006000506000700050006040805030007000000040006020208000804000400070600020500020601
10304053553050644578306060703060706472245245868750668243406042203070706040222043701
10702000000050007000006080003070706000400000000000500030007050007000605070005000001
10807567666878703023628020357068604050603088276887308030225050436382723060504033521
10200000400050002060000050300020006020003000005000307000206070006000005020704000001
10752267605060265080708880205820475052478855704080406727205086203026605083705088401
10400050003000400040300030304060300080000000802050200000004000302000508000007000501
10804040606588608580506230806020806252472380547060503444557040506730806483536040201
10007000803000006000407000808000704000000040000050700020006030707000800050003060201
10745043608078455076838076504482503060645034646870876020708030205060825053207050301
10007000402000400070002040006000200020002060000000400040703080505020008000805030601
14603242707040607484303080623060767833705050202687505833702050407060208870208260801
10003000702030800000607070000080200000702000400000700000003040400030802000700080801
10524050807030447840204026744240727740432455773330223028607060457323303050805050301
10600030007040000030004000000040500060500060000080008000305070702000508030404000701
10204286654020654037686870548060207080804070833050507870788080802050435060436386701
10200000300080007000000030400030003000308080500020300080700080004060000060007060001
10606830403887402624834070706226347248657050705264644057207087556048808627608060321
10403000706020004000003060400000008000005080800000000030004000003000700000300030001
10774030708070402070278030588827207075405088806335533660402276254550603330602528301
10700060508000608080600040003000705030005000704000000000804000003000602000406000301
10505448704438247020504530203040604030765480548028334658256072608026548036402060401
10600000500070000060200060200080600030800000200080000020007000700070003060702060001
10334340732080706044674060375020802740707074707050753020205060404770307060602050881
10000080007000206030000070003070202080005080005020002000305080500060600080006040001
18487073506523305050533772306660206058766850703084802677708540286040863276343045701
10005070008000003020005000408000600060002000708000800000704000800040200000002020801
10302080688574745068602770308088533680203062737888507670805030202280207435307080701
10505040800000006000800000706000000080307000200000800030400050600060608000205060301
10528030743378305630304855302226607070503070703440572860433267542060604036208040401
10002040004000006060800000500000503000204050800030000000600000003030005060007070001
10404047203077577030782272426320233754803080645046835482645286406082788060256073201
10604000604020000050000000000040000030008080002040000000000000802000000050008000401
10603380207020308265557728272050376040548872745040586545236440702344826885305650271
10300020800040200000000000200020500020000000800060400000006000700000000000400020001
10836030458480675380334460702685806067437370702770704436808036632648608250864037801
10007000200050000060000060400000407060000030400000708000805050000000700070000060001
10204385707060586078543060268040505040507020644074704040703085202450704054885260841
10608000007050004000006060008040503070304060003040008060702000500070407000000030001
10602078248063724054802877402580703250388027603760276085803030252880304662434078701
10300020600040007000202000303000300000700050605000700060005050000020700050003060601
10478850603380405236806040234030756578304380402040607750728060254040203050534080701
10300000200000200050002080000080004000008000200050300080306060008080706000700040701
12305087542734234020223040463340586023642060867420202020305030763060603273702580201
10008000000080007060300040000040800080000030300000208000300020500080704000500000301
10504855485067204020705062854060808460408550506275746266425060606470605020402745501
10200000007000008060404000500040700000708000800080000000003060800000303030800070601
10326777435088746060205255702828542423508056462220608748404060834825663040283060701
10000000005000600040006000003000800050008070006000603000008020200040600050008000201
10564443807383207025387055666820506060568050302026604047287050503070306335702735301
10006000600070002060008000000070505050800040705000703000300040005000500050008000201
10504050276050807060503546267040802870804430705730578450852872328457582050528070401
10300040004000802000700000003000200000800000300030000030000000000000000060000060001
11111111111111111111111111111111111111111111111111111111111111111111111111111111111
