11111111111111111111111111111111111111111111111111111111111111111111111111111111111
10000000600000000000000000300000000000000000000000700000000000400080000000000000001
15283057707038364740556850203025235885402732865260807084753430367060303044335573201
10000070004030000030006000807000002000400000000060005070000080800020606040000040001
10603360804040584060655063603024507360505655835064863320705050606460502860284020371
10600000506060600020800070007000700000800070003000000000505050500000700000300080001
10753455458047207264206840306780658443786470804540544468705050848677267532603665301
10007000006000407000500000300040003000000050700040006000003080400080000000006000701
17706060803040306060368560255072404065284030435023508083426020604020602857367060201
10006040507040607030000040300050304000007030200060503040002050002020800000006060601
10328040606360506043755070506650406545307078508050705030308072864060737437502030201
10000070804000707000200040400000803000002000003040007040800040002080000050002020001
10563480506033403038702670402886303080334537445080642040852760806057682080403037861
10400080208050006080003000700000600050002080002080500080700000806000003030802000001
18708350506060234030557067338840436065705050806070607680806526208063502050777263601
10006000605000600050400080000050007000400030407060200060206000307030005050004000301
10874060606236488270807728376030503480626760487024842070606066208080874030607030701
10200080700000000040800040003070500030400040007060007020005000004060000030508020701
10406740524740356080302070703065734045208058503050407028444266504040238563703064301
10603000600070002000408060204000005000002000800060408080006000405060600000700070001
10604067827076506388773080305537302580768320408330356030602470205028606820606030541
10008050008000600000008000700000500050000080400040008000300000307000003050303050001
10834030205380603867406364602770643030774370805087207033354353704670585040504258501
10008080200040700060008000400080400040200050304000503020000000300040002000405000001
10277080544070502030253840405040204378708030805857804080385270356060853287506024541
10200030006000506040000020706020008000608000605000008000700000400020800000703000001
10404844305282708055564030402074633080706332372075486870504284606550702240485068801
10400000306000602000700050406000000050500000000020000030402000007000500050005000801
10308320706067203030407380702237586260806277782462428050308052334726447048705333201
10200020005000004030507000800000406000800000500000005080505000600000500040005000201
10663233543278777020807050828260603080646552208035207050303380806340708887358060701
10004000300000500060508040000080504030003000805000607020307000807000400030000080001
10808020408450305840502082233020802068467040603060706050706063208085846020352088281
10700030306000505000205000500050006000800060006070806040504000003000000070003080001
10453320806064544080406780208782322250306640766020808020206833282463303558707530701
10007000308000700040405000602000000000200070704030200030703000000000800000700000601
17806022707720308355506027845037645644488070302020258254406060577360836522504278601
10303030300020003000603040006000000000005060004060000040005070800070000000500000301
10408040355070737040608060205270676570504050342063802020628030602088784640857050501
10805040400030600070007000400080000060300040005000502050000080402000003080007070801
10608060704528703348248683324067627040257865244640225054373768507058506034704030201
10504000704000200000000000003020800050000070000040004000000000003000400080002060701
10803030404060803442252564505080304043876060636088606638483384204620543240553570301
10006070500040500000400000500040005000006000708000800000005000500040000020000050601
16877070838880572870406320402654636024205244602030477856306080704045204053872024801
10003070000050006030002000708000002000803040002030500040006080207000608000004030001
10442052327860602046847020806050302820805040763240308060345230606530382274627020841
10000050000020203000000070803080700080600060000000507060000000400060000000500050001
10862270786080202228804760503040746020788285784667305070447564524057787780602386601
10200080005050400000300060500060400040000000000000002030000060008000000070200000601
13307046508056206620304030865884208826222075577585782067505034808738266050265550501
10005040005000406000202070000000405000002000000000302000606000400070007080000020701
10662020806650586082406065324430207373402023502870507050805570538050408074743560201
10800060800080000030007000000040500000005000700050003060200070004000704030300000801
10323660408048736540386580357070665460676540728032487730867720204676303060406526601
10000040203020004080200050400080200060006000700030000050000080300000004040600080001
15673030206050408030202073504430587050202056258380445045838070408762462060206080671
10000060804040800040708000002000300050803000000060007080006050800000003000707080001
10534750203040306630505572652030607850508873604026602060404080535088347072776060301
10500000604040200080200060000030800040400000306000207050600060008070002000600070701
10504030302020844470506040337687643033765330807450406080306545703370405240203624401
10707040803050000020705060000000000050005000602000207000300000800070400060204020001
10207022303086533080374046276376524030705270853055604257403880484030568086606040501
10004000308000302000500070006000005030300030600060004000503000508030007080006060601
10753250806380605073408520808076804080603083306360653040265043608067407070532020261
10000070202080007000400000402040007030803000008000300020007000005000208000200060001
16533030402045655463375536505570568080273365378053404038808048834560702735803066201
10005050700030000000700070007000500040500080006000002040002000000080600000806000401
10673040765240307620504030737040505670308040203443253040438568563280366630304420701
10600060200000700050305030000030500070004030700050000020002000000000302000800040501
10803370804474504250308088262040272082454740206046648555207077533873308086367076301
10007000800000208000805000007060004000500080605050000040002000000000506060006000401
10865075337360706082503882604365264278505030503080606076348033406420205080704480601
10607070000050203080006000500070000000007000707000304000004000400040004060500000301
10803080203040807070624040873050607376645735636086404543203460344022245070604352401
10004060704000507060008030000050705000005000004000200000400080002020700040400000801
16864040722854306026205058677530823086402044207465435060284034605060707420564480801
10000060000070004020003000500030003060005000600000002070002040002000600000200040501
10768526254065723050706275605036806050884620203243502235425050536742707852804650701
10000000003030000030400080006000400060000000700000500040000080004000300000700000601
10667837802060872340482020776420734382878327776742255060836667566060685448845588601
10000000800050000000600060000060000000000000000000000070000000000060000000000000001
11111111111111111111111111111111111111111111111111111111111111111111111111111111111
