11111111111111111111111111111111111111111111111111111111111111111111111111111111111
10000000500000000000000000800000000000000000000000800000000000300060000000000000001
14384043704088466820263830305054888532702444587340602032338240732030505052688827301
10000060006020000060002000808000004000200000000080008080000070400050708030000020001
10306260803050587040347088506033807730804567768055235370503040605880306580437040571
10200000307030700040400030007000500000600020002000000000603020500000300000800080001
10267882483044805473407540204230672522685780708730763545203060748547855534802436501
10006000002000204000200000400080002000000050500030007000006030300040000000004000401
13308080606030503070748330877064406055784030268078205063286040508060205643378080801
10005020406020308040000040700060408000003050700020707020002050003070300000007030601
10544020303740705025774050802750206483804053708060202020803087577050543522202070701
10000020803000307000800080600000803000005000008060007020700050002030000080004050001
10457640507027706038308530303555802080248786522020755050726750308046562070505072231
10500050608060003060006000700000600040007070002040200050200000703000008080208000001
16406380602070542030353024465560275072203070506070803650406347506062503030534446801
10003000803000400040600020000030008000600060504030800080702000802070005030008000601
10362060404283554520808242274070504370837270446025872030807075206070233030303070401
10700020600000000080600080003030800030800070008020003070005000007060000060707060701
10304350345870853020602070506027533054603067404050306026635754403060385853807052801
10407000700060006000306070403000006000007000500020206060003000402070400000300020001
10303084548043705837475020406687306560463860808320286040406450703043404750507060271
10005060005000500000006000800000400020000020800040005000300000304000008040503060001
10583040605540303682306548508830566050466830602042708063657225407770758050204363301
10006020400020200040002000300030500080400030804000602050000000800030006000503000001
10876040848060703020475260407060303468406080404285503030442380884050575385505057281
10300080007000206020000080805060002000406000704000004000300000200030800000208000001
10407587208755207086234070607058874030703847542076557260602875405830703270563068801
10200000706000205000400050407000000050500000000060000050608000006000300040002000801
10406870804088702020605230405476835630708267783586458020406032756882625052302548601
10700080008000002050705000700000708000300000800000005070307000600000700080007000701
10523354476583653030404080273760306040864283604037608020604220206470602584257020801
10008000800000700050508040000070804050006000403000706040402000202000300040000080001
10507050203270705520507036238060704052838070604020602080207075508024386080863023251
10200020408000303000308000400060004000200050002030302070204000002000000050007060001
10733770205082376040606370303566755670807460732040702030807262453525505768605550301
10004000706000300050505000205000000000400040505080300060406000000000700000400000501
15304078406850705582305054588088586665887040804070672486803050553870657552504572301
10203070200070007000807080005000000000008020002070000030007070300020000000800000501
10705020444040467030705080702220868330607080333076806040454050806036752770263070801
10502040700030500020003000500080000020200040003000607040000050806000005050003020301
10506030605257502784354538663035248060352675834250652057644787808042605063804060501
10504000403000300000000000006060800040000040000070004000000000002000200050006060401
10803070306050402554525744408070407054666060674056802526574875402340876870786880301
10005030600060600000500000200080004000006000302000200000004000400040000030000020201
17865080872740433260608660202682784046305547307070424686505080204048704024477053301
10003050000060008080003000402000008000406080004080800080003020308000308000007050001
10784038386470806048343060507030407580608070875270805060334760204830755647863080241
10000020000030705000000040606080700030200060000000202070000000600050000000800060001
10546420256050203672202680503030454070635586627643508050882775545064538250507362701
10600020004020700000600070500070800060000000000000003080000080005000000040300000701
13202043807056302760806060723677806787784067648876747047706037408678337080768860401
10007040004000406000707050000000204000006000000000205000303000300040002060000040401
10236020408350268032707044785330706682508034503380506050404420845020803033788750201
10400050600020000050003000000050800000005000800040002040200050003000205030400000201
10584570206063574560338450482050564340484570537044455850658670803385708070703688301
10000070508030007080400040500080700020002000400050000020000020500000005070400070001
13447030703070508070202045602560826080302022354670853048485030704527226080202050471
10000080504070300040806000003000800050802000000070004060005040300000005000508080001
10436480802080302550306666462040506580407427303023502040604040273065377042876080701
10200000603080200060800040000060500020500000806000703080300020006020006000800040801
10806050706040456250204030456784733048457530404370408050806322308470603750705236801
10808080403050000080206080000000000050004000702000604000500000300070300030608050001
10407046504062527080846043253547334050606540765053507565708680877030353066305040401
10006000308000304000400080005000002020800040700030003000205000405070003080002020601
10853320506450604026304450502074603030504077804360688020865074804026805020382080321
10000080204060007000200000302040008060603000002000300050007000006000602000300040001
18343060208086356655765628507280332060355463385057207055705054762830406557604044701
10003050700060000000400060003000600050500060006000007040007000000040300000806000501
10432060487740708720506020522080706320207060203834222020776882437680477560707550401
10400060500000200080207040000040700050004060500050000050005000000000207000300020501
10602430203682204450603042385060645028874670503057475456604028434434208074276037501
10005000400000403000205000008040002000500080706030000050002000000000206020006000201
10772074343370604022406765205384875344406030204080606046556025404760405080402740701
10304060000030608080008000200070000000006000605000303000007000400070003060200000301
10803030806070802040827070572020402767786572235052602284504430526044273080707326501
10004050307000303040007080000030302000008000003000800000300050003080400020600000501
15566030254425802056404056322650576088305023807368463050874064308040308260546330601
10000050000050005060007000500050004050005000500000002060004050007000400000500040601
10754473323083772060805723208082304060853250706383503283384070652827503724707720401
10000000003080000050800060003000500080000000500000800020000050002000600000700000601
10784684502050666340486060252330772344464823257367658070468667633030863465756748801
10000000300020000000600070000080000000000000000000000080000000000050000000000000001
11111111111111111111111111111111111111111111111111111111111111111111111111111111111
