11111111111111111111111111111111111111111111111111111111111111111111111111111111111
10000000400000000000000000800000000000000000000000200000000000300070000000000000001
16665075203034576450855830708075233557803863753530503025472740453070607065628888701
10000040006060000030003000804000004000300000000020008070000080300060607030000060001
10208620702020782080524077606067807760206257568085234680803030303730207630264060741
10700000508030500050600040007000400000600040002000000000706020400000300000700070001
10267377556042307363804660302730385387363760704430776767702060244483666784503353601
10003000003000606000200000500020008000000040800030005000003060500020000000004000801
14305060603070802070783370765033303062655080434024707087788070708070303485822040501
10003060605020408080000020500070708000005080300070503030006040008070400000005050701
10855080503620708053648050808650603472206034808050307040803068433040773448505080401
10000020806000507000500060200000808000008000008050005080400030002060000070007050001
10632630203048706022507540304646807070336322263020577020668380803045475080707065831
10300040802040004030002000800000700030006080002050700020700000307000002080606000001
17802520605060468050447056365740724022208070606060404350708876604034706070335837401
10008000508000400030200020000070003000700030503040700070406000704060004050005000401
10835080302476557360407386365030604250676880545057248050306062605030685040707050301
10800040500000000060800040007040300040600050002050004040006000002050000060305070201
10404870376650278050808070403082744073505043704050604053627838303060366583505057601
10204000500050002000708040806000005000006000700080402020004000502020200000700060001
10602027245027202587468050404223502880543360804760256080507870808023404330507040541
10005070006000300000002000500000400030000050300050008000600000505000006020507060001
10253080506350705352702447405840736020568820302083804063452842404630755040807763601
10005040700060800040003000200040600020500040703000502080000000400020006000403000001
10887070647070204030268220304060208875204050203444402040452860676060627236402087551
10700050003000805070000030806050008000206000807000007000700000800080200000808000001
10205848508877502033856070205045337020208745528075573560405437206850506770264085601
10200000504000606000400080608000000050200000000040000030208000006000600070003000501
10404230508084805030304750705484346530603533685253535070307065328822465064508654401
10700020007000002080204000300000307000200000600000002060205000700000400030003000201
10864437653663827030704070337540306050444527308076202070704820803420607667325040501
10004000200000300080603030000080607040002000703000703050204000303000200030000040001
10302040702770207720505064352080303032276030602050506070204042208047478030888062661
10300030503000304000204000200080004000300050005060207080507000008000000030004070001
10773630602072232020604820604687853750805460452040402060704787338552605723806840801
10003000408000600020807000504000000000500080806070600070708000000000700000700000801
18306044805580405426404033562065774884826030508050785876404060244360437484702272601
10803070300050007000406040007000000000006080007080000040004050200030000000500000401
10405070224030546070808040705520677260507050526038207050784040307054785670853050701
10505060200050700040007000300050000050200080005000207050000070504000007070008020501
10504040406755807568624854784033323040746723386660564076872643203073202024604030201
10304000403000200000000000004050200060000060000020006000000000005000200020005040801
10305040205030203663426283502020802033667080622038304873387227307760758670224440201
10005070400060600000600000300040005000006000304000200000006000300060000030000040601
13428030523730653820603380302732756082303773202040276255806060402083808023853087601
10006020000040005070008000404000003000808080005070800080005070704000204000006050001
10763047858830605048886080706070602740302080532380604040778260703620678378377040871
10000030000060802000000060703020500020600070000000605030000000600030000000700070001
10837530264030206848704250506050648020886858776867804070633458437023556330604387201
10500040008050600000700050700080300080000000000000007060000080004000000070600000801
14502036605053308580803030262358607436437053775464442067502082802777868050255380401
10006060006000507000602080000000607000003000000000807000407000400040004060000030701
10748050708540546066808036852570704382804055805870303070804820436060506088886470501
10300070200020000020007000000060400000007000700060003020200020007000403020600000301
10857730604075448860635830434060864740442880853078638760656520203585505060202646701
10000020403060006080300070700030800080008000800080000030000030600000008030500040001
15822070804070408060608085306350746060704063378880562064485080305332787040806050871
10000060204070600020206000006000600070704000000030003080005050800000008000305030001
10537640608070608750608884285030406250505474304033604080403020787046374088227070301
10400000208030600020200040000040500030400000403000303060600080007020008000700050601
10205060202050226430308050478735562044385350705720306030208584604370604760805325801
10404050604020000030406060000000000030006000402000803000500000600050800060505020001
10803057703053738070247037852672428060208360884053804457608650632080252034803040201
10008000807000602000600040006000004060200050300030006000708000403030004070005050201
10786370502540804043403850505045507080808036704270328020373046305064604060678070361
10000020806050004000500000806020004060806000007000700080002000005000503000500070001
18454070304083824633648337404470334080865437486047607055506056684340803388606077801
10006050300040000000700080003000600030400020007000006070005000000060800000507000501
10245070474720205360806020787020304880503060807867848070438558873750264570608520701
10800080200000500020603030000050300060007020600050000080005000000000806000500080701
10303740203874203540805022575020266055527550202053265682302087338453607057488068501
10003000800000805000302000004080007000800070605050000040004000000000608070005000701
10242077453740602047707667402576825478403060208030806025536033806450804020806470401
10305040000050208070002000200080000000007000804000503000006000700060004020500000501
10502070304080502080843060277070502868288545675057704664405670547036477070607243601
10005080806000207070006050000060804000005000002000800000300040008050800080700000701
17265020227257404048608062566380384023603043203838274060522067405080505640333860801
10000050000030006060006000700020007040004000300000002030006080002000200000400040601
10358262823063563030702332803082206080463260308334204464752030545347507832804720301
10000000006060000080500050005000800020000000300000600030000080003000600000800000501
10738447305020754230654040568250882767388565886436556070784638844060757273388775701
10000000700020000000500070000070000000000000000000000080000000000080000000000000001
11111111111111111111111111111111111111111111111111111111111111111111111111111111111
