11111111111111111111111111111111111111111111111111111111111111111111111111111111111
10000000500000000000000000600000000000000000000000400000000000400070000000000000001
18648022308056654870345580604078564525306877457840206067724350525020807053432457401
10000040002040000040008000408000007000700000000020004040000020500060407050000020001
10702420602050477040322068808028204460707622648057642270803050208480502730357030551
10400000308070600080700080004000400000500060006000000000305080300000300000700080001
10323543538033504346804860305730862442784670804360534227803020243858475363805327501
10006000005000805000500000200030004000000050300050008000002020800070000000005000501
17607020507060602040854280346057304068837020864074503087254030708030504785474070401
10008020408060202040000060500030502000002040200040702050006040008020400000004040701
10528040604740307058538060708350406845402078403050603020807053482040737476504070501
10000060205000607000300080600000703000004000007030005080700030005050000020007040001
10854360306087502047803540307768606060632753385080324040323620203045867070302034221
10400030405030007030005000800000800060003080007020700060500000705000004080704000001
15202470805030657070386063783630325037703060502020605620202837306026205080426286401
10002000406000600060700060000080002000800040807020500030707000306040006070008000301
10686080306872645540202387283060404730773520833057688080302062308060263050205060401
10700020700000000070200040004040600050500050005020006040003000005080000060606070301
10406630544840337070504030707044263065403053702020302058648756602070353677307026501
10404000800020007000607050207000004000003000200050703060002000503060200000800080001
10705048846068706777532020702888407880735420202280464080304860505037703670407070631
10003060002000800000007000300000700060000050700040008000400000408000007020507080001
10846040504620204456506568705720462080764340405038506074276274503280546080406378801
10005080200070200040003000600070500020400020407000202050000000600080005000806000001
10537040478060204030243530407080602768608080302726302070632330826030264425307028231
10500030003000406040000040407050004000308000707000005000800000200040300000502000001
10704334307282502065476070603034788070305747463024675440507376605440302670468056201
10700000703000202000400080204000000060400000000020000030402000008000500030005000801
10305520305062502070703260607826333780302255233645767050604084832857847066603748401
10400070003000006070604000800000505000300000800000005020406000200000800060007000701
10874888455855463080608040884430302030332486308082307040204630702830608434367070301
10002000200000400070306020000080805040006000506000305050604000507000300080000070001
10805050502370504380802038275050203036873020204050504040603088804052254050557047851
10500080803000508000404000600040006000400080006050704060204000005000000030004080001
10646330604064652080803470702442647380605470252040405070602865877844502223606580501
10006000503000200060502000203000000000600070404020300070505000000000600000200000801
12604044403370206828402088373062264233822030206060333353603050633640868547302757501
10304060800070008000808060002000000000006070006030000080007060400030000000400000501
10208070253040384030303060308270523240504070777043505070223020705045254740435070301
10304060600070700080005000700050000070300080003000703040000050705000007050007050701
10504050403364602232763244545046747070835423622620527082242835703027202076707020801
10708000706000300000000000004030700020000080000070007000000000003000200050004080801
10407020602080302664387225802030503034227030887064303786525874606750528640565640201
10002060700070500000600000500030006000003000704000200000007000600020000060000040401
14588030673440783830305740403786767036203863207060363385302060308038308072884037801
10005070000070008080003000402000003000807030005050800070008060803000206000002070001
10447063867270807032836030208020707280807020453530805040467230704280563464352040361
10000050000070803000000060707080600020600030000000402070000000800040000000200060001
10672820546040805747705560805060548040384632246747502070336626255065752650406443201
10600060002070200000200040400030400040000000000000003030000050008000000070200000401
18502046507036707840805080728582307454725062525567538057708037206554482080526730201
10007060002000308000804020000000407000003000000000502000802000400030006040000020701
10852050504530522044708063876760305788608087502640405030708730344020203056467280201
10200050600050000080006000000020300000005000500070007020400060002000804030800000401
10632380308072365550882860683040766240653850685074457720585660508524304040308326301
10000050202020004070500040300070500060004000300020000020000040700000005060400040001
13783070607060503040604057204260686030607042678280454052426050203244584040204080731
10000080202020400080604000003000500060803000000060003040003080400000006000204060001
10643450405020405520303347658050505540403343505023706060605040666042373037278020401
10400000708060500050200020000040700040600000303000203060400050008040007000300070201
10407050404020367750807080727872332082767540803830505080208356307330507660508427601
10302020405030000050802080000000000040003000208000506000200000800040800020508070001
10807058808024424060645086447274774080207340842025703678405540875020834033608050201
10003000205000604000200070004000004040300070800020007000302000308050002080008030301
10645850205630608074806880404063408020808073504520744050832025606072304080253020731
10000060503070008000400000305040003020703000007000800020006000007000408000200070001
16223070605028663742845564607380448020868823446048504044802054422830407448805066401
10002050400050000000700070008000700040700040008000004060008000000080700000702000601
10222040223360507720308040433070803580707040704743827040252257884570374550806750501
10500080800000200070805050000060500020005040300060000040004000000000705000400050801
10604370703857208660704058732070423043488480302085835344506083866277605034576068601
10004000700000703000604000008050007000300060305040000080002000000000308040007000601
10825082683330804072808522204667225475204060706030304052853045708240407030606640301
10403040000050302050004000300030000000003000605000805000005000500040005060400000601
10405020807020504070736040434050702423726875664055804638306460232042256050206752401
10002080805000303060002050000060705000005000007000300000300080008070600080200000201
12488030454665505064507043475260453044807057507484636050364036608060703470882730301
10000030000080008060007000700080006040005000600000005040007050007000600000400050801
10553255876022864050204533205048507070255880802454303848683020426582202583502670701
10000000002050000040700070006000200040000000800000700050000050007000700000700000701
10326263506030346450354020284820475324477623337328667070735874243040588332444336801
10000000400020000000400030000070000000000000000000000080000000000080000000000000001
11111111111111111111111111111111111111111111111111111111111111111111111111111111111
