11111111111111111111111111111111111111111111111111111111111111111111111111111111111
10000000700000000000000000300000000000000000000000300000000000200060000000000000001
16826034206048334430676530708062773355703427454220603082582540736080708062648435201
10000070005030000080004000505000007000800000000030004080000050800070206050000030001
10503650405060728060465063802045507250804276688054723360704050805460808730435040421
10600000207020600070500020006000300000300030002000000000505040500000800000600050001
10267556686034703658607360703630528447326640708280363766603050246446826272207773201
10006000003000805000200000500030004000000040300060002000003050300050000000002000601
12204070303020604020584770632058408028723050372073407048345050805070304656274020401
10003040404050805060000030800040602000002020600080705070003030007060500000004070201
10452070805830802024287050203450702262803055705030604080307048336080748575403050401
10000070805000307000800030700000407000003000002050005050400080008040000070007050001
10742340204037202053607370508776803060455355358020258040657640207056835040606028521
10400060804050005050006000500000700050006030002050600030500000607000004060706000001
17708460206020587080744038372870625038308060603040603240706686708034305060673452501
10005000206000200050200040000070002000500060707040400060505000308080002050007000201
10358050806534767540807666357070603830756550727045636040205042407050663080806060501
10500060300000000060400040005080300070300070008030006060004000005040000060502060301
10504350852830223070805060804024643085705062705080602025652366508030843563807042301
10303000700040008000408070702000002000006000800070206060002000706060500000300060001
10303028232034403556484080507528707430324280208350523040305280203064206560704020671
10004020007000600000008000500000400070000030700020004000400000806000004070203070001
10568080503370303754408262204450466060527230606022304046627267203370346020508427601
10008020600030200050003000600070200080700020606000804050000000600050006000306000001
10473030553040202080483740607050205655206070303753403030476330453070852243704075621
10200020004000406080000060406020007000302000404000008000500000300020300000607000001
10608636704585404023862040604082635050405586462052764860203554305260704670243053501
10700000805000302000800030504000000030800000000070000040604000002000200040006000501
10306760503026708040808240607587483860405863435428855070303032832578262086803234201
10400040008000002060803000400000702000300000800000004040305000800000300080004000401
10445756662826774020705060734560802080224766206062605050506240608460605325584050401
10004000800000800030207030000020605070002000207000404050608000804000500070000030001
10808080807650704420308054567070603035528060408070802060508048605035265070845027771
10300070305000205000302000200040005000500040005030403050207000005000000040003020001
10372670503056777060207560407754276360502830238030204080706847878257508584704880801
10006000508000800060702000308000000000500060702080700040303000000000800000600000201
16302046504370708447403035335065365545246080505040477824603020288250625656705538701
10308040300080006000405040006000000000003040006020000040006020200030000000300000301
10505080582070723060704060205440364450305020437068407030484030408034822480283030601
10705030600040500020002000800070000040600020008000303030000070207000004020006020301
10804020508253706875364787273082227070874648547680266024356766402045508084802030401
10803000202000600000000000004020700080000080000070003000000000006000400040008060701
10203080304060204784776688308050703068364050564046803372666473405380868270247350601
10004060200070500000600000600040005000007000306000600000005000800060000050000040701
17842070444580478830605880208386832063604826402040466283206040404076603057478085301
10008050000020008030003000708000002000402030005020800020004050203000504000002040001
10734038738580706087736060804080606460403020242470602050866850503860447865688020541
10000080000050408000000050805050400080300040000000708020000000300040000000700060001
10666880336080608532303750204060525040842335342252702040363462546075432560504824601
10700050007020500000300060800060300070000000000000003020000040003000000060600000201
14808066507088408230705070552828703784324023743552443073202068704566837040363730701
10003030006000602000803030000000708000006000000000603000204000200060003030000020401
10755060202840364077604076652280704275703032302380407070803780822060803077877740501
10700080400060000070007000000080200000004000300080003030400070003000703060600000701
10522280208078466660437660865020835230752330277068784250576650308242203080405744701
10000040408060002040300050800070400070004000700080000070000080800000007020400080001
14826050602030506060605063606360445050806077388340263083386070508247528030305020871
10000050203070600060305000003000800040806000000020008030007070200000004000605020001
10336630802050307440803743775050305660603874204054802040602050376034542022845050301
10300000205020400060200080000070300070600000708000702070500070003020005000800040301
10305070508050633250307040463733668023645330306840505060705248306640306660705788401
10605080604020000020608030000000000080005000404000202000700000600020700030602020001
10804047803035777060558082486823853080302230764057804326803820374070543073307020801
10003000606000406000500070002000002030600040500080004000705000407080004050005070801
10873240305260403075802240803058602050405046505830743030732065506072208040758020771
10000080504080004000600000404050005070503000007000600040004000003000504000700040001
17744070507072584445282647804550832020637754348068703048608073468250505845403074601
10002060500050000000600020006000700050800070004000006030007000000040300000607000201
10328070778730702250502070833040505820406080203633436080357328643670282860603840601
10400040300000200040506080000060200040008070400080000050003000000000408000200060301
10307730403222708740407072878030633078757320505065548658202026528886408038447082201
10002000300000808000306000008030004000700060803020000050007000000000204080006000801
10266055887720806047804275606573453685603040205030703023684085608220803030706780301
10608080000030508060002000700030000000003000705000408000002000200040003070200000701
10808070708050306070442040283060402634262358886085805577708860735033446070604843301
10007030707000308020008070000050205000002000005000600000600050005060200040700000801
18356070637325307073705026458340487023705043504557838020648038803070605220785330401
10000070000030005080006000200060007060004000700000006040007050003000800000300020401
10365425272026767050703782403032205070464850608265202677283040654546407837406560601
10000000008030000040700070002000400080000000300000400050000050004000800000300000501
10654623406080253820385070586740868422734382866732855050326234483030467578324675301
10000000400060000000500030000080000000000000000000000080000000000070000000000000001
11111111111111111111111111111111111111111111111111111111111111111111111111111111111
