11111111111111111111111111111111111111111111111111111111111111111111111111111111111
10000000007000000000000000003000000000500000000000000000000000007000000000000050001
17804042706025465547303570536078403060504055337087423357643733705050677250246030401
10804050007000000000500030000070007050502000004000700000000000402070300030007060401
10608660532635532280304060562260268830802637708020704045868260208030702027207350201
10800040000000000000304080005000800000700060007030008050006020200070506000300040501
10555020708673857435646050606024308857423250267020835420308060262688204050204020801
10200020502000000000800080806000504000002000800030500000300070200000602020603000201
10302570565087334770606060705760663060405042808882206043768050305420603430808377301
10600070007080000000704030807030000020300050800000002040004020506000302000500000401
10833020802050828547407060407052783430655560308074654022405070802032604027725260401
10000070400020004000008030300030004000600000808000007000006060603000004080005000601
10678360807374564060385040332737602067304584305062706678306020803057727030405570801
10002000400000200020800080000000002000707000603000700000402020003000002000800060201
18204087655233704786605052822326746060703520703760463840203082474460707446258070801
10005070000000808070004000700000002070002000200020000050308000000020300000700050501
10852020324650602040203420805244306878305057205058706070278625774022383460408286701
10800050800070708000305040200070006000304000707000604060400000700050003000400080001
10203060402050307037203050667070846080568360232720604060205260504070308077667030361
10707060804050008000700040006060006030000080005000608050300060307070500040007030001
10508040604054353635402673703050303828453072308063606070377060505050446820506057501
10506040007060008000705000800040400000007030600050007030503040008030000000306000701
10707532647040608040507020554050584878602060506330854070704022768686687028588460801
10800000006000507030200020006070007000504020300030400080008000000060003050002060601
10544475557853806050678750702446802040303080835070506776823325677060207320805060401
10000000200000002030500060500050007020200020007050400080000030000030208000708070801
16737070408753343080702030465060567040273343507080602060743040505480304085606020401
10007020300000006020004020202050000050000000808080308060500060500050406000208000801
14202760706388507030265030606040463066634750606070203020506520522820504820803370801
10006000306000200060008080303050006000000080007080802000803000800050300040800070201
10808032686060782738302020705030805335663638746620853264707034506060408080787083201
10707000000030002000006080002040605000800000000000600020002040006000304050003000001
10503536345755702068466060546075508070607034462888202050844050776745366030305044671
10200000400060007060000040200020003060004000005000802000606020006000006070708000001
10348375203030823060408280406630842077274774308070207878702085405076704072402054401
10800060005000800020600050203070200050000000804030200000007000406000402000007000201
10404060207422608870807570407070506527832730745020208555568070507520207424373080501
10008000502000007000404000703000702000000070000080700050005020708000300020008040801
10737052808087575063828083606853504050526073862250768040305080605040445025406060601
10007000608000500030003020005000600020007070000000500020502060602070006000807080601
13606584208030502282803080633070844478605020502244704546307030804060807460504470201
10007000702020200000502050000030300000204000700000300000006070400030202000200040701
10555070407030344860305072876630845670524222668880855032203040677822704040606040801
10600020003080000030003000000060600050700030000070005000603060705000508020402000401
10202486383020873024878650746020606080308030483040805250244060603030578020375347501
10200000800050003000000060300070007000505040300060300030600070006070000070007030001
10402460402722705657352050504274548644855050307637853057405035382033303432206020561
10807000603020008000002080400000008000002040300000000030003000004000700000700070001
10384040205050603080647080856447602053405027703454478430405542774470604360508367501
10400080703000305030200060002000803030003000707000000000805000002000508000508000601
10206282707475525050608620402070404080722670467042525285248036303082237085303060801
10300000400050000070300050500040800080600000600080000070004000700020008060205020001
10436640256020703034727070474040603520308085502020768030208020406250602040205060251
10000070007000204070000020006040402040008070004050005000405080500020400070008020001
14837043506656702030864548804220604023583460208034603882504880888070235285448082501
10007040005000007030004000203000200070002000208000200000803000200040800000005050201
10206020638428783033602820606042472320405026466836602280307030806770503645808040601
10303020600000008000400000308000000030204000200000300020700040700020307000205080501
10562070883544303240203857308466508030505020803830258670533627848070407056607020701
10002080003000008060400000400000808000602080200050000000600000004060005020002080001
10803053607057648050823577545230226262208070726074588646354385307084343080834032401
10805000506060000070000000000070000080003030003020000000000000306000000080003000801
10208870403030306446364522686030752030365648453070278343623520307882523534202620771
10600040600020600000000000700050400080000000500020400000005000500000000000500080001
10448040266730484650867450806383805034354540404560207565506035867278602570846048201
10005000500020000030000050200000204080000040700000303000308040000000400060000080001
10408627205060566038457070856040303050503040682065802030602088403780602038876720841
10406000005080007000002070005030202040207020004070004060406000600060406000000040001
10402054833088847077505346808550505330673032602770668062206080767370304436453057401
10700050200040006000207000307000200000200030508000500020004080000020700060007080201
10553880403680605874306030826070276868505370208050606650265070557050806060726020601
10600000300000500070005020000080005000006000800030200070408040003020208000700050701
15505054482735375030758060458770638057582030766870706050302060888050708844704750501
10006000000030002070800020000020200050000020600000605000700080200040602000300000201
10503454786043802050502027646070202340502780405553568238655080405380608030706454201
10700000006000005080803000400060300000504000300060000000002030600000808040800070801
10666725746073537080704227505664543427308082442780608257408030825635363060646060501
10000000002000500050008000007000700020007070006000506000008070200030600070008000701
10438275605834705076576052783760708020848020808027208023867020208050607588606257501
10004000200060007060005000000050606070200040708000804000700070004000300060005000401
10202080838020505020204643848060302430703360406240428520363623464663253040344030301
10500050005000603000700000003000600000700000200060000060000000000000000020000050001
11111111111111111111111111111111111111111111111111111111111111111111111111111111111
