11111111111111111111111111111111111111111111111111111111111111111111111111111111111
10000000600000000000000000300000000000000000000000400000000000300020000000000000001
15362032303062674680643660608075826283402575755740503058867650568060307067773626601
10000080003020000030002000407000005000700000000050004020000060400060303030000020001
10405570305050227040254053504058705860505682587052635440503080603230506280685080461
10700000303030600020600040007000800000300070002000000000405050200000400000600060001
10225324388088604238803680402830264475336680206460428772605050456348523745405254601
10007000005000506000700000600070003000000020800050004000005030400070000000004000601
14206040207040604030325460537052305048627080483047708036773030703060603265642060201
10005030504070804040000070800070502000002060500030703080006080006080200000004040801
10752070705860606062485030608830807583206025505020702020508028726030737852607080201
10000060406000207000700040800000408000006000005040005050500080005060000030003030001
10428520403048508084308330603866806070746268824040475040582460708083282040706046571
10200060808060003040004000500000800060003030004060600070500000604000006060803000001
17507830207080868070256056846560656087304080706020205640706545203068707030878382701
10005000403000700060800060000060003000200050508050300040206000208030006020005000301
10484020804572847670504736465020603830325870832073786060306024702040786030206060301
10400070300000000060400060002030800060500020004050003040005000002040000050305020301
10802260228270428070703030306088578087804075707070806076562562606040357545803087201
10808000200040003000204060308000005000004000700040208050004000408060500000800050001
10804026563084506472827080506476806360726780402560822050504840206084205430505020541
10005040008000400000002000800000200050000050600080002000200000402000007040607080001
10833050505680403678404646502830623020365570805083708062634443205240835040807242801
10007030600050200070004000300060200070600070303000306050000000700070004000608000001
10478050753020208030744260603030403658407020704287306020326470688020825865306033371
10600070002000305020000060706040004000704000206000003000300000800040700000704000001
10604278604824806055325020308022847060503878642063463760207665203620507280724027501
10400000508000205000300020803000000050400000000070000080408000006000800030006000801
10305450303062804020308350506536885250607886863644245040708062682325537064602464701
10400060005000005070707000600000307000500000500000007040205000700000200070003000601
10686586445526686080507070833250307040264843203085304070702720705750503548535060801
10004000400000400040208050000050307080007000708000606020603000508000400040000080001
10806070403360302830605078578030604033256040805040604030405043507025657030464048321
10700040307000207000603000200030006000200050004080205050306000002000000070006050001
10665280504057862060807220405223556840808250788050208030503544862625606362808360201
10006000604000700080606000402000000000400030205040200040208000000000800000200000501
14703066508520608756607084658084683347336020205070354272805070456820877383605377201
10202020500030006000208030004000000000007080002040000080005050300020000000200000501
10305050624050276070608060307640283520505020444022505030643030606087823850767070501
10304020400080600030004000500020000050300040005000408060000050806000006030005050601
10505050406556803274287872756035675060632658853240678024547638203038508035704020301
10408000604000500000000000003060200030000040000020007000000000002000800050003070401
10308040403060207328623883804080706027848070435037205267374262707420857760755440601
10004020400020600000400000500070006000005000406000700000007000500060000060000020401
13738060866250648560802640407227834034608538706030866646803060703064605044333052701
10002030000060004080003000605000007000402030005070500050002030603000304000006070001
10758077758380408075852040603080403340808060825230308060362520202440232478235020271
10000080000030205000000020206030800040800030000000707070000000700060000000800080001
10825580674040207666606350708060662040358664742274507050478284382024526640307845401
10300040006030700000300020400020300030000000000000004060000060007000000030300000701
14206078404042403470208040253328705774755032638447242063203084806436523050853580401
10007030003000308000803070000000602000007000000000702000607000700060002020000020501
10427040608250523067802022657870204674604068208570302050203320667080608082666880401
10600050300030000030004000000060300000007000200070005060400050007000802060700000301
10655440604038542520887530324080472780643760456087624650735280302663706050306633201
10000060302080005060300080600020300060002000600030000020000080700000007060200080001
18647070208020305020408044403430568070204077378820334074376070703527427030703070471
10000030603080200060803000002000700070604000000070007080007050400000007000608040001
10666480802020404550304547656060604250707273604034803030806020267058452044585030701
10400000806050500080700030000080400040800000208000508020200070003060008000800040801
10704060205030854430808020782337237084555280706550506070706378504640606450804876401
10706080507080000060805060000000000030002000405000507000600000400030300080307040001
10806036406082225080532063576722825020503670877034602448805370838040835042704030401
10008000708000505000700040005000007070800030400050004000308000803070007030002020701
10862440205670603054308650804084508030804045506870635050237057703078202050753020841
10000060703060006000500000603070006030403000002000800020003000004000502000700030001
16528020803053465263867388606380736070444726434037507072208057376350607574604056301
10008040300020000000400040004000800040700020007000007040005000000050400000408000501
10284060668280603450503030563020406880508020202732462020767834275620745660404220801
10500050600000700070307030000070700040008020300020000050007000000000507000700050801
10202770205845604460203032427050426048346570604032753355502024345765508075447034801
10002000300000204000208000008060004000600080204070000060003000000000704080008000201
10437054833380608075306526808848256448608060202070204042477052302520507050708740301
10403060000070405080004000200050000000004000505000603000006000300050008060800000201
10202080308040204050236070658080802742663786235036305778306670322057253070706727801
10003080804000306050008070000040707000006000006000500000300030008050300070400000601
14646040722244305073808022348770284036206047302743772050877055803070504620326830701
10000080000080007060008000500070005040002000400000006020008020005000600000700020701
10356753232035255060503862803034607080825340205865402537864050747752503834804240801
10000000006050000070400080005000500060000000200000800080000040002000800000300000801
10338773502050236730855020466650823243525337566887448080666553654070768534562272601
10000000600050000000500050000030000000000000000000000040000000000070000000000000001
11111111111111111111111111111111111111111111111111111111111111111111111111111111111
