11111111111111111111111111111111111111111111111111111111111111111111111111111111111
10000000600000000000000000800000000000000000000000500000000000500020000000000000001
15873028702074228340672560402047536322802855288220302045734720266020207045358475401
10000080002060000080004000404000004000500000000050007040000040800060703020000040001
10803520602070277060256072507057702760202674284062824430704050207880702750475020271
10400000304050400070200040005000800000200060002000000000505080300000700000300080001
10624453343062407654605660204220324863687470706380334475304050557248357345507477201
10006000008000208000600000300070008000000070200060004000006070400030000000005000501
17806080207030503060838330585034403057337020286033303032732030508030708724355080501
10007040707070306080000070700050504000002080700020506040007040003020200000006070401
10844070203280305035558030507720504475305037206040503020207035374070327666305030701
10000070602000205000600080800000604000006000003070007030200030006020000040002020001
10248470203056306022307650804543803040482723755030546070765460806056332040808042681
10400050308080003030007000600000300030006070007040400020200000607000008080205000001
13604440307050573050735056266280674044304040405070606370308655407082306020768644301
10008000606000300040400040000020003000600080603060600060703000503070002080002000401
10833040407383676340705643684020308480273850473068524050707083702050326070305040201
10700020200000000080300050008070800030200030007060008020007000002040000060203060401
10208640243330848040204040304022234057305052704040408047444735508070346768307055601
10606000500080004000606020706000005000007000200080403050004000505050500000300030001
10802047367024503438565060603724308270675320605520844080604860802026705820802020481
10006030002000700000006000500000600070000080500040004000700000803000006070506060001
10328080202640302852507534604370265030654720605054207043675245505220277070205373301
10007030500020300030002000600060200070500040207000205040000000700070002000604000001
10377020456060707070884280804030406755203020206663605070344820453080834886408068541
10300070005000703020000080706070005000404000406000003000400000800080200000508000001
10602865303265806063386020707025372030408282456074733630205886207460307770865033501
10800000602000306000400060508000000060600000000020000070808000006000300020008000701
10307850605024603060502350406253644840807238868788362070702084672272853035707458501
10800080002000007040704000500000204000700000400000007080503000200000600040006000201
10345686338553284070308040228640805070378474408078703040705450602460403646328020501
10002000300000600030204060000060608020007000805000203040505000505000300080000080001
10307050205260306820503038827040504025576060506060304080503044205073857030287066751
10500030405000702000803000500050007000600030003050506080602000002000000030004040001
10448680605034338030608240205645733330503870785080505060403637382377603672606620701
10008000804000300050703000807000000000300070703080200020202000000000800000200000801
13402078805230505828806075752068756432547020604040478243707020725320754546706883201
10206070600070005000804060008000000000007020003070000040003080600060000000600000501
10405060536030226040202030207420662750403060754027208080543020603024288240482050601
10805060300080800070008000400070000040400020004000706040000080705000006060003040601
10806020203678507643386762745072345040686634286580628023635268202086508037402080801
10608000408000500000000000008060600040000020000030006000000000006000200060008080301
10504040802080506372565263803050204075272060823036503268857273203530744630778460301
10005080700040200000500000600040002000002000702000800000007000500050000070000060601
15844020742570757550204770607868848032703566403030746277808040303082705055623026201
10004080000080008060005000304000004000705030008080500020006070503000803000006050001
10852054828230602072684080408040704270508050224680507080742870703830624434848080781
10000020000030406000000040804080300040500030000000705080000000700040000000500060001
10545540468070207738803650608060587070886625744424207040764262563032428750208545601
10300030002060800000600040500060600020000000000000005050000030007000000030400000601
16605036703047802380208030342754508574256062255448552044706047703635342080485480601
10008040004000808000705070000000308000006000000000304000508000200070005020000060501
10453040304750245073206028625330507482404066502230308060802270836040702078532480501
10400040700020000050008000000030600000007000800080008080300030008000706030600000801
10288430604088765760765860264080756230488660264083833680837730306356202080702685401
10000030204030005040300020500070400080002000500040000050000020700000006050500040001
17373060708080608070708035604480536020607028526380238044643050804335778080305080851
10000050404040500060705000002000800020603000000060005080004030700000003000604050001
10475470608080407630404343886070606420304636508037405020805020574045356054642060701
10300000302060200030300070000080600040200000707000507040800070004040002000200080301
10407020405070347630806060542536854023442670703280307040508643504730704330307277401
10805050706040000020605060000000000070005000308000408000300000400080300050702050001
10702026606025657050225053354868254050602560237075308536805640823020746048804020701
10005000302000702000600030008000006030700050500080007000507000206080007080006020401
10853630508430404084507880705083808020305022308640285020745032804084404070565020631
10000070503020005000400000703030006020604000002000200040002000002000704000400070001
17274080303032562463244233303370483020475473434043402075406066466840208283803056801
10002040200070000000200060008000400060700050007000008030004000000030300000707000201
10846030328260205750503040434080404270705020306563484050346355452770885870305540701
10300050800000400050307020000020700020002080600050000040005000000000305000400040301
10203780207387408370308034466020266033887260403072546762808022828283202057868053401
10003000300000606000307000002020008000600040408080000080008000000000803060003000601
10244024626430205025205247202634626466805030408030806086768058308860804080404360501
10702040000020703030007000800050000000006000703000605000006000700070002020800000701
10708030306070303080423070527030808583583856322045503456403830663053262030202572201
10004050708000304080005020000070808000006000004000200000400050002080300080200000601
13357050436223602086207024458440832054602057403583828020544076507070704640676560701
10000060000030002040004000800080005080004000500000008040004030006000300000800020801
10682248583076286070504862402046502060473720406352508375843080647724207644405630801
10000000004070000060300070007000300070000000600000600030000050007000200000600000201
10432224407040273740744030242880376785336324337582223080284847443070437227367763701
10000000600060000000700070000050000000000000000000000020000000000080000000000000001
11111111111111111111111111111111111111111111111111111111111111111111111111111111111
