11111111111111111111111111111111111111111111111111111111111111111111111111111111111
10000000800000000000000000200000000000000000000000300000000000600080000000000000001
13427036306043586870462630807073637527202822377560802058664840367060208027654526401
10000050005040000060003000805000007000400000000040004050000040400040805050000070001
10604880408040877070354033308052607530605338734065525640407040208830405330383070821
10700000204030800050500020004000400000600060008000000000707030700000400000200040001
10757328432077404267606630208820386886864820706340444464807080755772868488308337201
10005000002000307000600000800040003000000040600030005000004050200020000000002000801
18308050702040208070552430633044503043348040724023304066372060504050303227457050601
10005050208060404020000030300050802000007070400020503050006060005070700000005020701
10767070305430505085835020504880307445304075708050407080307058377050563864406070801
10000030508000608000500060500000606000004000002080005040300050006030000060007050001
10486440202082706052502450707352308060857224287040258050535570806084556080602067361
10800060208030004080005000500000600040008060007050500070200000807000006050502000001
18206560302030337030787076424850846056208080203080806620705668404045808070368665401
10004000706000700080800070000040006000800060802050800040603000707070006080006000701
10788050506257558530508583633030503550528760258077357030207077608050775050702030201
10700050200000000060400060006060200040400040003050004030003000006080000040408030601
10402660877560652070302060404028425072606088704020407045274482702050653558503083601
10405000400040007000707070408000003000005000400080804040008000406070500000300030001
10602035623067807644552070805452807270757770607850263080406730203062607730807020741
10003020004000200000006000800000400050000020200030004000500000706000005080703060001
10247020203280208537607754503640247060448370305047502034876224307250825080803246801
10005020300070400020002000700060300080300040806000808030000000400020007000404000001
10276020785070305080766470806030702623403020205788608040386430683040424775607028251
10800040003000404050000030605050002000304000408000007000600000400070400000402000001
10207734605233502038545060805045464030506427325047636860502282807240302750852057301
10500000408000805000300030603000000060200000000070000040703000006000400020003000601
10702250603054302040202480407627485570503732324858658070406068225548423053604727401
10700050003000004050605000700000602000400000500000002040707000200000600080005000501
10372452754224722080207080847580606070353376505063803020705440203630205736262070401
10003000300000800050302060000060702020007000705000503030208000708000800050000060001
10708030205460607250407034545030207064274050305040307020302067805022343050367047571
10200070205000603000704000400030004000700060002060206020304000003000000080004050001
10225560806063542050605350403556445320607740887070808080708235642786502878308880701
10008000804000300030307000706000000000500070702050700060602000000000200000200000701
12205062604520408685605083545038548456674030402030286653406070885550278662403688401
10704040800080006000506040005000000000005060002070000080003030200060000000300000401
10707030424070258080504070406620742360503060352075607020655040707033555850348050201
10608020600040800080003000300030000060800040008000708060000030605000004020005070701
10605060808768403588826634567024484070856858223440662053387646806055804027304070801
10306000806000700000000000002040700050000040000080005000000000003000600030003020701
10305080602070203825343375403030505062263070288073402252345833305470237570772370401
10006030600070400000400000300040005000004000808000300000003000500020000050000080801
18563050245750864370707450804538265066608843406060666524306070603088503057863038201
10003020000060002030002000207000008000506040003030300070007070808000402000008070001
10536075554660405072233080307020503220702060237530606040347430608380656673734040421
10000040000070402000000040306020500050700030000000407060000000300020000000700060001
10368770554030402268304460707060255080247755535656306070833627877088827520507843201
10600020007060200000700030500050500050000000000000002060000020003000000020700000701
18602065802077403760705030264652807436382026564852732067807028208776577030678450501
10006030005000802000608040000000706000007000000000507000508000200070008040000050301
10756050608860362048707067258340602575603033402240206050605270364030405036375480501
10800030400030000020006000000020400000004000700020002040400050006000505030200000801
10663850405032428460654530848030658570362380644077774780334780407823805040502752201
10000080208060008060500060400080400060003000500080000030000030500000008080400030001
17548080207080603020404074503740582080608053332850864044368030707862636060702060331
10000030402060400030308000007000500020607000000040008060007070600000007000802060001
10228680405070607840507774577030708450807274806025402060304060486052372085368020601
10400000508020500020300050000080200060200000604000302050600080007060002000400040601
10407020702020226220807040822657288047875830707340303070403855505470205780805737701
10602080202080000060604080000000000080004000602000603000200000800050600080602060001
10208054406076427050483073848484565050405760858076303856807220658080284075404060201
10003000405000208000200030005000007020600050400080008000602000806030004020007040601
10222480308880506032607650502034703060208044203350745080644034408066606080823040821
10000050203030005000400000405080004050304000004000400040004000003000303000300080001
16627030506054383463656437705780547050228245756084502084606033382440808657803046601
10003080200080000000400060006000800070500040003000007030005000000060600000307000501
10282040225850805640303050827040705560205040406463545070886672628640538530507640301
10800030300000500040306040000060200050003070400030000030008000000000303000400020801
10402370602365207560802023786050478024738330302027532665506026534344405083846057701
10006000500000604000607000002040004000400070803020000060007000000000708050008000601
10742074773820405036703834603266468476604050806040607073232086208850802070406640501
10806040000080606060007000400040000000006000706000607000006000800030006030200000401
10203040206080403070885060863050306336743653233082807423808530332025224030203752301
10005060507000706040004020000050604000002000002000600000700070007060600030500000701
17886050787423807022802024255540362076807024503758844050864086204050207320886630601
10000030000080008020007000500070007050006000700000007030006030006000600000200070601
10438357667053635040708388406073703040847520607548604544548080572452403423704250201
10000000004020000030400050006000800070000000500000300030000070007000800000300000401
10738766607030253730866040455570287854523333456347674070444728266060857447757582201
10000000500030000000200070000040000000000000000000000040000000000050000000000000001
11111111111111111111111111111111111111111111111111111111111111111111111111111111111
