11111111111111111111111111111111111111111111111111111111111111111111111111111111111
10000000500000000000000000400000000000000000000000600000000000400070000000000000001
16763067305022888750268230805074484524204563736360203038322550368060604087224358201
10000030008060000070008000803000008000300000000050008030000020700040603050000050001
10406220604080236080634074303048607320308847823082683230604080306380203480886050451
10300000803020500040800030005000800000800080003000000000506030700000200000600070001
10245656576068804343303320708850373275757530203270838252408060772635857836708484301
10002000006000202000400000600080008000000050200040007000007060800040000000006000201
17605060506040303080736880286082507054786070285054507042326050702070407266326070801
10006050202020702030000040400020802000002020700050304060006080004060200000003080301
10476050706430603078578080702840204374605047506050605020303076757030344556807050801
10000070606000803000500030500000502000004000003070008060800020008060000070004030001
10255650506022608046704770607826406080756377264070733030678350204078553070304033561
10700050304040002020002000200000400060005050004040800050300000804000003080606000001
13207630303080842060483057723280274023406050704050803260602863204036403030324536201
10003000706000200020300030000060007000300050207030300050403000705030008050007000401
10234060604458672330808384438040403620477640847037528040208028408050544070203080401
10300040500000000080500080007050600020800020004070003040004000003060000020408070301
10308680784230262020206030307024276034605042806070605044388288405020432352708078501
10802000300030008000803070308000007000003000800040305030003000603080500000700060001
10405088284054508323368030406344606230342350805330755080807250407042703770807070561
10007030008000500000007000600000700060000070500030007000200000802000002070702080001
10344040402780603766708765305820455020325460705043602074472443403570627020705675501
10004070700080700020006000600060700080200040208000202060000000200040005000607000001
10633040744060702020327680202030203776408080407843302030843380484070427883708044881
10400070003000604030000020807060005000407000802000008000300000800030600000605000001
10702234405482206023484020408024656020404763882052852870604832608820206740748037601
10300000808000806000200060806000000050500000000020000080608000003000800040007000701
10702450508053208070804320803468478840707545657534485040202073763843248072605423401
10600050002000006030305000500000808000600000500000002060208000800000200030002000401
10736774546542453070402080266840307070528868606023403030202580707670405334282050201
10004000300000600070804070000070403060007000208000508030603000707000300020000060001
10504080303680808820406047845020303043688020503050203070203087306077273070835048721
10700070503000306000703000700080006000300040004020304030305000007000000060006040001
10646550303024432020505460805637577680606370774040603080606353876756607274604860801
10006000808000300050402000802000000000300050306060700030705000000000800000400000501
14707057202480408486802022683042426324865050607020788385203040358620346375604333501
10803050300020007000402050005000000000007030005020000050007050700080000000700000801
10402060258070555020202070802680823230402040763027504080587020604024676870876050201
10308060800080700020004000300030000080300040007000502060000060406000007040008050601
10205030404882507742337368674066264080373772267280442085568482807036805032307040401
10603000308000300000000000003020700060000060000080004000000000005000800050003020401
10302050803040406758248272807050802044686040546034306732527752506380845580367820201
10005030500070800000700000200080002000005000605000500000004000300070000060000030401
15787030433620687270207640503547334042604457607080588462307070302056608026557087601
10004040000080006070004000304000008000506020004070500080002060405000403000004030001
10362086555740603036258030404050408230507060746470505080752460607350822564243060741
10000050000040602000000080604070400060400080000000308040000000800080000000500040001
10753550488080606368607830204070384060244342726576205050728587677073474280807686501
10800080006070300000500050700020700020000000000000006060000080002000000020800000501
18704044808028306530803080447468704753377032438237246054704036505352234050643750301
10006040002000604000504030000000307000006000000000204000502000400040008060000050701
10576060504470256045206084784250406464608026402860203050806820228060202057853780501
10200020700080000040006000000070200000005000600020005080600020003000308060400000701
10633630802043628770634420827030272640446540366065387340657840208755707030802823301
10000020804050005040600050500070500030005000300020000020000070600000007050400070001
14743040508050202060804065606450825080204087374420488077462080206723266050303030861
10000020206080200030506000004000200020407000000060007080006080800000003000303060001
10653630508040203250607578247060205780304482207046304020705050227057746054445030801
10400000803050300050700060000020700050600000205000703080600030004050006000300030401
10508050303040836720702030367567775065565240307360308020506456807430306380605567701
10402040404070000040306080000000000070003000607000208000500000700040700020204030001
10806023703084453040355026626522322060504560582084607744808350453080382035503080301
10005000407000408000200050004000007020500050700070003000604000805040002040002020401
10834330707440308088204760403055204060504026308340376080452054608034208030788040261
10000060607050005000700000404070003040807000008000500050006000003000603000800020001
17658070304082263734584742706680763060423572577054405084404034335680608544604022501
10008030300080000000800040007000300070300060008000006020004000000020700000503000801
10722040334330608380304080865080806860706060305835643060267867863530688540206850301
10300080600000300020603080000030600060004070800070000040003000000000506000700050801
10403860707443406570708032635060528022633430403045438264602064564634305083488073701
10002000300000704000802000004050002000700060303080000080003000000000605080003000601
10524042637420604033702253204524244268508070702050403057633037304280505070707220501
10208080000020203070007000400030000000007000808000205000007000300050006030700000401
10804040502050706050247070747040206326327652766026707754802580857066228070607355501
10008060604000602030002030000030805000004000005000400000500050002070500060700000601
14223070284668707063708076248530672075706044303373365020387036202050307770532260501
10000040000080007080003000600020007060007000400000004070002080006000700000700080801
10286256687023544040803427204074408020682370204872806264638080356822307888807720801
10000000002020000050500020005000500020000000500000600070000080004000700000300000501
10668735706030687530283080286420832546877464864757825020666758636060853657446426701
10000000300030000000200070000060000000000000000000000050000000000070000000000000001
11111111111111111111111111111111111111111111111111111111111111111111111111111111111
