11111111111111111111111111111111111111111111111111111111111111111111111111111111111
10000000800000000000000000400000000000000000000000600000000000600020000000000000001
18567088604032736850258380706047473626202658436470403056625720565060803087685545801
10000020007080000080004000702000002000800000000020006030000070400070508060000060001
10502780804040765030357087303065706650204733725062358620306060802630205480343030541
10800000503050700020800030004000300000700070006000000000507080800000500000600060001
10448346754065702762607650402670382576328530305750734865705020635524784725507875501
10006000005000505000300000200040008000000050300030004000004070400060000000006000601
12706080702060804020674780662047708052282060355047402073262080807020805247572030501
10008020504080402070000050200060506000005050800070703030004070006030700000007050501
10245060307230502054274040606780708384404056308080204050706033848070426248205050801
10000040504000306000300060700000707000005000007080007040200070005050000080008030001
10466670702062303022208550502368507020543423636070472030352640405056355030506042821
10500070405050006040007000700000800030005080006080800060600000606000004030703000001
14307240308050738080782055532430782038506040408070606260504688608088403080577446601
10003000402000700040200070000060004000300020405080200050304000602020007020003000501
10656070705678255680606334226020803270388740343042536040507053203030575080708080801
10500060200000000020300040004080400040400020004030008030003000008070000040602070401
10604820844850768070604020303088678063303086803030704027648286807020536874504052801
10202000600050008000507030406000004000005000300030202060002000403020500000700080001
10305058628052603844456070804548303630374260707850372030605650804044803320704080741
10004050002000400000004000500000700030000080500070004000200000608000006070607050001
10737060202750606565204622402260352080744470704077707026365477207850547030404772401
10007060300040200070008000200040300040500070403000202050000000200070008000303000001
10536060567050303030225460508040508424507050807685403040622760346060738427203047621
10800040004000602060000020304060003000705000507000005000400000500070300000207000001
10508524405436207074273050303044723060403252447064858720508358808870403530382068601
10300000503000208000500050703000000080400000000070000040504000004000700080006000401
10704880707036206080304760307355876770803468388445348030707064533545758046208728301
10800030004000005060202000600000603000200000200000007060402000200000300070007000601
10877745858633732080405070742650606080633835203052402070507320406580302735543050801
10003000300000800030704060000060207080004000605000507020207000704000400070000060001
10805060807620608530505075367080406044343030602050706020202022206074443060237043361
10300070402000503000408000800020005000200040008040302040406000005000000060003020001
10874560707084733060604640305632842840704250455020508020203526748472208634506760201
10007000305000700070705000205000000000400020207080600060807000000000200000300000601
13205053308620408265206074435028446863277070202060645258506020852850572433704442801
10208030400040005000808070006000000000004080007030000040007080600060000000600000201
10206030776080744060208080204220246350507020278087308030544070608037767830553050601
10706070800080200030005000600050000080300070006000402060000070507000006070005080401
10707070208554807245248527845085424030446868662360422083575356708023502042403060301
10208000705000200000000000002040500040000030000020004000000000005000600030004030201
10202020206050306663657868503060402038832070442077307848337782303730243470888730501
10007030200030800000800000300040007000008000602000700000003000800060000080000080401
12346020367520777630308350807346552038707854303060873857303070804053403048528057801
10002060000040008040006000306000002000403050002060500060007030606000303000008060001
10688078267680702073788030704080408880605070454340806060764220303460478633848070531
10000040000030204000000020204050600040500040000000708070000000700020000000500050001
10267640756070405363403740708050277050782826785257505070235483532075656720402387801
10700070006060800000300020300030200030000000000000002050000050005000000040500000501
16205042705037506520602020872768603878735044487862773068406025803636467050882520201
10006040005000808000308030000000705000003000000000506000805000200080002060000040301
10828080605670444025507038682520805663608037405270308030204740352060803067334440501
10600070500020000020008000000050200000006000800040007070700040004000303040200000401
10444470404053668350362330665030768230385330538063865830875230708624305060705637601
10000080706070004020700080200040500050006000400030000040000040800000005030300060001
18522060804070308070303057608380367020305025322780734072767070302632327060405050331
10000050302050600070402000005000700060706000000060004040005080200000006000204040001
10426350306060707430206476623060505530304862803034704060204030686043744068454080201
10300000703060300040300050000030200020200000506000805040800050007030008000400080201
10708030803030226250805060648344532052568830204580205030802277507530208230608353601
10507060804040000050803040000000000020005000407000505000800000700030500080708020001
10603026805067872050833056674634832030707660263042403366405570546070532034604050301
10004000502000208000500020006000004020200070700020004000302000805080003040006060301
10742750202630603028406680806048402070304078406370687080862028602086402060654080261
10000020803030006000600000806030006080402000002000200070003000002000503000300040001
14342020604027372828465484405220383070873675383043504054202028837450807533305027501
10006060700080000000700070006000600030700020007000006070006000000030400000608000501
10867050882630808750806060736030308250504060203745884040754587743860854230502440501
10300080800000200060507030000020400030006060800060000040007000000000703000400080401
10506270504262206850703035338040446038658280706067426647604026662582206053457056801
10006000600000506000507000004050008000800080606070000060006000000000707030004000301
10282023885520702043602444504666238785807020508060706073748085606350404080206570501
10404040000060205070004000300020000000002000305000802000002000500070004060400000801
10702070405020306040522030323070406585363342453084503547805380654063525070408563601
10002040304000202060003070000040205000002000007000500000300030008070600070400000301
15452070752255404082607026757560255055706072704828885050445076502060205260786470701
10000030000060008030003000700080007040004000500000002080007040004000400000600050301
10436653887074547030705666804037202020348230306346808646652080442237505457404670701
10000000007020000070800080003000500050000000300000300030000070004000700000600000401
10578643607060846740462040783330755838855535778352653020852222223080478288777736801
10000000200080000000700080000040000000000000000000000070000000000020000000000000001
11111111111111111111111111111111111111111111111111111111111111111111111111111111111
