11111111111111111111111111111111111111111111111111111111111111111111111111111111111
10000000600000000000000000700000000000000000000000300000000000400020000000000000001
17875088306034643380423570806073864728306522752750704057554860648040406086282722701
10000080007020000060007000504000006000300000000020008030000060700070807080000020001
10603380705080636020248032702065605860303674685027845860502030507560402430724030821
10500000407070700030300040007000600000600050007000000000307080700000200000300040001
10656748855084202763307570208260866884778340407230448582303070848328634227505683201
10004000005000703000200000400020003000000020200050003000004080600060000000005000801
14208060402030508080362820366023502064453040324026408042533060505050703753664070601
10002050206050308030000060500070502000006070800060208060003030004040400000003020701
10235050803230302055568080505860304362607044703070605030506058242080647782406020701
10000030408000806000500070600000802000008000004040003070300020002050000080004020001
10285620203078403033304760708748302050453874226070743040346520802042662070602043681
10200030802040004020005000400000300050006050002020300080200000308000005020507000001
15203270808030586040526054853250738067304020305080306780603627305063808030727523701
10003000204000400080700070000070005000700040203020400060307000702030008080003000201
10466030608536887260206754874080408380257640767025256050207088705070768070308030601
10700030800000000050600060004070200050600070006060007060007000005040000060807030201
10502260485420248070203030806068725057203086504080502037432323802070837524704085301
10303000600060006000604070504000003000005000700070402030004000508060300000300030001
10804055357032403672355030202743306460478560602880748040303730204046508370203040671
10002050006000500000003000800000200030000030500080004000200000707000008050505080001
10867050603530305435202466204580884020377780206047506042885486302430652020706324501
10007070400050300040003000200070200040700040807000702050000000800030008000706000001
10446020883030604020272730407070203225606030806633702070285670773080643335404066441
10500070007000703020000020806030004000705000305000004000700000200060500000708000001
10504226505588502057474030408077285040403278844042525280207732602360408530562057601
10700000203000506000500080804000000040800000000050000050606000008000300030006000601
10204330804088808020608670703737822430205455232346484070805088657574735047507824701
10700020006000006060806000600000403000200000400000007050505000800000400040004000401
10826682785535262020202040664740308050825457708023808030204560603750502766362050301
10004000300000200040703080000040302030006000705000703020405000406000200020000080001
10407020602320404770602063773020307056355060607080606060504088703053828080638066631
10400050505000607000805000400030005000800080006080302050503000007000000060005060001
10242270704085354050702620706876677230806440655020208070302743822672206833506440801
10008000504000200040603000508000000000400020803030400030304000000000300000400000601
12706065503530307377608085663068242527877030804040484788304080763550276254604365701
10403020600050004000203070006000000000007040006060000050002060700060000000800000201
10606080237050736050608070608350454270802030578035704050752060407046224520263060401
10503030800030200080003000800020000030500040005000708070000070204000004070003030701
10802080707847208836353638255045544040843746425750676044424843502042703065403030401
10807000304000200000000000003020600030000020000060002000000000007000300020002060601
10703020403030305824736856207020603075562030257066403566754886206320386450464750301
10002050200030800000200000300020002000006000305000400000002000300030000020000020601
13488050832280252470207350808727554085705427208040286786404060306033307083747068201
10005040000030002070002000208000004000205030003060300080008030408000403000008050001
10368063662380502072247080202040506360504050648470704020843750505330634553464030771
10000050000060704000000070206020600070800050000000502080000000600050000000500050001
10772570456050804834503270308060767020564288483247307060543735834032485260604875501
10700020006050800000300040500070700050000000000000002050000060007000000050500000701
15407036303087403330508060782748608855547047286544864023803042502634327060535780601
10007060004000306000808080000000303000003000000000302000803000500080006060000030501
10546020303370745033602075528850808844804036808650303050505820322030806054682260301
10700020300070000050007000000040800000005000700030007040600070004000603040200000201
10564420504048883650334870662030266660355430352067448530873860302448607060304424201
10000020505050005080600050800030700030002000300040000070000050500000007040400030001
17332020703030708060606084502880846050306057676330474077373020508643243030307060221
10000040406020200020808000007000500040707000000070007080004080800000005000202070001
10528420703040708850304443576030402770404378606037604080308070524078273022744060201
10200000706040800020800020000080600040300000704000704070600080006050003000200040601
10206050307020428670802020475227387027824430405850404070603223806550706220205565501
10705020806020000030308070000000000050002000402000806000800000300080200070602030001
10705085202075382080735066223248553050507880352038508384208850466060763086807080301
10005000204000607000500030002000004050600020600020007000705000407040004080002070801
10573840208380602055402660203065308040402058303840336060785037305068505050753040531
10000020405040003000500000302080007030705000003000600080006000007000603000400080001
15236070305065656735268573502780244050873255766036206028302056436560602228202088601
10008050300050000000300050005000800040600020003000004050008000000080700000703000301
10436080274860805550604070727040507650404050702352635050436336626440642450302250501
10200060800000300050808020000080600030004030500070000030003000000000505000700050201
10203880702236507870307083353030222063378720704047775538708086864737403084667024401
10003000800000805000506000003050005000700060405040000040008000000000407060003000801
10322053583350806063402362605685823782307040603020304083623087802250802050703540401
10507050000060403060002000200040000000005000602000207000006000300070004060300000801
10506040608020502060752030232080802555338854543057404535608580466075244080202676301
10002060603000404050006080000050203000006000004000200000300050002050300050800000401
12684060676255603076306042744460543064306062508442376030287078304070707720524770301
10000030000080006070002000600060003040006000800000008030007030003000400000300040501
10258262725022336080805754204058202070254230805264805625457070238834305676208840401
10000000007030000030700050006000800050000000200000400050000020003000300000400000601
10654425605040253420678060846220462786827528746475868070268842282060577855653823801
10000000300060000000800030000050000000000000000000000020000000000070000000000000001
11111111111111111111111111111111111111111111111111111111111111111111111111111111111
