11111111111111111111111111111111111111111111111111111111111111111111111111111111111
10000000200000000000000000800000000000000000000000800000000000300070000000000000001
14843076604047887460327630607046583373803478684520707086238230663050602028526738801
10000020004030000050003000503000008000800000000060008030000060400070704070000020001
10605820304030358060655023306043208560206287857027883560803030504560702370734040261
10500000703020400060300080002000800000700020006000000000407030500000200000400070001
10423766454057703477504870708540226877223740607740858674708070754884823633302543201
10007000004000302000700000700050007000000030400050007000005070300080000000004000801
13206040606070502060678280875058603047444070775066705028678080608050202662872070401
10005030606080803040000050500030802000003040300020205060008040004050400000005080501
10677080506770504055763060504380304664403077808080406060406034748020754752306080501
10000080407000208000500070800000607000008000003030008080200030006040000040006030001
10584270202037307044708520206567702030474234844050878060234430508053888070708062771
10800050806060006070004000600000800050006080007080200080700000405000002030505000001
15203680304040463060878026622550536076704030506040305830803743203035704020358655601
10007000706000700030700050000080006000800060303060700080805000402060004020002000601
10824030604323382540406555472060604730772770587034883080704044308050258080508050201
10200030800000000070800040003070700070600080006070005080003000008030000050304070501
10507840278340724060702070206046282054508035303030503034685527308070337378705076601
10405000600070003000707060405000006000006000500080404050008000508040700000200060001
10505086573032407546584040505732306340743860604630344020205750608083205520604080641
10008040006000400000002000300000700020000070800020005000500000806000004060305070001
10657040706330407575806563806230738050337370405087405062683248603370864020208386501
10005080200060400030002000300070700060700080604000407050000000300040002000402000001
10742020344020305020776250605030203828302030404675604020273870473020478324603065651
10400050008000507080000050407020008000403000307000006000800000600060600000804000001
10605534207488305082275050703075223030502547663084637630207857402570404360377053401
10600000407000706000400040707000000060700000000030000050607000002000300070006000301
10704550703063306060406680807736488880706765786737843020707068586787763053408442401
10800080007000004040504000300000205000400000500000004060603000300000800070006000701
10355486288834455040706060446860503060845437607022404020303560404370607726285050301
10002000200000300050303060000070208030004000708000404030604000406000300020000050001
10502030307670608580203063487040804086267040207040406030704068607065632020867023561
10600070507000205000805000600040008000800040007080803060306000005000000040004070001
10227350402032372060208840806326554660704750778050408060706737487275804666403220501
10008000606000700040405000706000000000800020604080200040606000000000500000400000301
14802027207280204635207074382086734686268030502020668857504040655340884625706567401
10702080700050005000507030006000000000008040004040000040003050200060000000800000401
10807020283070725040603030504550752680608020642048204080586070602048845820824050701
10404060500020300040007000200020000040200050004000606080000030706000003040003020701
10507050202253405757662662258043337070232737866440865073722652806033805063205060801
10207000602000700000000000002030300050000070000060004000000000007000800030002070701
10503070608030805763584542504060307066247020345048207384456734603380262830332460401
10005030400020700000500000200080004000002000807000400000004000600060000030000040601
18854030267730428820604340704876627043308543704050236828504060408038605073868034601
10007050000050007070008000408000003000605060005070300020002070605000304000005070001
10445032353730405082484020406030407540408080853450408070435460202450838865784020871
10000060000030405000000060507060500040600070000000803020000000200060000000800020001
10664320723070608652403730504050378070287245387426206030262453762055657470207858401
10600060002070500000400080700030800080000000000000005060000060007000000060400000601
14704056405082604850407060836367202287255054643668753085708023802658638040464770401
10005020003000405000306060000000202000003000000000508000506000600030002020000030601
10858040606380776057206063378540206467402057205370404020703380525040803027257440601
10200050500020000020007000000030700000005000800080007080400050007000506040200000201
10838660503024787340284530845040786640228330677066323280778450505727304020703567301
10000060308080008050200080200030400030006000800080000070000060600000007020600030001
12847060808070705070205087208440476060807074223870565053636060708445587030806080371
10000080508050500040306000008000300080402000000050005070006070700000004000704080001
10474250305030208460503568445070306460206368708022606020803030245034287072245080801
10300000706030700080400050000060500060400000808000408070200040008040007000200080601
10308040203070864750602040748625755056326780208360502050202825605860208250208724601
10607020608050000050808040000000000030007000505000508000500000700080500050307030001
10205024707055743070447027752787557050604430556053406648606830525070276084603030801
10008000804000306000500020006000008060500050800070008000603000502030002040006070801
10444850706380604043804550507083403050402022404780526080738047403086702040564080621
10000040708040005000200000205060004060503000008000200070008000002000507000500020001
15423030507075444423886635508820443070384236746025304057605034635470202456603063801
10004020200080000000600040004000400070800030003000008040007000000050700000504000801
10556050625420207250608070425080404350206080508448834040267475385670525420303830401
10800050500000600030604080000020500020006020200080000070008000000000804000300080401
10708270406285704380407066385060366024346360508082626338702086557853604036373074801
10007000400000502000408000002080007000300040808060000070005000000000503060008000801
10646025263350406077506767206283362342404080303050803048468054203840206080508230301
10403070000050803070006000800050000000005000507000505000004000400070007070600000201
10503060503070603040322040447020604826257884683067203727205440564034472050703785701
10003020403000208020007080000080804000006000002000200000500060006020500040400000601
13646050485258505076702054836220837027506044508328848070844042608060308550474360501
10000020000070008040007000400050007080007000300000007080007050008000700000500020801
10235268335022388040707534506043704050377680304472602757774030442435608438402640201
10000000007050000040500080003000500030000000500000500020000030003000800000600000501
10764745704040234460277080646860352836845877585366625070623532225050432387666233701
10000000300030000000300020000050000000000000000000000020000000000050000000000000001
11111111111111111111111111111111111111111111111111111111111111111111111111111111111
