11111111111111111111111111111111111111111111111111111111111111111111111111111111111
10000000200000000000000000800000000000000000000000800000000000600040000000000000001
16483026206025432670474680205038433245605444747850202023628840843020808064826438701
10000060008050000060007000706000007000300000000040008060000030300020406040000070001
10205270206060845050428043304068507340702668473032346250704040502480808770884070551
10200000408070300080800050006000500000800070005000000000604040300000700000600070001
10566233843055302323405880406330878537876850305820473885308070856473238884806335801
10002000003000205000200000600030003000000050700070002000006020700070000000004000801
17703040506050608050855840647062306038677050346065207074567060305040308763573040201
10002020307070207040000020700070408000005070700060306020004030007050800000005040701
10744060806860708076577040406880805753805054807020805050707047332040522443605070801
10000070505000803000400080800000304000007000004060006030800030007050000050005070001
10783340605086502026508220602625805060383585545080452050575460802047228040507032581
10200070408020004020007000500000200030007050007040800040400000403000006050606000001
15407460608060827080757054633540432072802080504020303460602787506064708030868862801
10005000708000700040600040000050007000600020602020500030705000808060002050003000701
10765070706227452770406364577080402340236240676056283060707035206030835080406050301
10700060400000000050300020004080500050200040006080007020004000006060000040408080801
10807450488850258040408030503026887027806023303060802067223835608030467727805037401
10403000400030002000703020404000004000002000800050407050004000407060800000800020001
10703043463054507237333040804654302870573440606280786040302530505042504650302050661
10006060004000300000008000700000600030000080200080002000200000306000007070603070001
10566080207240608748203582806670287070267470405055506023854544603580372040607286801
10007020600030700050006000500020600050200040707000703030000000200080008000207000001
10278070327030606060682530202040407663505020307445404070246820447040383224807064241
10800040006000702030000020205030006000705000408000006000800000300050800000606000001
10404758707566704023733050407078636060803424485028678850608672803450302740788062301
10200000203000405000400080504000000040600000000030000050506000007000400050006000501
10602850802042302070305220306356723420207368372778587030808066464853266052805522201
10400080008000005080506000800000505000600000700000002050507000700000600020008000801
10272738248725374080202070748260407070546777405073205050302240408360805744754080201
10003000200000800050305080000030307040002000604000806080705000403000600070000080001
10802030708250402450206078324020406037375020803020508050506073608075463060855082381
10200050507000203000405000300050002000400080002060605080205000005000000060005050001
10543520204023258080705560508743622330703240377020804080505886434682705883202830301
10004000706000300070808000506000000000400060205040200050805000000000800000500000601
15603088205640408852306044572037665534424070607070246235803070772440363655707587601
10505030400060003000803040007000000000006030005020000030008050500030000000700000301
10703030762060435070408040508580245270707040552022404080682080208046354750475060301
10305050200050700080003000200040000070400070008000707060000080403000002040006060401
10305020705464806345226787886082763030772874743340768085367674405036608027203050401
10503000703000500000000000003080700070000050000050002000000000008000300070006020401
10306050703080503466767587805040708074588020237023604685576784207620784650428340401
10004030500030300000600000300020002000005000808000400000007000300030000020000070401
12565020742320388430702760408344547036405728707050765286805040606033506054773025301
10008080000070005060003000408000002000804060005050800070005060705000502000007050001
10565084342480402057887030503060205660602050385470308080868880403330476582234040751
10000080000030508000000030807080700070400070000000605020000000300050000000500030001
10878220586030402246306670302050528070762848687476204020482423732066744540307586601
10700080005040600000700080800070700070000000000000003040000030007000000050300000301
17405042408063808350504020242674703557347055583345677046603038806554726040774840201
10004070004000703000404030000000608000002000000000308000204000800050004080000060301
10222030804370857068806063642250402325306037603330802050702520848050406077537540301
10700020200020000060003000000060200000008000300040006020800020007000406030500000401
10776680708023485670446720664060425820882830474065845250458350603372804080607524801
10000070708020007080600020200080200040002000700050000080000080800000004020200060001
17844030205070707080405087405620776050603086375730635044775080302348358020806050581
10000080402040300060704000007000500040807000000080005040007050800000005000604050001
10456680806040404560307664436020707280606242608035207040807030766052775026738070601
10500000708080800080400030000020700040500000807000402080400070002050004000700050701
10804020206020535380403080474235827038467380408780202080703446202370505320403647801
10206070707040000060604060000000000060004000503000504000300000700080400070304060001
10407075207045534060788072533337844060504680472064208574306570225080783088308030501
10006000804000404000800080005000002060400070300030002000203000803050006070004060801
10725740304760707042402580604044507070205043805580786030666054607047205060457040281
10000020405020008000200000508030004080304000004000400030003000005000602000200030001
12825060404058756784643238503730572020645634343088705067508063588750502785602057201
10002040200080000000300020004000300060200050008000004080002000000060300000304000501
10843080542380308270707060555030307260206020403278268080884225685220587750606460701
10700070700000600040204060000030200060002040300040000030007000000000507000400030501
10805260702723703880307075566040628066238620606052434462706085444444403057268035801
10003000200000807000606000008020008000200030303050000050002000000000504080002000801
10223087866530806036603628808357367553706070508070808076685046206470506050304620301
10804030000070606060002000300060000000008000802000307000006000300020002080500000601
10202050307050206030783060288080606257342682262025406487508630735028443070608887401
10006030702000602070007030000050804000007000007000700000700020008070600030600000801
14888040587658706082608035475460487076204027805448676020828027405070507230724540701
10000050000080008050003000300060002020007000300000006050005030008000300000600020701
10374542568057644040604343204078307030852230602784808843787030684554207263305330701
10000000003050000030600070008000300060000000700000800080000020005000300000300000801
10473577404050257740882030766250667445423433685742567050682337877050667468523262201
10000000400020000000400020000080000000000000000000000080000000000080000000000000001
11111111111111111111111111111111111111111111111111111111111111111111111111111111111
