11111111111111111111111111111111111111111111111111111111111111111111111111111111111
10000000200000000000000000800000000000000000000000600000000000200070000000000000001
13683024503044855680586270504057877368308547435880605037256530267060506066258788701
10000040003020000050003000502000005000600000000030003060000050300020303020000020001
10307570403070327030252025206026703250704328635065337330408020303740607560474050441
10300000207060400050700080003000300000400050006000000000502030400000800000400080001
10582782734087304433305380408780248574845780706820437386305020546324438437207525201
10005000005000208000800000600070004000000020800070004000004080800070000000004000601
17302050308020408050866680432053704047855070462032604057875080604070707582224070701
10005040402050708060000040500050208000003070800020606050006040002050400000004020401
10223020302330804023423060303570503468704075504070206040308068685080342345407020701
10000040707000604000300040500000803000007000005020008050400080008070000070005020001
10336240808077705026505860806634303080677387438070566060658750502063755080403045431
10800060504050007040008000200000800020002050006060600060500000308000003030702000001
15606650308030665080636084365850526075804030704080607740604558402035607060665782501
10002000805000400030400050000080004000400080206050500020302000807050004080003000201
10477020807374277350506485846070707840676370574036254080605057706020576020202080301
10300060500000000070700020002020400070500040003050006020005000005060000080802050201
10504770763620868030306080702068864064406076504070608067668437302050543263602073601
10204000400050006000605020807000003000003000400020308070003000203040400000500080001
10503074288064504658643020403652503230833680602320535050805520305047707340706040721
10007050002000700000004000700000700070000030800070008000800000608000007050507050001
10574030707440808338408268403230662070648730805034207047782625205350264020807765301
10004050700070400070008000500060700050300050804000204020000000400030003000504000001
10842050522060804050788420705050704285805080305563807080246680467050886664608032261
10400060007000402030000070705070005000507000402000005000200000600070500000206000001
10705244604357204048444020308023668050705555384053258250402246308560405260645053201
10300000303000706000600060805000000080300000000080000030402000007000200020004000601
10708480804033207040705250804372248270606283378426222040706044472484785078205283601
10400020006000006050603000400000602000500000200000006060704000500000200080006000201
10584356735887225050602020867750807050833758707087604040404730407780704457436080701
10003000500000600060806060000040602060006000406000403020706000503000300040000050001
10808040303560407770406066262060802035756070207040705020303047805035458050856054231
10400070504000202000808000300050002000300030007050702020804000007000000030008020001
10382570408032245050702440306375352220205280476060708080406368725555505676602780401
10005000202000800050303000602000000000500070508020300050502000000000700000700000701
12304076404460806332208065646025556222787070707080347583606020762470355745408634201
10802060500040002000204020007000000000002030003070000060007070200050000000500000601
10803040846070866040408050806740236220808060523028405080433050302054775330827020601
10508020700030200020005000300070000020200080004000502040000060204000008060002070801
10403070207526804378774633883028372040334436423260472026352754602044507088508080501
10702000308000700000000000005050800040000040000020003000000000007000500030008070701
10406080503030408378364885302080403083547060865044207448237773803260567580533480601
10007040200030600000600000700080004000005000805000500000008000300070000030000030701
18543060364570464440306840506536573048605887606080845657403040408026704036578046301
10003060000070006030007000802000002000604030003050300070005040506000807000008080001
10267044268620304068722040307070208820404070647260304040524770405470374736677080481
10000080000060304000000070303050400020500070000000503020000000600080000000200020001
10488430486050604845506570508060624040324583482235308070324226883026578570806374501
10200050003030600000400080700060800020000000000000006060000030003000000080600000501
14406043408046808440802030248637805547737073233384383072302077702566588050337540201
10007030002000303000706080000000606000005000000000804000303000200080007020000050601
10538020404530876056602082626570806286706033708680702080702460467040608085282830701
10800060600080000050002000000060200000002000400020005080400030003000306070800000301
10658340507027252780322650527030348670642880556052388660848340303333707080206246601
10000080704040002060200060500050400050007000800080000030000040500000004060400040001
16442030605030308050802065406280278050405033644540357083566030603733558050206040331
10000050405070800020703000002000200080308000000050007080008080200000007000806020001
10876250705070805260208465733080406450806687202037302040305020636024856046744020201
10300000702040800030800060000060300040400000307000702030300060006070003000300060401
10603040706050568530203060448725275085568460404320206040305333803320708660506375301
10606030403030000080506030000000000020002000607000702000800000400020200040802040001
10204023408076372030442073256775722050806280782043708533403260834020264033605020501
10003000602000408000200030007000004080500050300060004000507000506080005050002080801
10238280204230607036807340606023802050605034205570522050273052206088207080445040561
10000020402030002000300000505020006060407000005000500070003000005000604000300040001
15875050707083723835654425803770528040544324542073508057308055477520307654505055501
10003070400080000000700070008000500020300060003000006060005000000080400000804000501
10632030224350602560807080673020207230604020305774657030568478338620244220603220501
10600030700000600070703060000080800030006050300040000050006000000000208000200070301
10408750406477407460707052853080778043328420408058732232206066354352707058288065801
10004000500000403000303000002020007000300030404030000070006000000000702030008000201
10634086758770404032502376707663472555808060303050804065432028808220704030707450301
10808050000020203080007000200050000000008000206000308000007000500050004070400000601
10202050805080804060246020463070605473722566824055308388607860784022788060804745301
10002020506000203070006040000080406000002000008000400000600070003040800060700000401
12646080224758508048704088736360865028505037307276373050368026405040502870633380501
10000040000050005020005000400020006080005000500000006050005030007000800000800060201
10664564644088488030707855802085302050232560602338205445284060756677202248306650401
10000000006020000060800030007000300020000000300000200050000080002000300000400000601
10764774305020774360582040742750434636438834767265482070323478758080552276225584801
10000000500040000000400070000080000000000000000000000040000000000040000000000000001
11111111111111111111111111111111111111111111111111111111111111111111111111111111111
