11111111111111111111111111111111111111111111111111111111111111111111111111111111111
10000000500000000000000000300000000000000000000000500000000000400030000000000000001
12258063307065867530483740307032344856208863672420702024568750572030407084464765501
10000050003050000070006000502000008000300000000060006050000050800060804060000070001
10803880503070744040455076306023803530803362674054473430804040302570503330836020381
10500000702040700050500070006000500000400070006000000000608060300000600000500030001
10762878823063708287804770208260327363638450802670886284403060428324435868506585501
10006000007000202000600000500030004000000070600080005000006080600060000000006000601
15408080304020403040232220266088802088334040377083504065848040506070704872743040201
10008070507060403030000040800040205000008040800070206050004050006050300000005070201
10562060306330204056457020404250205872403062505070402030603075744060537878705060201
10000060805000404000200060200000605000004000007070007030600070006050000070004050001
10785720607022302075608820802772708060636435246040734030478580803058347040806024821
10700040303050003050002000200000800050005030004050600080500000502000007070504000001
16502380405060642040687042426720265067403080207080403880407642804084507080757632701
10005000308000400040800020000080005000700060604030600080205000303020002050008000701
10773050208825743450706623368030303840262430465088464050305025504030538020208030601
10500040800000000080600080005070400080700050004040004060008000005040000080604030201
10802280323380253050804030308087244042306042204040703053435563207020553362302024201
10503000200070004000302050707000006000007000400020308070003000307050200000300050001
10405054522047404357483020408475602380768560502530342020707230403078605570405020541
10004060002000800000003000600000600050000080700050003000600000308000002050803050001
10436040707540308472502467808230385040624520408035804078328348807450825080804583201
10007030800050500040006000700030800080200070804000406080000000600080002000606000001
10662080366080803030866670203060505236806070804587203040876660622040763625703026821
10700040002000608070000030307050007000308000803000007000400000300070400000705000001
10802387806252706033732030406067848050605345266042365340407742404880606280588045301
10500000303000703000300030804000000030800000000040000020605000007000400070008000601
10807350405046404060706380705643757470608537462848526060703032234247855072803678601
10500060002000002070308000500000306000500000300000002060503000400000200040004000201
10555565274822422080408030777550204030748224305035803040405350805630203757438020801
10006000500000800030704060000030605020008000503000803080704000704000600040000080001
10702050407870708630808042734080805062264070302050308040602082702068476070852034861
10600040203000307000204000500070006000400080006060203080607000003000000050008060001
10547340404053633020808860407744562530302680836030302020508845322876606478703450301
10005000505000400050307000708000000000600060803020500030602000000000700000400000801
15308088208430503866806028863082428536384020203060687336205080332680884548307726601
10406070700020006000604070007000000000002030003040000050004020800040000000200000201
10203030242030572030405040408680266480308040758085702020462020505026864670552060501
10702030500040500060007000300060000040500040008000308060000020805000008060003060501
10806080808346406762224565644032567020888568676370725023843524802064306058205020601
10505000202000800000000000002070700040000080000020008000000000005000600070002040701
10303050808030706525663262206060402087227030568035403223273624802720362780242270501
10004050200080800000500000500060003000007000307000400000006000600040000070000030301
16844070275660476820408280202327357047408456405030777452707020504087704082742047501
10008050000050006020005000202000004000306020002020200060007020507000406000003070001
10773068442560406054452030806070704280408070334360408070768680803830347435224080381
10000030000050506000000050403070200070800060000000708040000000400070000000700050001
10648470874040202764404670704050346080377852466427306080345425327075765830205645301
10400040008070800000600070600020400070000000000000006020000080004000000030200000501
16408033808035704750205050833623302825726026236368428072703054406554857040826460401
10003020003000403000707020000000503000007000000000208000808000800020007080000040601
10573030503230427037202027774620206643207037307870607030208820548040508023753860401
10400040700060000020007000000030600000002000500060004060600020002000302050600000601
10657520208053574440684880428030323570433660848052347740735360506524203080407486501
10000020308020008070300050200060400060008000200070000050000080700000007060400070001
14775030503080502050404083702370277030605028453480646058276080805278863040708060521
10000050804020600050803000008000500030305000000030005080007040700000006000208070001
10555870207070405660504765325020508380802545806044305050804080354033544064823040301
10200000508070200080800030000060600020600000703000707030400080004050005000700070401
10404020304060557630207040525455422024777350407650607070605578204720805450503624201
10702020802050000040308020000000000030003000502000207000300000600030200040206080001
10704036406028348080436077753638727020206470558063305625804750385040372073303040501
10007000808000605000300040003000004030400050700050007000408000408060007040003070801
10383350503250503068303730802046608060505072707670276040284057705074602080653030741
10000030306020004000300000205050006040602000007000400060002000006000407000700080001
12764070608067532847244228202450723030562243463082205074806062644350805654402042801
10008060600070000000500070002000300070600070002000008070007000000050600000804000801
10456060437620302260608070553050402540405060308244443060642484446280282640803580501
10600030800000600060404060000080700050006020600030000030003000000000502000200050501
10603470404385204640203048866070465078842470706066437338605077738683507046573085301
10003000600000708000606000002050008000700060806080000030008000000000402050002000801
10843022375740502054702384808863562253603070406050805033284034202340503050608870701
10306030000030303080002000200070000000006000405000307000005000500050002070400000701
10307030307070308030445020572040205688363688648055803434306360352037255040203635701
10002050606000503040003070000050806000003000005000400000300070002070400070200000501
18248070358764807048702055575530552036205047805823253080847088702050304340788370801
10000060000040005020002000300070005080007000600000007050005030005000800000200080201
10782588587073374080804738807044705050823480808383208237756040843784804666503750601
10000000007040000020600060005000600020000000800000300060000050007000400000700000601
10872874504030478850644080286730634468435273327584523030388454787070257653844537801
10000000500030000000600070000060000000000000000000000050000000000020000000000000001
11111111111111111111111111111111111111111111111111111111111111111111111111111111111
