11111111111111111111111111111111111111111111111111111111111111111111111111111111111
10000000600000000000000000400000000000000000000000600000000000800030000000000000001
12586023703026842670334540205088827335507785666460402023863660558060605037862272801
10000080006080000060007000707000005000300000000050006020000020400040602070000060001
10205550307040868070557048707056207480502774433035465750703020702260307540576070661
10200000304030700030300030005000700000300050003000000000602070700000500000300030001
10863724662025805333205350306380785522457820205320366867408040452258232862403854701
10007000007000204000700000400040007000000050700040005000004080300070000000004000501
14402030308070205040745230468046503052255040576075506064624070206020207827464060801
10008050708030608030000030700060607000003040200080305030007020006030200000004050301
10573060607480205033447070602540804847706062207040604060505026578060522268703020701
10000080503000602000600060600000805000006000008080002060800080006040000070003070001
10364880804048305088706340406376507020327868328040528080662420602024726070704062871
10300030706080002050008000700000300060007070003020200080200000508000003040605000001
18505850602070556050522028467260845028208040205030505220506358708044702030667652501
10004000706000700060800030000020002000600080707040700080604000205050004040006000601
10758060507386584660506433253070405270523360847048754080304026607080353060803050601
10800060300000000070400080005030300020200020004050003020005000005070000020803070501
10308250847670723060503040407052635042502054604080503046322723604040363474502052701
10203000700030003000402060703000002000004000400070708030006000303020200000700030001
10207065328035204548278060302453303780456280307750843080703460702056706640807070451
10006080003000700000008000300000700050000040800060003000200000403000007030405080001
10525060505240304628504238606340273080283780308025705064685664302670465080304278701
10002060700030400050006000300030600060500030404000805080000000700020008000403000001
10654030767020507040463370505030306626608050503244302080474480538020775224808066581
10800070002000508020000080207040002000607000708000005000500000700050300000203000001
10805885302836803086465050503082772050205474444053233520305578408770806520476024501
10800000702000504000300070202000000030700000000030000030202000003000400040005000801
10602450407028406030606340302424288480404833467362763040506024845753454032308843601
10300030002000003080608000500000505000700000700000007050503000400000700040002000801
10656355858647742030607030767780702020573852305076508030606840707640806844627030501
10004000500000800020508070000020308080008000608000708050307000806000600050000020001
10707030807670705670305025358060507047252060202020305030204037305062622060472054751
10600060207000802000407000400070006000600060007050702040602000006000000050007050001
10638470303085232060502650406883726680804720653030708020403362375367204227702740301
10008000308000600020606000302000000000800050807050700040403000000000800000400000601
12308047706780506784602044335045842226335080607030286746204040827870264788807523601
10404050800080007000705080003000000000008020003020000050006020300030000000300000701
10604040342050224030606080802530245840203020446064204080547050205072524470845060301
10405040600070500040004000400050000020600050004000605030000070606000003070002080501
10608030306384607556657855362042338060725384355630774065647246205062404045404080701
10304000808000800000000000002060700060000080000080002000000000004000600050002070301
10503070504030305677467722305080208067468030757038404664562755708750733260275540601
10004020600030300000200000500050007000005000704000300000003000700040000050000060801
14726050565330522550608840703827633077308653605020652824703050405034706086265036201
10006070000060007060002000606000005000202060006080500050003080608000405000006050001
10836045844230806034786050402050304380502070387670602040472380203820677883862060641
10000050000070802000000030707050600050300030000000507020000000600030000000200030001
10238450582060204268205370603050436060465278456565808080665423365084285770304745201
10700080008040700000500070300060600020000000000000003050000040004000000040700000601
16508053307067404770405080724373408747242058545377226043203027202578865060575230701
10004080002000503000502060000000203000004000000000502000504000500030007040000060601
10322020505260268067404057623260606867308028608250504080708580235030604052432240501
10200060800030000030008000000040600000004000700070006060600030005000208030600000301
10584870703023233630554840746040833350767270437038778650582660707844807040703563301
10000020804070008070200040600080800040006000400020000080000080600000008060700050001
18766060605020504080504085708830778030508032622340244038727020708545425060507060341
10000040806040300070305000004000800040603000000080003030007070500000002000705020001
10354570604020207670506583877020302750708667308033406050306070623026383062844060501
10500000605020800060800030000030400020300000606000605060700080006020008000600070601
10504040802040544650302020223845532023848740608760206030207254404350802760704227301
10402060303030000060203060000000000030004000604000403000600000800030200080703050001
10508078804048444050534077387738862080402230627067508258806840376040887065607070601
10007000203000204000200040004000007020700050800030008000507000702050005060002020501
10384760803450305087204630807067203030805066803630426040558088605055206020745020721
10000070405080002000500000302080008020606000004000400020002000003000203000400040001
14248050703037843447265673702560855050675783873044302085503042265650504487604055601
10008020300070000000300030005000500080200080006000006050006000000020700000305000601
10236070747340605640507040564040208350206020508536564040544884728830648840206320401
10300040600000200060402040000060600060002030400030000070003000000000506000700070501
10606520205274303440403028238060327023237360605055388267504026542442504034862028201
10003000300000806000808000007080006000500070505030000030004000000000808060005000501
10634083322570306058804833204477848485403020407080802028546062403450504020302660801
10407070000060805020008000200020000000006000305000308000002000700060002070800000201
10408050402020804080288030547030705728562672684057405256303860543082467050502624501
10006040402000406040008020000030405000008000002000300000600060006060500050500000601
17253060667244603062403025684780766083605086406422264050264026203080503440663270201
10000030000040003070002000600030002040004000300000008030003070004000300000800070601
10487634353023655070802528804088202060754480703865604836628060445832803686202330301
10000000004080000050200040007000200020000000800000300040000050006000500000700000701
10766854604040846640844040252660832223486824346634455080234547766050838475528225701
10000000700070000000600040000040000000000000000000000050000000000060000000000000001
11111111111111111111111111111111111111111111111111111111111111111111111111111111111
