11111111111111111111111111111111111111111111111111111111111111111111111111111111111
10000000600000000000000000700000000000000000000000200000000000600020000000000000001
18864068507056328820837530606054668223204384686660402062342470826020306056384474601
10000080006060000070002000402000007000500000000060002020000060400020405080000060001
10202270405020733040785056204034302330503762385054828870702070306770503850828030871
10600000607040200040300020007000500000700040008000000000705070300000500000500080001
10574286656084306263304260702360848462378430406460846364302070838786434238704755601
10007000008000607000400000200020003000000060200020006000006020800030000000008000701
13503070707060405030785730385063507044628080866074206046434020807030605726862080301
10005060406020603030000040700050406000004070200030805080002080003040300000003080701
10562050608450405036383030504770707254403026508030807060606065834070644688407040701
10000040802000503000400050400000606000006000003080003030200040006020000030003020001
10376570602038504042807670307727407070647787845040267050275580507074335070202052461
10800060307070007050007000800000200080004060005040400040500000507000004060503000001
16304660806020537080877022365480437074202030404020204680508448702062706070573656301
10005000502000500080500060000040002000500070203060800020303000308030005040005000301
10427040803454872850503325235050403570487730523062724070405064202030228030505050701
10200070300000000040700080003060500060300050008050003040005000004020000020805080701
10302220546540375050505050608083454078602022802030802023472342202040224848608067201
10706000600020003000505050503000002000004000400020807020003000204080800000300080001
10704046442032206883338080807643605520645680202280276050402240605077507260302070451
10004030002000800000003000600000200040000060400070006000300000302000002050507020001
10384020306280604388508787802320686030367860405062808087445787805380433050503883201
10002040800070500070008000300080700070500050707000307070000000600050002000703000001
10764050886080705080267760806060205873707040305833307040252270387050565823504083771
10600020006000706040000060405060003000702000804000004000400000400070200000606000001
10504468304445708023667040505037358060407288753046642450305283408770506450785056501
10600000806000507000500080804000000080600000000020000070802000007000600080006000301
10802860208062205050508450502584438850306457834768623070407024263384658056605533801
10700060004000003040605000400000208000600000800000002020608000500000300040003000401
10588853267582476040505070833450702070856433206035408060607260807520205287823020701
10003000300000200050502080000060208050008000803000607020708000404000700080000040001
10203050403370803560706022647080504058877080602050408080405085403082772050563026761
10300030602000303000205000700070006000300030005040805060408000003000000040004070001
10338640308045627020702570407556232230507440483060308070208345376234708384705280201
10007000507000600040607000608000000000500030306070800050208000000000800000500000601
15507054202740207333406072437052243877363040204060453587403080654420232443206867601
10508060700040006000407070008000000000006070005050000030008050300070000000500000801
10808080643070628050403020606360737280803020588056803060444050607028468420445060601
10508070500050500030002000400080000020200060004000808040000020408000008040004030501
10706020202787804553347774686045352070355274748650886065736653505062502034202050601
10706000607000300000000000007050300030000070000020003000000000003000200060003070601
10308080808020407624346836408060805042456050725042507434557436504220483280257230201
10005040200060600000600000500050005000008000508000300000006000600040000080000020201
18247060448340457240507440704485667076708427202020226458807080407036607052727076701
10008070000080002060007000508000006000708080007080700050002020803000602000003030001
10422055343280405088282020403030702860607050568740303060786780706680788324478030331
10000070000020508000000030707080400020700080000000307050000000700030000000800020001
10433650557030807563306760403070523050386622273872704050445754553045882870804383201
10800030007060400000700060200080700060000000000000006080000060007000000050300000601
13706034604043204650208050864428408827882033547423672078603082507747436080362750801
10002020005000204000505020000000302000008000000000705000404000800060006050000020401
10652060308330868068705086753660302234402048605370703040407820446030603076852830201
10500060700020000060007000000080200000008000500050002040400050006000603040600000401
10523370702072275270233730686040652750556280867038326440734680305226807050408685201
10000040302040004030400080400050300060002000200030000040000020500000006080700020001
18464050308040303020407055404840335030606088238750657022746080706562647050808040331
10000050708030600060707000002000500060407000000050008070006050400000006000806030001
10875230207050707480408374662040508460802783702036205080406020248046334075346060301
10700000208060200060300020000080300050400000608000704060500030008050007000700080301
10508050606070534270702040456737577054663430607420705080804788206340507280503587401
10406070604070000030807020000000000050007000403000503000700000500030400060806030001
10306067702082555040376033755333343060604230322053704357502370355030286032407070201
10004000605000707000600080002000003020800060200080003000403000204070007040005020201
10485850208770406036708730303068406040807025506340843030552076203028704020625080871
10000080608030008000700000803020008070305000005000200060004000008000303000400020001
14388030806078586886463624207420488040728727527055706077702075222550403752603074601
10008050300030000000500020002000500030200070005000008050008000000030800000705000701
10282080842350704820206080252030802560603050507772434040853458777860666330604650401
10200070800000200070607020000020200060004040700080000050002000000000308000500070201
10804770208375307370505086782020556044485840308088664325305042752528802084452058501
10002000200000707000602000006080007000600080608080000020005000000000702030002000501
10268048354530805065308485706535664846204020302030602043258036702440706050304240601
10502060000030402050007000400070000000008000203000507000005000700030003050400000401
10704050704020705020783020673040405758265478383026307363503460434066665080707427801
10006020604000803080002080000020302000007000004000700000300070002070500080300000601
18466080365567705062303028532770826056806036705443684050277072706020507660656860601
10000050000040003050003000700030002060008000700000005020008080003000500000300070401
10772585257047337080304422603073608040634670703676606354646050288266806783806220501
10000000007050000040200060008000700050000000300000300020000040004000300000500000801
10854532503050527780638060654680675322586776463458246040734585688050224858452343701
10000000400070000000600080000070000000000000000000000070000000000050000000000000001
11111111111111111111111111111111111111111111111111111111111111111111111111111111111
