11111111111111111111111111111111111111111111111111111111111111111111111111111111111
10000000800000000000000000300000000000000000000000300000000000500080000000000000001
16843066205047776360453740604074362224306764484620504063782770248050605074678374401
10000050008060000050002000307000007000500000000080004030000060600020803050000050001
10404270206080287080453052608063207230506268545038733740703040507440507460853040641
10400000505030200040800070006000600000600080002000000000603030800000400000700030001
10246682757073206757204860706870778888278720305720433348806020885727355355203525601
10002000004000808000800000800040002000000040200040006000002080200070000000008000501
15704020602060808070653530432043402024664040545067607074477020506070504724475050501
10005070408080408080000040200020603000006050200030808080008030005080500000006070301
10437030308870706042326020305480407247404022503030602080302025645030887835205030501
10000070406000204000200070600000202000008000002030004060200050002030000080008070001
10577230304068404064205620505754804060343447764020447030233360702025472080303073381
10200070203040003030007000300000700080002020008050300040700000408000006050706000001
12803370606080858020486077853740523065202080604040504220406565403035706040228684501
10002000206000700060400040000060006000600060205080700040504000602020002030004000501
10788080207874866680206647843060507630877320287042474080304065604080248070306030301
10300050800000000020400060007020500020500080007060006070008000003060000070302080801
10606560543420275020305040404072775022508067205020604047633766407060366724704052801
10206000300050006000804030306000003000003000400070607030005000308080600000300050001
10806023632052803347476050304643506620827880704460484080705680702046402540407020821
10003040002000400000006000700000600060000060400040006000500000702000003030206070001
10282040504720803678602685207860452020437280203063807072648455306870254050806663801
10005020700020600030002000500050500070500060405000308030000000400040006000505000001
10452080668030703050444430807070805557202040502263303030748270578050273772705056541
10800030006000603080000080507030008000504000405000008000200000800020500000306000001
10402274504758204034342030207037675080805863684066388570405278408360502740344046401
10600000702000403000400080605000000060800000000040000060704000003000200070007000801
10602660407082202030508530408585288770506573654425627040502073234757255023306267601
10200040008000004080507000700000805000400000700000004060708000500000400020005000801
10286333762378422050302060583360302030654873205028402050404580602680406737732030301
10005000600000800020303030000080203070006000804000705040504000805000800050000050001
10208040503470807560304033375050504023424040507060408060208076403054358020354064581
10500050407000404000802000400080007000500020002060805080304000006000000040008040001
10776270705027333050806280603644455370603670376080705030606423364365403675808570401
10003000207000800080802000803000000000200070404060500030504000000000500000600000601
14403053803470208636508076456064456422585030606050742567508050763350352732707862801
10705050500020008000403070005000000000005050002050000060007070400020000000800000201
10405070665050248030308050207650675840208070786054206080573060803036227550372030701
10707080300020200030007000200020000050600050007000708020000050802000003020008050501
10504040704277404543667558848068463060346828725380555053623776506038508072204070701
10504000206000700000000000005050700030000050000070002000000000005000800080002040601
10207020707020507254785825802080303028837080342037602562366472507820665280685860801
10004020800060400000400000600050008000008000705000300000004000700070000060000070401
13826070758260833880604730206263385076603768202040428646406020607084802084285035201
10004060000070006080004000403000008000207070004050500070003060804000702000002030001
10272083623520402043457070507040406680406070655880505050373460804440862745437020781
10000030000070205000000020205040600080500020000000607050000000400070000000600050001
10847550232050303383403630605030743060857473654273306050764753653053657680805822701
10300070007080200000700030400060400050000000000000004060000030003000000030700000401
16202058308024504720708030425385706753554068228622783084808026607873358030683760501
10007050007000507000204060000000802000007000000000205000405000500030008040000020701
10235050506360333086502074225870207258304058204320708080506630652030307044625280701
10300060300080000070002000000030300000005000700060004030800020003000302040200000401
10844740507043256730478570568040658530427780452045264630424560602235802050307363401
10000050208040006040700030800020400030008000800060000050000050200000005080500020001
13343050204030705040604064205380282030807054275440855085326020405466648060208030621
10000020408080400070702000006000600050506000000080002080004030800000005000308070001
10474850404040706460306282876060508840307586607024202060604040726084535042856030201
10500000506080500060300040000080200060300000308000506080400080007070008000400080601
10608030806030655270707040583885324022554250303550407030503422704760607850206286801
10806060202080000020204070000000000080002000703000705000400000800080200070505050001
10305073805027383070355043424242263080707340863045306476305560625050846052503020401
10008000303000403000600040005000004050200050400020008000805000608040002040004020301
10256540806740206048705280204034403020303044802260577050676038204073804070388080721
10000020808030008000800000503080008040603000006000400080004000002000605000700070001
12376030605083464388684328205860886080445585357023508086702065825650405423702085301
10008050800040000000200070002000300070300040006000003050004000000020400000403000701
10754070467220503330408080833080605360302040603554282020886745264340324720503620201
10300040700000300080504080000050400030002080600020000020008000000000808000200020201
10202780306536303480807028778070288044388620308026867856705063743775308067728065301
10008000600000603000404000002040003000700020507020000070007000000000202020005000701
10837074466860403072305332705654726725307030605030808042655078403250305040204840801
10406040000040206080003000800070000000008000602000803000005000600040006050500000301
10403080507040803050686070683040705877257865263083205287202270346044782060407582301
10002030704000407030003020000040306000007000002000300000600070008020800060300000301
15566080258453207063502078584870582066708037302748467030447082807040405670752840701
10000030000020004030007000600080002080008000300000006030004070005000400000300030401
10373624327068246050602568705056404020435740402284802585353040738788706655506270401
10000000006060000030500070008000600060000000600000400020000040007000600000800000601
10873776802080873340422080533730653333867484577366778050638637347070682735443583501
10000000500040000000600050000050000000000000000000000060000000000030000000000000001
11111111111111111111111111111111111111111111111111111111111111111111111111111111111
