11111111111111111111111111111111111111111111111111111111111111111111111111111111111
10000000600000000000000000300000000000000000000000800000000000200070000000000000001
12875053308046567670462730308083387765705873682720605075872260752030406063727567501
10000040003080000020008000504000003000500000000070002050000030300020304050000020001
10305480306070828020786062706034405540403466682046765360303040803270505850425060781
10600000805030300020300020002000500000600040002000000000203070700000800000400060001
10554456582045508323602670703530343478852270802250223655707080444482873448305543701
10003000004000705000800000200060004000000050400050006000006050200030000000007000601
15305020404070203040432420856054806054226040474057604033636040305020406247628020701
10004040506070307030000030700030607000008030200080405020004060004060700000007020801
10346050804640804073474080806460408722604048606020504030707077468070523664604040401
10000050207000305000200080600000203000007000002060003060200020002020000030007070001
10577380605063305086502850403368207070686423675060674080848740408062626070805073651
10300030405040005060005000200000300030002020006050700070700000802000002060803000001
17408280802060477040455065282370354034406030706030503780206446707084805060883723201
10003000804000700030700040000070008000600060302050400070502000502050008040005000801
10653050802262273780507427857060208560635270855084227050605057507020465030404080601
10300030700000000070200050002030300040300020004060005060003000005040000070402070301
10807570365520246050406020702048854034504065503040308054748387602020572588205035401
10707000500030008000606040705000005000007000200070804080002000607080600000700060001
10204028654083707328375060608842703530474770702550255050202750708048306670504030261
10007050002000600000005000600000400020000050200060002000600000607000005050602040001
10572060308830602727405757603520442040355360707047208047566453505570364080504823401
10004020700070700070008000800040700060800030802000604020000000200030003000205000001
10423020455080607060645420204040605762407050604678407020386220347050683822802046561
10200020004000607080000050407050007000806000208000002000200000400080400000307000001
10804338304767404052437030205037578070206527442068754670608573306280802630772055301
10600000702000606000400040502000000060400000000060000040503000008000500050004000501
10204430708034307060405470802755528380803265346755788050402063742324572048708327601
10500020004000002030807000300000407000400000800000006060808000300000800030008000601
10566766536524363020306030353220603020457225404085404080203330802220303722743060701
10002000600000500030505050000080306080002000208000503040603000508000500080000070001
10503050307220505230208026782040402037458040807060404020805048503028644060377033841
10300050604000303000608000800070002000200040004030207050205000007000000040004030001
10736350302042823030505420606863233660605650386080408030505485572663405262406640501
10006000707000200050807000307000000000300050207060300080507000000000600000600000301
12402045805740602837604074383085553623688020308060423552702080284620554557806435501
10308020300060005000803060005000000000008080007020000030004040700030000000700000501
10602030567020335030608050308770466240608070756086705040583030802052866420587060301
10306080300080500060004000200040000020200030006000806050000020305000002040004050301
10503070707743802347667652846022473070222668475770542085742243503045202064305050301
10604000404000400000000000006020500070000050000080002000000000004000600020003040501
10503070603070207233247474406030403046342080467055507363268555506240325750828470601
10005080400060300000300000800040005000002000507000600000006000300020000020000040601
14385060386780477440604720407852768024608365703070256866205060205042403062545077501
10007030000030002060004000804000006000702030002080500070003060604000607000004050001
10356087535670306036855040505050608280706040262570202050753720506750633454255030681
10000050000020704000000070408060500070200040000000808050000000400070000000400040001
10288870846070608835806330407060563030753468483585605070272476582058858430503638301
10400060006030500000700050700050500030000000000000002070000070002000000020700000201
14502044606028403640807060773372607272838076825578533072202057204484285070735750501
10008030003000203000505050000000204000004000000000204000604000600060005050000050501
10652080606770667032607052268370504674304047602570205070408770434020502042864730301
10700040800070000080007000000060400000006000800080005050200080002000306040700000801
10634330506084247650822340532040283520354370636022443660753680407466406030505438701
10000030608040005070300040400030500050008000700060000020000030700000006030700060001
13854020207020505080507062403630476080305024685760465078826060603265465080707050221
10000050604070600040306000002000500030306000000080007060002050600000007000604070001
10888670808040405750305732725050708620502745705055706060406060556057258033254050701
10200000804030200080500070000080700050200000503000204050600050006050008000500030401
10604080806060463440208080366226843072454320307470702030308278608460406360402552601
10304020307070000020803020000000000040004000307000403000600000200030500030703040001
10407032506077223080856033622836565020305220847042206335807340427070864068603040201
10005000607000702000400050007000008080800040400070003000307000503040003030004060801
10724640507560302046302650706072505060508083508230483040726034502073605040778060451
10000080404030002000300000802070002060807000007000200070002000002000706000200080001
14643050404044642454767743505770847060446573563033402028206054546860307636702024801
10005050800060000000600070007000300070700020003000005060008000000070300000307000201
10333040758850502850805020527040608480506040303487426060248377843270633460502440801
10300050700000300030406030000020200070005050700070000080005000000000505000400020701
10306860404874502680405073762030657048262670606057227547704068364824803065582086301
10004000500000507000602000006060008000300080205060000050004000000000304020004000301
10726046858740405072307585608458675572706050407030604066876055602540804050404620701
10303070000050705060006000200080000000003000502000608000002000200020005050400000501
10205060608070708080328020457040508776383428446034402754708840832026547030802786401
10004040605000408080008040000030704000007000006000800000500030006030700070300000401
14383040432268408074705067472220663084807085507856435080685077305080208540282330701
10000020000030004070008000500020007070008000600000008020006040008000600000600080401
10236772886024583050203253308064604080675260804255708345857030568883208625203730601
10000000007020000050500040007000500080000000800000600080000060007000700000500000801
10387522306050622830746020254780672667452772775652664040226326456080373882472638701
10000000800030000000300080000020000000000000000000000040000000000080000000000000001
11111111111111111111111111111111111111111111111111111111111111111111111111111111111
