11111111111111111111111111111111111111111111111111111111111111111111111111111111111
10000000500000000000000000600000000000000000000000300000000000300070000000000000001
17773057506078852450322360508037625876307488552520304047266480277060605025227445501
10000060006020000050007000404000002000600000000080007040000070700050407050000060001
10404460508050862020765064203064606780807274335044677880203060702350202460878060251
10400000502080400060200050007000800000500070003000000000302040400000200000600070001
10684768284023406564604460603270357557483850308330243243706040735463436662708283201
10008000007000808000700000700030007000000050400050002000008060600070000000007000301
17705020604070805040357680526023607036785060682068708053565080203060706853474040401
10007020605020703050000050700070404000006050500040402080006030005060200000002080401
10758070302450405028342030204850706374305083306070306020306084477050536378308050301
10000030207000806000800030600000203000003000008050006050500050008030000040003030001
10263750408023506056207680705722305030236674276020723030682480404066885040804065481
10500050204040008030005000300000500070004040003040200060400000406000005070505000001
16303480603030675030836064638330264037805070204070505370807444207033802060338385701
10006000704000800060300030000060007000500060204070600060708000204020008070003000201
10842030308564875740407853435060602830843560622044325060306053405070753080208060701
10200080400000000030500050007040600070200080007080004040003000007070000080803040401
10707420337540456080207040203033866026606064202080503075357223806040562565404077201
10503000500050006000408050504000004000003000300050404040004000206080300000500020001
10504034678022507777426060602463305870537780704220684030608620803037507770603020521
10002040005000700000007000700000800020000060500040008000800000708000007070606040001
10257070607750707768702535306830526070357320202076505053533462705240673030804865501
10004050300080600020005000500020400070300040306000602020000000700020006000202000001
10454050534040605080256360708030705553405030306778406060725740833040565425303082821
10800020003000807020000070806040003000306000307000006000200000600060400000603000001
10602233407785605064582040306073883070805767284042437220203557702860605860554074601
10400000507000206000600050705000000080700000000060000020206000005000500040004000501
10808640804055505070208840404482543220603836878674545070604057465435724055504256801
10300070007000003060803000200000807000800000600000005060602000300000500020008000201
10457834354482377050602060584320607080553654308062506070806440606280207736265040801
10007000200000800050408060000050802020005000204000502020703000507000800040000060001
10708070806770207350604073247050608085264070405040208020704063502066654080265084521
10600020808000306000703000500060005000800070004020205050706000008000000080004080001
10555780303072755060804460705682844480507250836070807050802534536637502236507580501
10002000607000700030502000308000000000400040608040300080805000000000800000300000501
16307064605580506685303026887068832268756020706060785338404020346480878326206484801
10608050400070004000702030008000000000007030008050000080005080200030000000600000801
10507020546060246060808080603830557380302060327035206060322050208052662350685030501
10306070200020400030007000600050000040300060002000606060000040502000005080007040801
10408070708842205276447565726047324030643636474440687056738428705082605077705020501
10303000802000700000000000003030400030000030000030004000000000007000600030003030701
10606070503060603622583764607070207085822060536047505454872272403250748230255630401
10003060500040400000200000800050006000004000704000200000004000300060000060000050401
14666050582220777460202630708755346063504564406060357653203080508025405072857067301
10007080000070005030007000807000002000704020002040600050004020806000602000003020001
10268073877440804063373040305020303230404050335320704070272260603670845354247060881
10000070000080503000000080802050700080500080000000403050000000200050000000700020001
10687470225080406448606350302070842020848634287635708040527873788086347720303275801
10400050008050800000500070200050600040000000000000004030000070002000000080500000501
13703037808052808620603080246553703544442032428878342044808022605822576050238870401
10004070008000203000505060000000207000002000000000505000407000200060005060000080401
10755030208740466063305035682320408745303035403860603080802650667060607025628620601
10600070800040000040005000000060600000006000700030004080700030002000407050200000201
10734660603064458470325830682050862360367340588062722880762380307275602050207765501
10000070305070008040700080500030800050004000700050000040000050700000008060300080001
14276060608030504040502026307420353030507086745550732085246020202885868080206040331
10000050805040700040703000008000400040708000000080003060007040400000006000802080001
10643850703030704570705482834050605880506784206028203050505070435078543054262040801
10300000707070200080500040000040600050300000702000808070600050008020006000400050501
10305020505040656570703060528765438088623670508520604050204366405780603440203646301
10704030404020000080307030000000000070006000303000702000500000600070500080202080001
10704044407083734050548038245847554050807730765085402757602560543040345022508080601
10008000303000606000700060006000008050500040300030003000707000206080006020003030401
10742850207460806082807870704042403070305052302650635030265062408044305030832030851
10000030706060007000600000802020007040506000004000500050007000006000402000700060001
18645020508045474442755273203470385050633726435034207037502056882780503288307045501
10007070500030000000600070006000300080700040002000002050004000000020400000503000801
10638060224530605320507050532050703760603040207857233020588754622370265670306580801
10700030400000400040208020000030700030005060700050000020008000000000607000400040701
10704650204258708460303027388040565037533580305034665353706063256456208075535066401
10007000300000403000702000006080003000600070808040000050006000000000304040005000701
10852088774870205043603885708665648463206060804040608048658073603280405060607780201
10202070000060208030006000500060000000003000606000707000004000200060002020300000401
10404060203020502020587060537050805235885775722043305422702280443073334080804624401
10004060206000206030002030000040504000003000005000700000300030002020400060500000301
13762070428857706056605067548480554068406076802883626060538076703040805360834570601
10000040000080003050008000600070005080004000600000008050004050002000600000200030801
10653376626054256030606687803044707070823230606566805683226050536646707867402520701
10000000006030000070800020002000800040000000500000200040000040005000200000200000701
10567442405040887270734050252240738442728532454325625030757658546070873372636775701
10000000500060000000400050000050000000000000000000000060000000000040000000000000001
11111111111111111111111111111111111111111111111111111111111111111111111111111111111
