11111111111111111111111111111111111111111111111111111111111111111111111111111111111
10000000400000000000000000800000000000000000000000800000000000300020000000000000001
14272024606042524450442680804047377238208877867630308053846480784070506067347365301
10000050004050000020007000404000008000500000000070002060000030300050202040000040001
10605860305040224030278068505073407640403544338048377330204030406780804570682030421
10800000602020400040200030002000400000700080002000000000202060800000500000600060001
10665425442085507752605270204550274654372630605450563263402040824843856332806468301
10002000003000205000300000800070008000000080200080008000006040800060000000008000601
13308080205080202070725520338065304032847030275083407085638030207020207886224080601
10004030203040607080000050400020203000004080500050604040006030003020400000007040401
10853060606840803057883080507560405676504076603020504030607053557050656883306050601
10000070405000508000800030800000302000004000006020006080400070002020000020007060001
10427580303034503083508630307572803080445786688050453060322260802022758060406075541
10300080806050006070008000600000700060003030004040200040600000206000002040405000001
17602240707040572030577087477260478055404070305030203520804623307037707030274788301
10003000603000600060300040000080004000600060403060700080607000602020006050006000201
10757040205387373850602865377060407730746860246033846080308053607020352020702020601
10400050800000000050600080008030800080800040003060006050004000006050000070206060401
10705880353460785060507060302066538038705052205060505034668286802070322455505066701
10303000200050004000805080207000003000008000400030706060006000607070700000500020001
10605034762085706654473070703846703480527350807250456050505620502067304340407060661
10004040006000700000002000200000600020000080500020007000500000604000004040407070001
10253020605620603857202535406360652040248870606075304085475566307260745030304732601
10007030200020800030007000300030700030200070202000402070000000200080002000603000001
10338060434080202050352480408070806538202080603243602050565620373080746554305077421
10700020007000202050000070207040007000308000403000003000700000200020300000305000001
10707478403373507074782050204024287050203668875084672240506842806840705270853022801
10700000508000605000700080706000000060600000000050000060404000003000300030003000801
10807670403076507080506280308246686770606865476553356070406065872626773053405854801
10800020003000005020304000500000507000400000700000006050705000800000200020005000301
10733684536333362030405080753370703070765372305072204080602270306370308874246030601
10008000400000200030407080000050703020004000802000506030403000506000400080000040001
10203020802460705780205077455030302026783080405020408070507064503084728070637085541
10500050202000808000602000300020002000200040002030403030307000006000000050004060001
10426720202064276070806760508627832380803720367020706020404463438444504482608280301
10006000803000600020508000702000000000800050507040600020706000000000600000200000301
15203036806730708737407035548037448866552030808070248226805050242220833364207226801
10203020600020008000802070004000000000006070002030000030004080600030000000500000601
10703020636080375060406020808660273660807020485055203040443040504035448680524030601
10702050700030600070003000700030000050400060006000808040000050806000006080008020601
10707060503357808277547388723026272050233853242550448067356536807045306035703050201
10605000803000300000000000002080200020000080000040006000000000005000800040007020601
10508070807030705767724864303050807077787020865038302643284584206780338740762350301
10004080800020300000500000600030003000003000806000700000006000700030000060000020701
12384070658320275560405750506786686023508763608050364567207050204053403087248034301
10006030000040007040006000805000003000207070006020800040002030806000505000002060001
10833024568850205024253020202080302530605060225570808020273750702330852435664020771
10000050000050708000000030506040700040300080000000405020000000300080000000200070001
10634450277080307337808780605030573020366532854837305060552248274023672280807355701
10600050003060400000700070800070600030000000000000006030000040005000000080600000201
13304065305087206720307070564236702425846044848346643054405062403636334070577680201
10007060004000804000602040000000606000003000000000307000207000700050004050000080201
10432080202860424074303066556840207447608073305430303020603680526060205047537740701
10200040800030000060002000000050200000003000300020003030800070006000802080800000801
10864860708058347340836230322080222260644470653034747660567580304266205060402633801
10000060305070007030600040700060500050008000200030000080000080700000003040400020001
16844070705080803050306068404280824030804067483660875055673020607654865030706030721
10000050802020500070302000008000300080804000000040006050002070800000002000605030001
10243530205040805560307237847030605570602377807054308050804080646032364048476080501
10600000303080500050200040000060600080700000804000506050500030002040002000800060401
10806030707020483620204070744674827027382840606330306060502833707850704370606255401
10305060502030000020206070000000000080008000407000503000700000500050300060607050001
10707086807036768070646066572452573040407250664032406673802260246040475052207020701
10003000602000505000800030008000003020400050400070003000403000805030007050008020801
10563780802440604087202550208042502030403042708870878050733068705042407050672060471
10000030403020007000800000202060002040203000006000600080006000008000405000800030001
12627040204083658476538833508350456050426388348053704066207072247220503624207085801
10007030400060000000800030002000200030200070002000007040006000000050200000503000501
10765040368770605850708080744070405360604040202756764030862477666330636680707440401
10600070200000200040508040000060600030002060500070000060002000000000706000300020201
10407460403843707330205024752040444025883460806078485877305035747533808056428034301
10004000500000802000606000006060002000300050808040000050004000000000404060003000301
10746077564220702087605463605778785655807060306070508086223043808340802050805680401
10806050000060306030006000500060000000005000608000208000008000200040007050300000401
10804050602060606060386020676020508624278338838033705684305860664037264080305252701
10005080407000202080005070000080304000002000003000800000200080002040200080800000501
16468030232332603024307035355230585035706072506672472080268053702040708520466450201
10000060000070008020007000700060003070002000400000004030008060002000600000700070701
10842245766025543060407676305077706080226560203848207584525020644273503765605540301
10000000007020000040800020005000800040000000700000200040000040008000500000600000401
10522785208030336350737030737630448632763866245743377020426485845070727667546324801
10000000600040000000200080000070000000000000000000000060000000000070000000000000001
11111111111111111111111111111111111111111111111111111111111111111111111111111111111
