11111111111111111111111111111111111111111111111111111111111111111111111111111111111
10000000800000000000000000600000000000000000000000300000000000500030000000000000001
17566033405043524250456780303058275643605735238440405042885880575040605028564484201
10000060003050000020005000503000003000600000000060005080000060600050304060000080001
10407320704030252040645086407026702480605335437046554260708050408570507570533070541
10300000603060800050500030007000400000200060005000000000805030400000600000700030001
10273436647024805875507640508840844553878570302340735827802070677667868277303586401
10006000005000307000800000200020003000000070700050002000006050200080000000006000601
12208050403030503050538640233057508033672070484048204037285020605080402438323040201
10004030603080207050000030500020204000005080700050306060005070003070700000008030601
10347080705680306073345070208640406653807036402050403050303078576080872722805070601
10000070202000703000600070600000508000008000005080007070300050005050000080008020001
10242650503063306046306550703653605070556822655040344030883370302072885080602062571
10400050702060003070007000400000300030008070005080600020500000806000007040702000001
13706620502060863040657083743340742035503030703070202220307353606032606080858247201
10002000508000500060800020000070005000800080206080700030203000308060007080002000201
10648070203863824830602576672070507840426680732078537070303054608060728020707020701
10800070200000000070500080008070600020200070002030004030007000008040000070404060701
10204470425460765020405040802056635033505036504030308065438282808050474475502042201
10807000700030007000507040302000003000006000500040406030007000202020500000800050001
10807023354076206635374050306773704740726570403630232070408350806047804630406080481
10002030006000400000002000500000700020000050700070006000800000608000007050203080001
10346040604770606655402545202670238060528480804085502068623486602660332080607578601
10006080800020800040008000300040600030300080406000403020000000500080006000804000001
10274060565040406080774680806050204442403050303856302040778340236050783242702056471
10700030005000408080000040508060005000707000507000005000400000700020500000606000001
10702654806873507068532050403066786060504432468075486760603638202270408820447047401
10600000402000807000600050305000000040700000000080000060205000007000300070005000601
10508480703033506040202320802865247460508467654443237060403042522442442033507383801
10700040008000006080407000400000607000600000500000008040308000800000600050002000701
10537854256843456030302030228680603060858874203033605020303880402260606586467030401
10005000800000800020504020000030706060004000404000806050303000705000800060000030001
10802080304250608440607037832040503054436040503040302030802086604033427030826068431
10300040504000706000303000200040003000800070006050805060306000003000000030007040001
10355630808077885070408660307874633280406720374070807080504383752768307742305380301
10007000205000800080602000606000000000200050508070700060607000000000300000600000401
13203064203470604658605087836032626478467060608060625427508030744620833844704536201
10305070700050002000604020002000000000004020004080000080004020300030000000700000301
10303020868060525040703060305430447840308020746035506080726030508068243680877020401
10403070700050600020003000700030000020200040008000402040000060203000007040008020301
10203070707342505825338743268057727080856824626320663042773866606055808036805060401
10305000706000200000000000002060600070000070000080007000000000004000600040008070301
10505040408060506342865577605070808078775040233072708765263883808840582860573880301
10003060500020600000200000500070003000007000307000800000004000600060000030000060701
16223020847450276570205570707424458062508725207020748336706050805036203055274078601
10003030000040008070004000503000007000806060007060800070003020204000806000008020001
10852048758430503045764040403020305430202050637350507060585770803780454738843030231
10000050000050502000000030208060600070700050000000203020000000300040000000200080001
10466840644050303273804870504060824070476723244758408030365475455055673340207466601
10700080004070700000700050800040400080000000000000007050000070004000000060500000501
14408078603057802780703020258742805276576077768535386082302062205348357040476570501
10004050004000204000607020000000303000008000000000406000202000700070002080000060301
10364080206460655035506057257740406677805088404230206020803670834040502035658630201
10700060200020000040006000000070800000002000800020006070700080002000802030200000501
10527440207043628880448760377020434360867250455077272860628860405865306030603383701
10000060706050002080500050500030800070003000300060000060000060600000005030700060001
12656060608070804040802035207840874060803035226620376043636050806344754060403020321
10000030403030500050508000005000400030607000000060002050003020300000008000706080001
10568540504040204460802738587020703760604357705064502030402080836045454065452080601
10300000807070300040800080000020800070400000202000408030700020006040006000500070701
10708070803060438540202030284455536022642540708520205040603577303320502640404346801
10603070305070000050803040000000000060007000403000805000400000400070800030204070001
10703042203034532030242056287775522020404320582074607683608250482080287044202070201
10006000705000405000700040007000003040300050500030004000203000207040004070005070401
10758370408770702045204320603037703070704032802880286050762045705064804040868030871
10000050306080002000700000403070006080605000008000200030003000006000402000200020001
12673020505077753682454837508340253020374578562025807058407045667280703228303074301
10003050200040000000300070004000200070700020007000004050007000000060400000603000301
10887030863770604550306020388060206870504040302533776050836384266830787430704460301
10800070700000300030706050000030700020004080600050000080004000000000307000600080301
10206370203835406850608072783030326026228440204055787377607068347357502058845077301
10005000400000406000205000003060004000600020202020000040003000000000206030006000401
10376053377240602048402542302284375887205040504080803054375045506230604070308440801
10603080000030305040007000500030000000006000203000205000002000700050006080500000801
10402080307030206040637050576050708465485784673074506626705620446025643080302265401
10006030508000808040006070000070605000003000005000200000600040006040600050400000601
14826080622485302052708033328220586078805025307824575020728057808040706760772630701
10000060000070004020006000800030003060008000600000006070004070007000800000700080501
10574287368088553080707253607084602050864320803254306478566020762587705664405230501
10000000004050000050200080002000800060000000200000300030000060002000300000300000401
10454275205020323330628060757680244875846463735782542080364436338020763833238322601
10000000400080000000300080000070000000000000000000000080000000000030000000000000001
11111111111111111111111111111111111111111111111111111111111111111111111111111111111
