11111111111111111111111111111111111111111111111111111111111111111111111111111111111
10000000200000000000000000400000000000000000000000300000000000200020000000000000001
13448082608088882660686450408058855675302526257880308043724660346080303033372835401
10000080005070000020004000503000006000800000000020007050000040600050304070000050001
10704460704030687060754052808075705240204474486074366680302060302520803660386030461
10300000407080800030700080008000200000200050005000000000208070800000300000300050001
10466252787086808274806220202440328743653630605880655683306080774573554338703873801
10003000008000508000600000400060006000000080700030002000007070400040000000006000501
18302040604070305040625720357043505032858040858072503055475060406030203387347020601
10006070208080804030000020800030305000008060500080405050005080008040800000007070801
10268030202650306066582030204540705447806032404070703030403033724050564855308060201
10000060503000207000400030400000206000007000008050004040800020005020000040004080001
10248450402038408075705330805622806040375487567040286020777430703057845070203038371
10300050406040008040005000700000800060004080007060300070300000206000005020704000001
15506830305050428020482036375850387075202030202060606750308457803054508070275746301
10002000406000200030400030000020006000300060606080800030705000304060006080003000601
10746030304657468630307687248040403240244230883088826050206036206080247020702060301
10600050400000000070200060004060600020400070005050006030007000002020000020404030301
10704320738640766050607030808035788084507026405050304072786732708080677554504074301
10704000500020003000508060204000008000005000200050405070006000804040800000700080001
10308078877055607742635020507546403530286760307560872060606450505024506870204030871
10007030004000400000004000300000200050000050700020008000500000408000006070302050001
10478020708430408727307885302230875070565450404077202088346572208530832070208566601
10003050800080800040003000300080400080800050703000807070000000300060003000704000001
10755060673030805040585560503030402436706050202222705040285250528030222487306044721
10800030008000608060000040306030004000608000403000004000300000600030500000707000001
10405285202662808075258050503084373020707687442022644370804685702750307530762065701
10200000208000204000600030406000000040800000000040000030608000006000500030008000201
10405770208066202070705570703783578580207587654227626050602048862756826085208485201
10800050002000005060504000400000308000200000600000002070807000500000700020007000401
10335822244344732050206080463330807030537737807027705020708340308430306876747060201
10007000700000400050602060000030302050006000202000204070705000307000600040000040001
10402080207570303880405083428080306037876040404040206030505074208036228020582046421
10200060702000204000204000500030005000400070008080605030203000008000000060007070001
10623450706085866080605270502443233550207880656030507020606624473645407356603840301
10002000308000200020602000304000000000300060606070300070204000000000500000200000301
18405085603460606556705078358048563346742080608050824432702040835520765838807657701
10307070200040003000506070008000000000008070006060000040006030200080000000500000401
10603040855080766030204070807640782340505050637023203030885030206034278750467050501
10308040400060200030003000300040000080300020004000702080000050208000005050008070701
10305050508432304742253557756073822020283664384830485027684586604084205038504080201
10502000606000200000000000004060600060000070000080005000000000007000200020002070801
10202070805030807242676385706040308044873040745053307468673534807640244750867270301
10008040600040700000500000300050006000003000406000500000003000300030000070000060501
13444080853260567380406340405645286067602854807050672873705040503026507088522022201
10004070000020007030004000305000007000207060008030500030006040603000205000003050001
10873033272640408075463020402030204270207020234870606050856580306870253665734040271
10000050000070508000000060806080800070400080000000208030000000700050000000200030001
10243440388060208545604630203070535060447532877278608060678345635082668270307823801
10700030002020200000600070300030800040000000000000003030000050003000000030600000401
17802056802032807480503070553472206727747055452724624035702055508246627080788460201
10007040002000408000807030000000507000002000000000704000707000800060002060000080501
10648080202260542026308033645720308685408038202830605080505830828020406086684670301
10700030600020000030008000000070700000007000700060003050500080004000607040400000201
10236670806054343560265830762030352480486680724084723770347660305465203080307883801
10000050803050006060400020400030800050008000800040000020000050600000003060400020001
14484020203020407060205072405720582070605053556550654022423080803582542040508070871
10000020206030400020706000007000200040306000000060008020007050400000002000505030001
10443230703060704480407528247050308230507252208073604070708070567038534034868060801
10400000507050800040200020000050200050400000405000704070400060006020004000800050201
10208030705020766650604060363828428054254570206480304040406344403480606830606836401
10404080706080000080304020000000000020007000305000203000500000700040600080703080001
10207028702073583020344053742855873020703420875066204647305360628020255052807080401
10003000208000603000500080003000003030200030400080007000407000303060007070008050701
10625450707450404084405720403088302070408074204740664080782077202058708020838030281
10000060806070003000700000807060002080702000007000400080003000003000207000800080001
16284080202068725823857526606860666060847357882042608046408086566450507266708067501
10006040500060000000200080002000800020600060002000005060005000000030400000705000701
10367080733470705860407040853080702750508050506676574040788434876270584780605340301
10500070400000200040506020000030700030007060500060000070002000000000308000400070301
10305220403572602740208053845070223072322370207086544358705048478767704086767022601
10004000800000404000806000003070005000500050702040000080002000000000205080005000801
10567063283480604052202556505437872283602040804020604023554073303770304050502320601
10603080000030305070003000600070000000007000602000503000007000300080006050400000801
10403030406040207020887050688070306247622524832024405377802580647074825040403635601
10007080503000602030005040000060805000008000005000600000400070004080800060500000801
18452060674535703057808078528720674058202082705648282030647064204060204670434360201
10000060000060002040007000800070004080004000700000007040002020006000200000200040301
10478587267082776060306223202057202040884530802322604483832040334534503424606260701
10000000003020000040700040007000500030000000300000400050000060002000300000600000301
10558246407060448520238080332840347635664278688552574040686278343070226272285248601
10000000400070000000600030000050000000000000000000000040000000000080000000000000001
11111111111111111111111111111111111111111111111111111111111111111111111111111111111
