11111111111111111111111111111111111111111111111111111111111111111111111111111111111
10000000700000000000000000400000000000000000000000200000000000600050000000000000001
14535076805074445420476430305036653444208524474460503062543520728050604024843344601
10000070008080000050003000403000002000400000000080006030000020700030208030000050001
10703720404060584030834083705042206680802322728068442360304080303780507260768050431
10600000805040700020700040004000200000200030005000000000805080300000600000400080001
10364544377085403866803830708850526776576540608580352525303040476632566385705567401
10007000004000404000400000500080006000000040400020003000003060400020000000008000801
18208030408040402020337660483066204074777060253027206073453020508050304282265070601
10002050703020306030000070600020302000007020600080706070005070007070500000003040301
10482030203540807058465050206540508328708075608040304060802035526070552827505060601
10000080807000204000600040200000703000005000007020007080500040002030000020004080001
10543620306046204056605350205376502050584265432060734040535260707083564070605044631
10500030502070008060004000400000600050004030003060600080600000702000003020504000001
13502660605050478070482025846420662023206070808070205630406456807057502040332443301
10006000702000700020200080000080002000700040402080700080508000803040007030002000201
10857030308834525870508377527080807840885230274076457050306062603030433020207040401
10300070500000000050600070002060600080500030004020005050003000004060000020204030801
10805470486270424050405080302085853043505048708030608084777553604050873724502084201
10505000600040003000408040705000007000006000500080204020002000307060400000800070001
10802028877056807633366070303443707750534240402480282060602860402084505360706040621
10006080003000600000004000700000600080000020200080002000600000602000007060302030001
10768040804270507868403236305360853070256330508048804054864722303340242060803827401
10007080500050800040008000600050500060400070508000804060000000800060007000604000001
10274030562080804080885470604020705348403020605422203070344420526030866645703084371
10500060006000507030000060606070005000202000707000003000700000500080300000307000001
10503257204752403074333040206035236060803377664036754530704558207850303450463036801
10400000707000703000400060402000000070500000000060000070508000002000500030008000701
10605360404065207060502650702785332640503575428644752020804088733362522078305244501
10300060006000004040404000600000807000700000800000003070505000500000500080002000801
10257484585545837020508070723670502020636734403073804060705840206650605725328080701
10003000600000300030207030000070705030008000702000806060206000702000800040000060001
10306080503380506530407072383070802043538040508060406060403072708025626020364045881
10200050506000304000607000600030003000500080002020403070302000002000000070002020001
10737870405067325050705570303623364540604370478070706050208632667522306735808630401
10004000203000300030606000608000000000200060508070500040808000000000800000800000301
18803063405620806882602082787088772424563040607080258537502060532830322823205545301
10405020200080003000406080006000000000006060007020000050004040200050000000800000601
10303060484020637080403040805420677320502020262072205070533070204052827630258030701
10405080600020600030006000600080000070800030007000802020000080205000005030006080401
10202070505678508547836648486074863080465666733430455056264558605036802035406030601
10702000802000700000000000006060300030000080000080007000000000008000700070007040401
10708030407050607353265362808080302057725030234022504542225882504730235830474880201
10002060300070400000300000400070007000005000508000600000004000400080000030000070201
15634030866250564320602870802383766084508366604070856863706050507056506088856035801
10003040000040004040007000202000003000308030008020300050002080807000305000003060001
10743086256840505088366040205020208250708040527550206080356520602720484542248020651
10000070000070402000000070206060500040700070000000507060000000500030000000300050001
10533360585060507873506730304080863020827465553872506030274245767034278860603687201
10300070005040800000400020800020600060000000000000005060000020004000000070800000601
13505045705056505320306020435385707276275027572687853054406025505358555050343250301
10008020004000604000202080000000704000005000000000505000406000700070005070000070301
10548020808550258047506034482720303547603028304420406040402830787040604065372240701
10800050600070000060005000000070200000002000200080003050400040003000805040800000301
10862860706072258470878430738030585880622860472043354760645580804383707060604724601
10000030206060004060300070400050800070008000300060000050000080600000003070800030001
13563040805020304070803024804660853080605052585820274032766030505286652080407080671
10000020302080400020607000005000500060405000000020007050003070300000002000504050001
10583650307050603450304222678080807230505255204046705050406070752025648035685020601
10500000204080700080400070000050600040600000606000505050700070002040004000300060701
10808040707030754740404020273783265058345770407670505060808364403740206820406723801
10402080304040000040508080000000000050007000206000805000300000200040400070607020001
10506052803045374030554076657655577080207230875053304657603230742020565082303060501
10002000207000304000500050004000005050800070700040007000308000208050003080002070301
10587260403430705047406680407057304050405086805640264030287084502025608020448030831
10000070507030004000800000606050004030307000006000700020006000005000806000300030001
14525080404064856763232435307260746050268637757048706065804065255380205775602058701
10008060200050000000800050003000200020500080007000004060008000000060400000402000501
10363030626450502460404050252080802760208080402287283080524332335330835540202460801
10300080500000500030307060000080800080008050700080000050008000000000605000800060301
10204680705557404320506074887070537027852580805024786448807025655273306074837032801
10005000600000308000607000008070006000300020405030000030005000000000403030008000401
10225087364420703062405588803245238865206060806080506036857022607750208070304820301
10404080000070804050007000400030000000008000702000705000005000200080004030500000401
10802030506050608060565060682080808474542434438028205643703820558072632050805847501
10008020308000804070006070000050608000004000008000200000600060002050400060200000501
17758060845248703064605032546640653035503074404565488030227048803080206850422230601
10000060000040006070008000400030006040006000800000008030003050002000300000500050701
10878364332072722050706344407062602050755820508655308744454080626754502282702820201
10000000002020000040400040007000700080000000400000600050000030007000300000600000601
10334588307030472560724050858330766227287323547662355070655447874040867752785523301
10000000400030000000700020000040000000000000000000000020000000000020000000000000001
11111111111111111111111111111111111111111111111111111111111111111111111111111111111
