11111111111111111111111111111111111111111111111111111111111111111111111111111111111
10000000500000000000000000400000000000000000000000200000000000800050000000000000001
16752084606036272740634470506068384448807444243340504066265530287040803086274438801
10000060007030000020008000705000005000800000000040006030000080300080508080000070001
10703860702060634060246038808067802740507222266063727540303020803540807780684040481
10200000407040500060500040006000200000700070002000000000207050700000300000500050001
10382622766045503884405770703250436777257660204530444683804020567782757232303762501
10008000002000602000300000300040003000000020800030002000002080800080000000002000701
13807020408070804040348850474028602067235030457037303047358060808020208545585030601
10006020507030403080000030300070708000002070600020506020006040003070700000002030301
10734040702540204087757050602270708565505028805030508050308072322080448665704080601
10000070307000602000600040500000203000007000008080004060500070006070000050006020001
10752340804047206037307680506338306040723666887070728050753820204086245040405023751
10600040508040008040005000200000300060005020005020400060300000803000004040403000001
13803530704060244070427044478820365062207040202070808550806838208086606060553656301
10004000405000600070500070000040008000400020503040400050305000808080007040003000201
10383070402732266650207676677060307430473580676085266080302058205060687060506040201
10800020500000000070800080003020700020500050007050004080008000004070000040604030701
10606420664220676030605070403067676086302022205040308066254743703020542337202033601
10803000500030008000808030707000008000008000200040808050008000803060400000600030001
10205058633076703323787050303355605650575550608560338030302460804038203280603020581
10005050003000200000005000500000600070000060600040002000300000804000007080206060001
10577040805530408245806354804320378060268340202067702024526575607450783030804736401
10004040500050300030003000800050400040300070702000605050000000400080005000207000001
10385080722040806060746530608050707334603070207374705050256530587040886423202043581
10700020006000505060000060503060005000208000202000003000500000200070500000305000001
10503735208558205027466060307024238070803737438064875280307388307780505330348058301
10300000506000507000600070802000000060800000000060000020406000008000700060008000301
10403570407082405050505570507865254670507527776464632070803052684242325053808558201
10600040002000002030808000500000703000700000600000008050508000500000300050008000501
10258326322684465040603040363260308070866422703066603070702660602750608686786030301
10003000400000300030404050000070406020004000405000408020703000308000700070000040001
10202040205540806730302036364060806023727060302070502020402053508054872070228047861
10700030204000403000303000400050008000600040006060802020203000007000000050005070001
10738670405027623050302570608533855250207260367070808080802852527424304474703580601
10004000607000400030202000705000000000600030608080300080408000000000700000200000501
15406075307880804462306045587036266748734050703050534348604040865470758728205257401
10505080600050004000208040002000000000005060007070000030004050500020000000200000701
10703050536040535040608050502560787320202020662068607060736020702076572420855080201
10407080600020700050007000200040000060400060008000704030000050505000006070002080801
10604030702572206527537223882085478020654278447320535024834264406064604027307020801
10507000807000800000000000007040300020000040000030006000000000002000800050007050601
10602080507080303878885642706040708086725060865062808823726864503630523550564530401
10002060700050300000300000300060006000005000403000200000003000800060000040000030401
12747070586480786830302750202335744076706655704060676636804080603082808026874088301
10007060000030005020008000608000002000305040004020500030008050305000305000005030001
10352077637670702082768020407080503670407070842520602080628440605380463662523060651
10000080000070305000000080802080200020300050000000706070000000700070000000400080001
10534880458070508467208230704030557040543635486723804020388337782046657660504574401
10300050007060200000800060800060500060000000000000006070000080002000000040600000801
12504036403062702330708060622636608822757075373638534082805052402626822080638770501
10008040004000408000807080000000703000002000000000607000302000500040003080000050501
10356040306270858074504028372270506842504032408550305050802540435080307037457440801
10700060500060000030002000000020300000006000500070005060400030003000702040700000801
10363260702083668730752240368080878280626850843055863440375540508474606040406224201
10000020503030005060700040500060500050004000600030000040000040400000007030500070001
13765050603030308020607037504660622020308032455430328053366080405245567070505060331
10000060804040700050502000003000300040603000000080006060008020500000005000802020001
10346730807060406750604658834080806650502723505034605050407070476066227078286060401
10800000808020300020600070000070600030600000803000606040200030008040005000800030801
10503060504060652650806080473775868074342280303450207070705674506270706580605757201
10302040404020000070608040000000000020002000305000805000200000200040200030308040001
10305074808056544080838038574345778030304730575024606375404570542050735058603020201
10004000508000502000700070003000002070600020400080005000303000706060004020006030401
10232450506550405072503660302042605080407033406480287020537042206088306060446050561
10000060704030007000600000608030002060608000003000700070007000004000603000400050001
13788060302024452777746474603270447060346626544033505084208033442870206288503076701
10004080600020000000600020007000300040500070008000008020005000000030500000703000401
10846070223340502230503080357050705340605040403725878060748255783370823820202420501
10500030300000300070808080000050700050005020600060000040004000000000207000300040701
10702830606653505550603063242020634063577560506035453734305066772268603062856086401
10004000400000205000808000004050002000500080703070000050004000000000603050003000401
10532088443320804026206688205724346862204050407020702022462057806370205020205580201
10407080000020305060002000400040000000007000304000404000003000300070004050700000701
10205030703050805020328050856060305755223428648032308567203740225068852040202238801
10005050705000206050002030000070602000005000005000600000500020008050600070800000401
16868030225787605078805024364560566044403073702884266040875063203080702370654520201
10000040000030003080007000200070004030002000500000007080002020002000500000500040401
10686386456037847020408322604023308030863350208385803263386060827233804234806350601
10000000006080000020400080004000400060000000200000500060000080003000700000500000801
10743226408030643840668020637330453322837252543652852040272346342050333828676336801
10000000800060000000700030000070000000000000000000000030000000000060000000000000001
11111111111111111111111111111111111111111111111111111111111111111111111111111111111
