11111111111111111111111111111111111111111111111111111111111111111111111111111111111
10000000200000000000000000600000000000000000000000700000000000200070000000000000001
17442047603026532650257560702042385477207742383750308052664780854060507033245484601
10000080004070000060004000202000004000500000000050006050000040800070606060000060001
10407270805050542080437055402075703530308476625086454650403030508660803650788070321
10700000208050200050700040006000700000700020006000000000207030300000700000300020001
10875558458044407662708550404450284736774850706260786334503030347864545442806753601
10008000005000707000800000800040002000000030300020006000003080500020000000003000701
18403020408050702080535560428036207054886020848033707074678060606020206767626020501
10002020604060807020000080800050808000007040800080208060002050002020700000007030301
10828020805350608047444020303640606678508024305020504080804088228060678222806040301
10000060408000507000600070500000608000003000007050002040500070003030000040008020001
10863460703027806022406630607233303020235786533050847030563840802046564050706088761
10800060204020005070007000200000300060005030006040800070500000207000003050503000001
15207740607080384030725072444620245076303020708080807770407445302058206030277787201
10008000202000400030700040000030008000400040507020200060807000706050007040007000501
10568080608824748860404672868060806780457250423067322050304058704070254030605020501
10600080400000000040800020007060600070500030008040002020007000008020000040803060501
10703420668720827020305040503023353044304023802070507035232746502050645643705033301
10407000700050003000806060802000003000004000300070608070006000208040400000600050001
10505048863075206774837080404272204560683730808360867030203480804066602680207060271
10006070008000600000004000400000500030000080400080004000400000204000002020303080001
10775070208720306675305463307250277060254330602086303076373868208460855080305656201
10005060200030300050008000200080400040800080308000505070000000300060008000605000001
10534020237020305060747440408030205268604080407642704040548480786080385526205047231
10300060007000802070000070605040003000802000308000005000500000500040700000706000001
10706338608862202088626070604038222080707787272084235550207285202840208680286075801
10800000507000808000800060502000000030800000000020000040805000004000600020004000401
10503520606078805050202430305735453620508254778683362080404046652764436026603825401
10200040002000006080507000500000408000200000600000005040603000500000500060004000301
10437887583435372050707060642260803050584265206047207080203430504540602783266040701
10008000600000700040608050000080402040005000406000803040403000802000400060000040001
10506080503550302220206065886020306033375050405030403020402025806076732070723038731
10700050504000605000604000300030004000600060008020203070302000004000000070007080001
10466560202048244050805380606736525750203630746050302060304744582386204564304620601
10005000407000500030807000808000000000800070704070700080405000000000300000500000501
16802063505220604733307072386054288288857040306050586288503030444640427388304532701
10206070600080007000402020005000000000003060003060000030004070700080000000200000201
10606050544040464070406020604880534760307080474048205060387060602073437460885050801
10805050400020600070006000200060000060600040007000303020000080302000003070002020601
10204030606865408766578277656082727070465338284320822056528284205064305085306020701
10704000405000200000000000008080700040000060000070005000000000008000800040003040601
10205070303050707324888776307080703048456020558076402572627324405730884260834380201
10003040800050600000800000600050006000002000508000500000007000400030000080000050501
12232050242360634430602870403662237035704636607080628876502060406027306054532084801
10003060000070003050007000203000005000202020005040600050002030608000504000006040001
10838064684280607043523020505080204230204040434850804020326260405480864456562070271
10000030000030707000000040502030300050600050000000206070000000700040000000500080001
10836330557030305224307240608070374050352475282458202040888852866036257550305845201
10300030007040700000600080700080500040000000000000004060000030003000000050800000701
16502035706036205870608060836355804748457058344647268032502055702454762040777350501
10008050004000607000508070000000404000008000000000607000503000700070007050000050601
10345030206570288076504065743440505455705067208740707060304620673040707083437530301
10400050300070000030004000000080700000004000700050005020400060007000802070600000801
10625280306062347460242440246030348340674250762028365660385720204728808070605544801
10000020705040005030700040800060500030005000600020000040000020500000006020800080001
18488080505030806070503027408260732060406023453440257045283070607378376030506020861
10000060406030700070505000006000400030703000000030002060007080500000008000203020001
10475760508050805760307225247050507370803727302073603060604050547073383023865040701
10500000303040600080200020000050200040300000303000307020500030003080002000500060401
10203080508070283830706020655656645084323230502520202030708757404480207240202357301
10503040308020000070604080000000000050003000708000607000200000200070600080704080001
10307038808026426040232047763763274030205640263043206552603880365020772086402050201
10005000202000503000700030007000005080300060700020006000408000504040004050004030501
10478420706580505043608650708053404060703085607660726070743066705064702020654030231
10000040702050002000600000806080003070606000006000400060005000005000808000600020001
17577070806047284843335245308380348060643268284044304025308028274570607523802058301
10004080500030000000400020003000800070600020003000002050006000000060500000705000701
10733020348330805540202020262080702460207030706442772030765485363420852320603630601
10700030200000200030604080000080400020005060700060000020006000000000503000500020201
10802850706555403480508028544080362074568630206032575225608087273388704082347085301
10005000300000503000608000007060008000500080602060000020002000000000605040008000801
10663074325820408082503737508427273848508060205040605085654037804320708020505820701
10306040000040404060007000800020000000004000302000802000004000800020007060300000401
10308040207040305080346060633050704464278247258026202757305430723074447020802773501
10003020404000205070005070000070806000002000006000400000600060005070800070300000401
17254050878248808063504048478650285038208027607247265060326042402020507830886350801
10000020000040005030004000500030008070002000800000004040008080008000700000300070801
10254325686043742070608585808032507050864520804557203263735030785335502356402730801
10000000002030000040600040006000300040000000400000200020000060008000800000200000401
10825733502080538880474060664650747557573242833856558070457245653030582235577234401
10000000400080000000600060000070000000000000000000000080000000000080000000000000001
11111111111111111111111111111111111111111111111111111111111111111111111111111111111
