11111111111111111111111111111111111111111111111111111111111111111111111111111111111
10000000800000000000000000800000000000000000000000500000000000400040000000000000001
17656086707027264540454370407046883878805743842420504053774670735020702085683228701
10000080006050000020003000708000006000500000000050008040000080200080603050000080001
10208760506070688040255085503082508860804856326074835530306020708240602580474070821
10200000502070500040200030002000500000500080002000000000605030500000200000700040001
10654435752052604283408650804750348667767360208570542528808060745583332654407865701
10006000002000206000700000700050008000000040300040008000008020800040000000003000601
12202060402050207060358820244025605045664050526075802023728030204030605723843080701
10008080206040507070000080600060508000006020200040208050006020007050200000006060501
10224030303340506075532050608450804756708053802060803060508054484070238276606040701
10000040706000502000800070400000406000007000004080007070500040004070000080006070001
10387380504046703052408350802573808030888642638030276050423530702026226080603077661
10400050508030003020002000800000800040002070004040400080800000702000002070706000001
17305460606060444080247023236560272062706080304070702250408436508045805040588367601
10005000404000400080800020000040003000200040305050600060608000707080003070006000801
10562080307745445670803254553050303280734280845074533060403027504030232030808070601
10600060200000000040800050002030500060800050005080006070006000002050000070405060401
10708730224850446070305060508056488027404084703070205025764456305070755664307086201
10602000500020003000405070402000006000003000800030302080006000403020200000800020001
10303064285068305633462020403668503270852460305470343040303730407087806750502020531
10004060008000600000007000700000800020000040700070005000300000407000005030705020001
10848070406230702522605674503640355040653450707086705063566277503320566040708835801
10004060600060400060002000600050500030700020607000203020000000700070002000505000001
10636050455070208080226630204050507457507050807837203040526660548070532326506053521
10700040002000608020000060607040004000408000507000002000800000800080300000204000001
10704726405258404047682080804036342060806375236074535470705662304820804370253052201
10800000704000303000700040304000000070200000000060000030805000004000400020006000801
10202560505068603030605760704762368740503376736233834060805065572888487085506356701
10800030008000006060207000200000302000200000700000008050305000300000300040002000801
10534458356874776080403080755560202060368882806046406040405850605260402432256030701
10007000600000500040303030000070805020004000506000705020402000204000600030000080001
10505020503560304380404068523040702057835050402020506080202063708072436050268045331
10500030608000605000804000300080004000700040006070403050205000007000000020005070001
10255680707042232020303260304574574820405420428060804060308463686385706575802320201
10004000604000400060605000303000000000200070302080800020802000000000400000400000601
16606087208360605626705052634054565725256050307030524778308080664360743375606766601
10703040700040003000707020003000000000007040007030000020005070700060000000800000501
10304080582060725040803040706630258380202050786074703050827080504024668430625020801
10308070700050500080006000700070000020200060006000407070000070305000004040003020601
10303080408276304883267856863046643030327822345350283058244685704042604073704050801
10804000707000600000000000008040200080000030000020003000000000002000700060004040801
10302040403030202326453572302020403046428080852055606882767875608880483820827330601
10005020600070400000800000200030003000002000205000400000006000400080000050000050501
18355040432750757250704450505852266073604425307030637227206040406062507076863046701
10002030000060002080005000305000004000806040004030400020005070808000207000007050001
10538076447470307032746060407040507320706080424580703070248280304540228557453080421
10000050000060304000000050305070400020200050000000604050000000200050000000800040001
10462360638020204473604830804050455030888235266533802060583843683023533320303227701
10500070006070300000200040700020400030000000000000007050000030007000000070500000701
13805027608032505860602030675333403238532078437377836036205062802235255070886280301
10006020008000604000604030000000604000004000000000604000707000200050004070000050401
10856050505260644024805074482280203654202073803830604030806630656020705032455850701
10200050600070000060005000000040300000006000700060008060600080007000503040700000601
10242460206034886850322270582060824240855420765034885250733780605877804080604878601
10000050504040006050300060300080400020006000500050000070000020400000003030300020001
17526020805030707080408036407640336070202078747260853073447080406875367030405050751
10000080702080700070406000006000700050503000000020002080006030400000008000203020001
10532830508040208380408475246040508430203878404026407060407030334063525065882060201
10500000702040400070500070000070200020600000606000306020800030004060004000400080801
10705040505050658370703030435325282027565230503730404050806864503680504240404433801
10806050603030000070206040000000000080007000403000502000600000600050800040803040001
10508052204074774060823048835877682030705280466082603233402660756080857068508020401
10005000705000305000400080003000002060800080500050003000203000208070004060003070201
10867230406550207065803540504086406030207027305340487050257036603087706050355040761
10000070602040003000400000503070007030205000002000800060007000003000506000800020001
12863040306083654462743223704850288070288725784077205085406034855670603673707035601
10003050800080000000200060006000800070400050006000007030005000000070500000806000501
10254050226340707730702050274020307870708050202885357080826728866550252360803720401
10500040400000500020402050000050200030008030200080000080007000000000704000700070401
10407370808457604450206086483020335042653580403058227273404068266555803028352063701
10003000200000207000203000008080003000800080305030000070002000000000308030006000801
10557038668830406047203875502558728788505050804030808028663028304830206040606350201
10708070000070808030004000600020000000008000206000302000002000200070003040700000501
10708070507060407080625070738040606337468845723025603346208560433084333070203868601
10003020208000608080008050000080207000005000008000300000400030002080700040800000701
18385020622856704045605072358580727057408076504778763020575084205060307560625750701
10000060000050008050002000200060005070002000400000002020007060004000200000400080801
10753663863055838080505825606027702040642820203387307454536060644377705446208430201
10000000002050000070500020005000700040000000400000500050000080004000300000800000701
10787677504060447740754030757280544277222768253687483020778427345040734375335634301
10000000600070000000400040000080000000000000000000000050000000000030000000000000001
11111111111111111111111111111111111111111111111111111111111111111111111111111111111
