11111111111111111111111111111111111111111111111111111111111111111111111111111111111
10000000002000000000000000004000000000400000000000000000000000004000000000000040001
15707022602063637634404230823062403070405037444048362835576888406040667840282030401
10503040007000000000800020000070002040202000004000800000000000404070800050007080601
10604450348283732670708060684860245480702388402080805044324480504050402022406250501
10300080000000000000204050006000500000700050006040008080006060700050606000300060501
10237060403334477665488080704062604873566480647020548860606040257777606040507040701
10700020605000000000800060708000606000006000400080700000400030700000805020703000801
10202480475045742670507050606270683050406066403867606032723030706880406450706836201
10600020006020000000206030702080000080400030200000008050002070207000603000200000501
10876030803050344632302080605032653240525760703056387055604050206025702047547450201
10000040600050008000008070700040003000300000707000006000007060703000007080005000701
10645330207822878080376080862534708073404425206088508442606080602074537060205650801
10005000400000500030700040000000006000503000204000500000704070006000008000400030301
15507058387283605837804043632382463030404520804520536480508036847250305886452070601
10008020000000808060007000800000004080007000200050000020802000000050700000400050201
10663080662840603030802320804452308342702068202075807060863764434082757860804255801
10300050600070806000808070600020007000203000502000203050400000600040005000600020001
10203070304030404064506030668020786050223830477480306080204240802040706054546040621
10306040503080008000800080006030006040000070004000707020200040708030400080005040001
10308040208083462846404678404080406436266056706065804030632020602020473750805032501
10302060005040005000306000200030200000005050600070007080308040003030000000702000301
10702544453030805040304080837060735456605070308430767080704044567435655054462840501
10500000003000408080200080004060005000702030200080400080008000000050003030008050701
10565358575256308020548460408828807020402060445060403284584435678020607630706070501
10000000300000005030400080500070004080200070004070200080000080000080203000303080301
17527050506444535040503040256040586080767448602030407060555060505870205047203080801
10005020600000002040003070202040000050000000602050306050700020200070606000202000301
16406550403473508030658050502070373074328540302030807060707820854530802480203580701
10006000205000700060006020403060008000000080007070505000806000300050200050300040501
10305057465050685528204080702070606225862725553860747655603058207020604060437075601
10205000000080005000006040003060807000700000000000800080002030006000206020006000001
10504344755438607062283050627024504080408057586374802060335080285242444050507076721
10700000400030005020000020400020008060004000006000708000304060005000008080404000001
10362676406020657040505330302240754064463858703080803622302045605082402084207072501
10700070005000200080500040602060200040000000407050200000006000702000405000002000401
10307030807283503880206240805060405823863430332050706588877050608460307237342080401
10006000607000005000802000706000304000000020000060500050007070203000200060002040501
10775045602026555028254062208642704060685037486370448020602070507020332035308080701
10006000502000500020008030008000300030008070000000500070203060608030002000208040201
12705235504040208485607050564080388338407020407647503763705020608080202820702560601
10006000505040700000504040000060700000407000600000600000004060400020602000600040701
10666060705060685520203055837420634380436745327540544027305030625236506070306050301
10700070003050000030007000000080300040700080000050007000204040804000808020308000401
10607266844060675033273820737050603020403070378040703340783050608050824040566526301
10400000200030005000000070700050002000708070700020200030700050008060000080004080001
10708340406664606362746080507484656344733060303673727027204068464054607673602040641
10505000502030008000004050700000002000004050800000000060002000007000200000600040001
10348020707060503070533030338623703028205053204324866240405888437250203840305727701
10500060807000608070500050008000702060003000306000000000804000007000605000806000501
10207448208223332070504730604070502060454650357062436628266087502062622073806050401
10700000300060000050800080200040800030300000400030000080004000500060002080302080001
10673440746080602075568020276060204470604077603040333050607060803860705080406080381
10000080006000504030000050005070704020004050005080005000706060300030700040004070001
18364037507338603080753775802370408053532750704023508257403220285050422226368045801
10005050008000002080005000306000800050003000608000700000702000700070600000002040601
10708030474476845045503550802032253620603088362236608640304030402340703264807020601
10803030600000005000400000708000000070806000400000700040800060800070306000304020201
10646060387338405470608238606642802020408040508650333260645542765060704036306050701
10002080004000006030300000300000808000203050600030000000400000008050008030006040001
10808064407077288060774336886730523863804080767024685576744827302084726030646076201
10507000505020000040000000000030000070007050002020000000000000703000000040006000401
10805830702070608735457534463080566050824467484060236346335540707756876825605780431
10700040300070800000000000700070500080000000200070600000003000700000000000200030001
10774060685840844580374370305287605024543360407730407334304062238267803340856037801
10007000300040000070000080700000407040000040200000208000304080000000600060000050001
10807584402060782074725060354020805070205050343032703070402024705450708046286630731
10406000004050004000008030006040808040607020006050008030708000700040402000000030001
10308028488058555085302525608450404370874038506440464085206080267830808264632038701
10300080600030004000508000605000600000300020602000300080005070000040300070007080601
10468530806660403284804030464020263835802380307050408740788070376080704070772080301
10200000400000200040002020000070008000004000200080700030708070003020506000800040501
15304023354324375070886070423760588063646020836270604030805050352050708736205530501
10005000000040003080600020000070600070000040800000303000500020400030306000700000701
10702383227076602020802032243070603460407520307248478874485050305540802070608268701
10700000005000008060805000700040800000504000500020000000007080700000502030200060401
10778857578042668060604375606433736263408088435570505345505040573243573060577040701
10000000002000500050004000002000200070003050006000207000007070300060600040006000701
10736878407544206027573063323370807050745080602075602027863080307050202884206332701
10008000800050006020004000000030608060200050407000304000400050008000300070003000701
10704020863080207080802578882070708580502470702660883270248437268343255070285070401
10800050002000203000600000007000400000500000500050000040000000000000000070000040001
11111111111111111111111111111111111111111111111111111111111111111111111111111111111
