11111111111111111111111111111111111111111111111111111111111111111111111111111111111
10000000500000000000000000700000000000000000000000500000000000300060000000000000001
12282035302056723530254460607062434828308858664460602063675650467080504022754843201
10000040006060000060004000206000006000700000000050003080000070400060604040000020001
10703740405020875020727027603062207520405654532054682270803080503320704740233070531
10200000603020800080300030007000700000500020003000000000303050300000400000700030001
10266454634076304273705780405570458724246440204480457624307070483876642553805275201
10005000008000604000300000500030002000000040600040007000008050400020000000003000201
13407070405050208070733850783076607042776060235063404057574020606020407542747060401
10005060805030305020000070800070405000004040500060505040007060002080200000007040601
10536070306830505084333070503630504242203037302070206070803032475020856886207020401
10000070306000805000500050400000807000006000005050007050200020008030000070003030001
10526350603065602043606840503665804040788663828040768070588440703048666070808022551
10800040608050007050007000800000600030006070003050600020700000306000008020403000001
13406840802030654070766038748770783078803060707020505270202453303025503020822223801
10005000303000400020600030000030002000700030703050700020807000808020002020004000201
10687060608876248270806253782020307820366720564074324030706032808080535030807080701
10400030300000000080200080005070600060300080008040004020004000003020000080504030801
10604380734540736070704070605035257073506038305020803066634756806080424873808065801
10703000300020007000208020703000008000005000300020306070008000605040500000300040001
10602022388068403678566040303364803730886520307260585080302670703067308530808050751
10005050002000600000002000500000600070000040300070004000500000803000007080504020001
10357080802780204248405682208440458040542460308066305022224568606370362040705458701
10006070200040700040005000500030400050600080305000703030000000700050007000707000001
10228080886030805020785750508040407345406020207463303070563530325080238253207077851
10800020006000808030000040507070007000402000602000008000700000800030200000202000001
10607427704525405087347070702025253080406676636037654280304524706670407620738033601
10400000208000607000400060403000000050300000000040000060705000008000400020004000501
10403670402082804080204680602856747320704388422483356020606032227383772047603622201
10600040006000003070202000300000503000600000800000004040408000200000600070007000801
10374667287438536050606030532540406030854682204053808060607570305880203653685070401
10004000800000700060206030000080707050002000503000706080507000606000500070000060001
10807080703480506720206055565030503083577040203020803040205026504075876080488057541
10400070607000808000707000600040008000500080004080807030204000003000000050004060001
10282780204042245050707340403353457440206840746040604050605334854542607736207650201
10006000703000600060802000704000000000200060703040200040708000000000300000300000801
18805058607720306574202045347037238586685040503060365638206080534620686475802783301
10802040500030007000705050004000000000007020008080000080006050800060000000700000301
10207050686060657050202070205870664330603030874072206060275020202087756680878080401
10805030300040500030003000400030000080700050006000605030000050702000005070008040601
10602040402648602558762457352067227080473758874280724042573757805034407058507070601
10802000506000600000000000002080600050000030000080005000000000006000300060006050401
10306050803080802588325786704030303044688020327076708637658286706560275470242550801
10007080700050800000800000600030007000007000707000600000004000400080000030000040601
13838080546850336280808280204883745027806384703080487762704020303087302077473076601
10006070000080002040007000408000008000407050007080300040006080308000608000002060001
10587034238280507087866030202030705750605050686730805040447450307750873756572080361
10000070000050703000000060508030700020700070000000708050000000800030000000800070001
10724760425050605448502640504030765050352745266627707060342836567045454460807642601
10700070005020700000200020700030200080000000000000005030000060006000000080600000501
14808084806083505540607020546485308852546082762747845062804066802465462040286720601
10006040008000602000404070000000806000004000000000407000308000800050005060000040401
10887020804780823053408023827440707322208035604630207050505760832080302076528380601
10300030300040000030007000000050200000008000500070004070200020004000503030400000601
10478550808073326360266740277040255350638560832063675870488360803722406020508238601
10000050703020004050800040600060700080005000500020000070000020400000008040200030001
18433080408020705050206024202470672060806057747270726072875070302852726050407070671
10000070502030600040502000007000600050708000000030008030002030500000003000807020001
10487530502040206420708653386050708280308358203058203050302070858052736082244070401
10400000604080200070500080000040500050800000505000502070400020003070007000200030601
10208050402070735770305030486766738053354350502280504050704365605230608850408486301
10803030306080000050704050000000000040004000404000602000200000700030500020207070001
10606067807062838060364055835675225020208230625083802282603480887080656046402030401
10008000505000303000500030005000008080400070600070007000505000703070002070003080301
10444820707220802026707240802033706020502086802860358030556068802023804080286030241
10000050707060006000800000506030002070804000003000500070004000003000702000200080001
18763060308085524662284825208580748080766338363044304046706078677830308786508077801
10002060500050000000600080003000400070200030005000003020006000000040300000808000601
10437020856840803650703050328050305460805050202646628060584644685850244230804220801
10600030800000400070806050000040300050002020200060000020002000000000608000200080201
10502620705542804550605025262080677023588360608037237244603033663646204033547088801
10006000700000703000403000007060002000200020708040000020005000000000407050006000601
10686057628680405026803565305763232832705020205080804028823067204520505040706440201
10502030000030703070006000600040000000006000403000202000002000300030003050200000601
10808030208060608060748020523030403688627283748036502234702420572054886060502282401
10004070604000505080005030000050803000005000005000400000500030005040800040600000801
15756030582673408067806076626480376034203053806636485040552057604030702470826350401
10000060000050002040007000400030006070004000600000005080002070003000800000400050801
10343576264036368030403427708033604050426680704632207823663040656874208778303620801
10000000004020000040200070006000300050000000600000700040000030003000800000300000401
10277424603020675840673030467530623628656844456826665020653273882030588866356642301
10000000800080000000800050000080000000000000000000000080000000000030000000000000001
11111111111111111111111111111111111111111111111111111111111111111111111111111111111
