11111111111111111111111111111111111111111111111111111111111111111111111111111111111
10000000700000000000000000200000000000000000000000800000000000500080000000000000001
15238047302047383780274540702043786828703725828870502078522740565060405033784624601
10000070002060000060006000402000006000500000000030003070000020600050704020000080001
10204260407030546080755042308066408230808887774086242530507020605570405770683050871
10700000402050400080300020007000700000200060002000000000208050500000500000700040001
10783336325073407364304260307720835288327470204840447585305020747355288886704826501
10002000004000302000300000600070007000000050700050006000008070500050000000008000301
14802020704040408020867820538032308068774070377038705047884020702050202338438050501
10008070407080303020000050300060302000008040700030706040005070003020600000003020301
10526020607720505023778080505520605562705026602050608060803028362040536688603040701
10000080208000603000300030500000705000006000003050006040500050003080000040002030001
10575270503072707085404850506344404040377228352030686060736630706088586060402027821
10300060702040004050005000700000400080008020005050800040700000602000004030702000001
18603240702070246070353053252650238048302020207030405770204752202073208040484533601
10008000807000400050600070000050002000500040607020300080603000207040003070004000201
10248050606342586570703483875060402680372220273032543050707042707050472040702040701
10500050800000000080500060005040500040800070004020008080008000004070000040507060501
10608730268660538070607040605034833042408022405060603077738647204080322227406035801
10506000400070005000404070405000004000008000300060608020007000406080700000200040001
10704087836027606638658080406454402560367770308840235060208320403036603240706060821
10003020004000200000006000800000600020000020200030005000400000208000008020606040001
10675020407370504537308866808230543050627860502085603076727843205670447080704434201
10002080300060700040006000500040700060600060403000306070000000300070005000202000001
10625020336020702020723830308030605274208060506735302020368830326040482238405027661
10500070002000303020000030406040002000306000706000007000400000800060800000703000001
10707473803777303043825050308046268040805625577083334350704233604640407580358082301
10600000503000208000600040202000000060800000000040000030602000004000200060003000201
10304380402066605030603360806387637450803727426323478020504022686265533023802778501
10300030007000002040806000200000305000700000200000006080804000200000700070002000601
10846234826734833030703050727580503020425365405038703070807360505240806348532080301
10008000600000400060208020000060408080002000408000507030506000706000700030000030001
10403050507640606780402025387020302033376070705030603050802068307034434080266054841
10200050705000403000206000500050004000800070006060706020205000003000000040004050001
10684620804045645020504750807348385530406330324050806070305665478347304825702480501
10003000407000300060403000303000000000300030205030700070403000000000200000300000701
13308074803640808385707022447054677348858040308050672566502030547240765274605545601
10808060700030006000804040007000000000008060003060000040007020500040000000200000501
10805030845030536050608080504650743470205030453074304070226050202023387540585050501
10603050800060500060006000300030000040500040007000702030000030503000003080008040601
10703080202726406587772852783088354080685674345260728043464638208046504045402040601
10502000207000300000000000005030600080000080000030006000000000008000600030004050701
10808030208070302275427354204050202025474080886063505578724384206880437770347880301
10004030800060400000300000600030004000002000508000700000003000300070000050000080601
15377040465540277440703330506585375066705885302050772585504080603025703037766087701
10002050000070002050008000204000006000404080003070700080008040808000407000006070001
10225054688680602042426060406030406280508040287640207060336360208540662575358030651
10000080000030406000000070407070400060500060000000207050000000800050000000200030001
10472860668030802638703260402020882070364336377884302030388832786052673340705428201
10600070005080300000600070200060600020000000000000006070000080006000000030700000301
12607074802062602370502050626245206886756056777657245064407057407458774070367750601
10002050003000203000605020000000404000005000000000302000505000300040002050000030201
10575060202580378032304067763280206863707088507880205080803730683020606026427750401
10200060500080000050002000000040800000003000200030004040400020008000406050300000401
10875650502025723350628350466020435330538740742034255880666870402786403080408348301
10000070703070008080400080200070300080003000800030000080000050800000008070800040001
18586030605080706070504023503440755080707032747320445044474050603562682020308070841
10000020807040200040302000005000700060703000000050002060003030200000006000304050001
10488860807050402570402466483050406340704252808025707020503030382043368027736030301
10600000304030700040300030000070700040400000206000805060700040004030005000500020401
10308040206020436460807050735633652065788630508720402080505287303270804540204848701
10402020807040000050502050000000000070006000807000305000800000400060200020808050001
10406066504086574070776085888272463050808570434068302743804540226040878085204080401
10005000604000705000300040008000007070700050600080004000807000507050002040003030601
10848460506230705082602480307032603020207078203770357060382028706082508080866080361
10000050806050005000800000502040007060304000004000700040006000002000607000200030001
15274040507023638456337737602630587040534657766056607036204022227540405352608053201
10002080400040000000400060008000200020600070005000005060007000000070500000302000501
10742030522320805240603040853080207430502070404724583040358527367260223860306350301
10700020600000800050703060000030400080002030600080000030005000000000502000300020601
10305660602753708460805028733070638073653880308088536756206082484525302053827028301
10007000400000305000406000003050004000400070704080000050006000000000707030006000501
10255047833680705042508233506662768338407080508040304028752062603650503060302560201
10605040000060707030006000400070000000004000305000606000006000500020003050700000801
10507050302050804060686060863070406834458646626035602468705220274075264040306456401
10002060404000208040006080000070202000003000008000400000800070005020500020300000501
13863020274858404076808085547330283056802026706656746060666047602040706780577580801
10000040000070004060003000700030006020004000800000004080006030005000700000600050701
10565488474085567040503542303062405020443730604686506438776020736836304868306250401
10000000004020000020300080006000500050000000800000600060000080006000300000800000401
10322852503060488240376020355250543685677374456278346070486742864030568564837727701
10000000500040000000700060000050000000000000000000000040000000000080000000000000001
11111111111111111111111111111111111111111111111111111111111111111111111111111111111
