11111111111111111111111111111111111111111111111111111111111111111111111111111111111
10000000600000000000000000500000000000000000000000700000000000700020000000000000001
13764073603042832850578370502052683352605373457330206056464740524070708065322264401
10000060008020000050005000502000008000300000000060005060000060800080804080000020001
10603570507040444070834042205042204620806358627032567430404020803570508720665080581
10400000706020700070500040003000600000800080005000000000305020600000200000800060001
10428752728023802727302520706480567434382330305250242678803030762872333537203673601
10002000002000803000200000500060004000000050200060007000004020300050000000005000401
12307060605080705060573860778048402085843070638074504028432030608050306565722080701
10008050304030702030000020400050203000003050600030505020005050006030800000004040701
10242020403570406058832080206270302335806042307040705060302042387070468484206050701
10000070304000502000800060500000802000002000004080005070600070004070000050006040001
10573660505042407068407450702462607040475534733030765070433450207067874040405065461
10600030507030004070003000700000600050004030005040200040300000606000005060304000001
16607230604050264040376068753230283036808070303020502460607758206022806050478563201
10003000703000600040800020000030006000300060704050400050408000407020004070008000601
10373080303825236450304445767080704640853460473052348080802065207070633020702050401
10500080200000000040700060008020300030600030007040006030008000008070000020508060801
10308250786330364020404060702073388076802064303020703023878474404070688665505063501
10204000600060008000302060206000005000008000700070302020005000807020200000500060001
10305052377035802466235050807223206580566630807380654050407620605082505670706020421
10003060002000500000007000800000700030000060300060002000700000506000003060603040001
10525020508760804222704822206750626050885760504055405022755426706450845070705688301
10007020700060800070008000700030700070500050503000207070000000700080005000205000001
10522030464060402030262680302050805675205060604555404050784540633030665263204028581
10700080008000408050000080207070002000808000806000005000400000500070300000506000001
10402737204622508044728020205087544040505362638058722550302634308420507240473073501
10200000704000408000200030206000000050500000000050000040308000005000500070007000401
10208380608062606050407460406724574580606258226355545050305077666734474032605783501
10300070002000007020402000500000205000400000500000002050407000600000300080004000201
10364437648883463020507050863660505030765578702075807060405350704660808872865060601
10008000200000400040808020000070503080004000203000502050705000403000700060000070001
10607030704660507880605034832030402025343070204080204060806085802087787040627077741
10600080802000203000506000600030004000700020005080204020402000003000000040006070001
10435220802078342030505820305536647670804620822060307060308574572856605634605670301
10005000404000600030704000707000000000600050505030300040407000000000300000400000201
13206068402330706383507038635057458475353060307020856235307050434750866484707786301
10702030400070002000302040002000000000002050005050000080004080300030000000200000701
10806060656050258020405070606320256880508020358027808040632070508062888220786070201
10408020200030300070004000200060000060800070008000808030000060605000004020008080601
10804020402363805326382773425078763040488655866830543053525562704072408065708040801
10306000804000500000000000006030300060000020000080003000000000006000200040003050501
10302050504020306476823243805080302042774050384072504823862584603760656520468680701
10005060200070500000700000600030002000008000505000400000004000400050000030000050701
16775020757680558250602240407447864086405737303040574722608020604048206064748084401
10006070000030003040003000702000005000206060007040700030002020808000307000004070001
10486063222270306024657070404070802730703050323760303030773370806460734858673020741
10000050000050204000000080606070500070600050000000508030000000800030000000600030001
10675850662040703327702380706020375070274867426587607080826757384053278540702373601
10500050005040300000300040400040500030000000000000005030000030006000000060800000401
15308064808033705240407060857846407827232042368823825086808028704553247050848870401
10007050007000403000803040000000605000002000000000504000405000500050008080000060201
10482060208260778068808075272340805425703046402640702020506420333080802073256770501
10700020800080000020006000000050500000008000600080008050600030005000505030700000601
10526570502037256420865820533050456870757730248055343670247720603584603020704742801
10000060304050005020800080400060700040004000700040000040000060300000006080300050001
15588070707030804040606082808850224030303084286480235078428060706768235040407060341
10000080608040500060806000006000500070704000000050004060005060800000005000306040001
10444230806030205520804447644070603760805284402068507050307060787074325022352040301
10300000702020600040700030000030500060800000606000506050800020004030003000200040201
10606060408040868340308020546463847068634440606420604070306458203220702520308686801
10508050605080000020602030000000000020008000402000706000400000700050300070806020001
10306034606026573040482026836367282020706370828056603376506640677020647067705050501
10004000507000707000800040004000005040600050200050004000808000406050008030007030601
10537450603370508032406380408038508020602028606460353080722032306077504060872030871
10000080408020007000300000802050007020808000006000200080005000006000306000300040001
12464060206022546275265275304260247050366345622078605086207088367240707832503028201
10007020500040000000600020003000200020700080005000003050007000000050600000403000401
10586020432570804520302070233040607720807050306245572040453858846520574550604620301
10300030800000700060802050000050200020004050500070000070007000000000704000600020601
10402220208522703780605052768080387052456650803062374565502055748744204072645022801
10003000700000208000704000008020006000500080307080000070004000000000606070003000601
10438056226520204036805776808632648624307050308040604048427072208480608020302270401
10704080000070608040006000600080000000006000404000303000006000200040007050500000601
10407080406070804060353080655070803286463482244086808562407420738035686030304847401
10002040603000402050005020000060802000005000007000300000300030007050700050400000501
16536030878722505064402082248720224037302045806454353080757034803070504480578520501
10000070000070007060004000600080007060008000800000004040006050002000700000500070201
10566762746027752070306375803047306060754640505243506333523040478857206465307550201
10000000005060000030500060003000500080000000700000800040000020005000800000400000501
10385272507070378820766040352580537623377442664362485060534388855060275433856644301
10000000800060000000500020000070000000000000000000000040000000000020000000000000001
11111111111111111111111111111111111111111111111111111111111111111111111111111111111
