11111111111111111111111111111111111111111111111111111111111111111111111111111111111
10000000600000000000000000400000000000000000000000600000000000400070000000000000001
16245073705043366570387570702042426263608526226550602087433350423070604047757783401
10000070003040000060005000804000005000300000000050007050000070700030803060000020001
10504780607040778050623085808077608830602467857072236220407070503370803620335040671
10700000604040500080400050002000700000400020006000000000307080200000800000500020001
10688627376035705648302880502270643328787420307820263773204070837463583776307835701
10003000007000707000400000500020006000000030700040006000004060400040000000002000201
17205080405070702060242340572022407036823060422065806084575070708070303784833020201
10006070302070802030000020200060602000006050200040602070006050005030800000006070501
10364020807450406066586060608720703525402042406070704030202047246020484672506050701
10000080205000405000400040600000506000003000003050003050200040002040000030003050001
10686470308034802058608480202272402020445275387070654030773340703082624050205045321
10300080408030008070003000600000300030004030008030200040700000304000006040405000001
14706880808020848020472025285250336044808030206060604680308728408023603060326373201
10008000304000700080800080000060008000500080507060500070308000708050005040006000501
10466080302225678260304246655060306680654250366046652050202066206060685080204030801
10800080300000000040200070005080500060600050002030006080006000005050000020705040401
10503830868340474030604030407077768087203073206030804025788774804070587655503035701
10302000400070002000503040604000008000005000600070304060005000307050300000300070001
10303033538076402438758080607576202450753740202340345050803850208046604330506080751
10007060006000500000004000200000200070000060400030003000200000507000008070407040001
10467040504270708635305256604780773080432760306082303044657357406360222070203225301
10004070700050400050008000200040800060500030204000204070000000600040008000602000001
10358070385080605070546330408070305283807020803865703080888640347030382338308088361
10200020004000505080000050204020004000706000807000003000600000300050800000503000001
10805542706446804022427020208082366040408832854076847420507352404640404420782045601
10500000803000505000700060704000000040400000000040000030807000004000700030005000501
10302350708062607080407420805284225350702827832554558060303058223442857076606248701
10500050005000006070204000300000503000500000300000006060507000200000300060005000501
10555863364252734030404030633620507050525672604022702050706370405570602252327050801
10006000800000300020802030000030604030008000405000807050602000507000800030000030001
10804070807370602740405046426030706046686020503040407030308023607056547060554026241
10700080702000203000803000300020003000800030005070504030402000002000000080006020001
10235230803068877080403880403854744880706880557060805020805265225585802473304630401
10007000806000700030605000703000000000500040805080200050303000000000600000400000501
12607074307650705857805067876032433828257040602080545634604060268670577253703485801
10504080800050006000704050008000000000002070007040000030006020600040000000200000201
10207040355020233020202060807550865540704040584073704070874020502047236680838030801
10406030700060800040003000400030000050800030006000203030000060805000003040007060401
10806080202766308483248636625082725080834842245380886077546646507046402022407020701
10402000202000300000000000002050300080000030000040005000000000003000700070005030601
10605030404080306843472523808030602053575060332087508765287827507330455720332840701
10008020800060700000700000400020002000002000803000600000002000200060000060000020501
14465020266320228560706860702437224067403468503040252585708040403047802036526067301
10007020000070007040006000707000003000706040005020200030007020506000304000004060001
10656057857750706032572060408050708820308020667350803030455770408370644836667020351
10000080000080207000000020406030500040700070000000704070000000800060000000400070001
10733430244080607746505760405080733050824444325223204060324554356028322640606544201
10500040005070700000500080800030800080000000000000006030000030005000000030300000801
12706068602064306540203050826233503838643077682864452046806025304876648050624850601
10008050007000608000603070000000403000006000000000404000607000800030008070000030801
10642060206870672058605032873380203622807047303230707040807880862040708058845580201
10700020400050000030008000000050500000002000500040002040400020004000306040700000301
10446760808088838850348830843080788760824250436038448670566720308656803020608858501
10000070506060006020500070400040700050003000700020000050000040600000002050700020001
15856080408040302070206083507850573060403066556760548046382080203524283030604080621
10000050204080700050508000007000200040808000000040003040007070600000007000306050001
10554260706030307750808627754080403320602867207035206050804060725044554085547030801
10300000304030200080800020000060600050400000308000203070700030004050002000500030401
10305040705040683220204020428255823085644230405580502040707375405760703830602382301
10804020404070000030307020000000000080004000602000602000500000500020300040804050001
10206076305077267020867084577285742080708230445063307852303760886040677023303050701
10005000803000205000500070002000002020500080600040002000406000705030008070003020401
10267240307570603063708640403053507060602035803480585030478045603084603060848050331
10000070805050005000400000202040007050408000005000300060006000002000706000800070001
14255050707043623647683254206240655020825646645036304073608058265630406342403063601
10006060600050000000300070007000200020200050002000008080003000000040600000204000401
10724030288620402650406070425080305330707030604335333040866732644720422540506660501
10700070700000500060705050000040700040004080500080000080006000000000402000300040201
10602440807225406730607076372040682072865230806048866258707042654883704028358078201
10003000600000405000405000007030006000800050306070000080002000000000506050004000201
10565074842450808027303465703252264568408080503040604086763023603640407050402430301
10702050000030305030008000500030000000008000604000208000007000400080006080200000501
10205080706060306020766020585050807773576572858054207268407250788034536070302588301
10003040304000604070004020000040206000005000007000300000800020006020300070200000401
18367080534675808037702058622660645047503075803682846060563063508070605860366350201
10000050000080005080005000400020006050005000700000004060005050007000600000400020501
10736733354022664040202733203068208030668420307328206722858030282442606425304470301
10000000007030000040500080002000400070000000200000400050000060002000600000800000401
10748382606060474670338050727840524784657577287668272040756487854080338232858873801
10000000500020000000300040000040000000000000000000000050000000000060000000000000001
11111111111111111111111111111111111111111111111111111111111111111111111111111111111
