11111111111111111111111111111111111111111111111111111111111111111111111111111111111
10000000300000000000000000400000000000000000000000300000000000300060000000000000001
13832057606037455650782660506056343347302264772470403063344660667030207042242268701
10000020007030000040006000303000006000700000000040004020000030700050702050000020001
10807370803080272050852066504047704850502655522037543450508020203370404650682060551
10300000605040800050300020008000200000700020007000000000408060300000500000700050001
10233738877064602742602230507250672845366320603530358555203040785456235463303244201
10002000004000607000600000800060002000000080800080005000003030800040000000008000501
16808050603070603040472470288023303032655060333044606056553030408060604622438030401
10007030604060702040000030200030208000006060700040703040006060008020200000004040301
10432080703640208075886080503450306355203078505080206030605064728040674578506050601
10000070603000402000500050700000502000008000002070005070300080005040000040007030001
10756770207036606043208660406252702050546582378060886050224280404034737060805044621
10800040606070005080002000700000500060005050007050300020800000708000002030205000001
17305370708020828070836035385350686027505070206080507550305845508027505070642827201
10005000506000800020400080000070006000800070205030200080708000505080005050005000801
10256030506288222560503486275040408750723820227034726060706037507020376070203080601
10700030800000000080500050008040600040500080005020008030005000002060000080607040701
10706630286580853020208020406054752075308053305070803065826657204080637227808087401
10308000300050005000504080703000002000007000300070302020002000606030400000400080001
10306032444027603283476020602683703570524540206620358060808720504025606230508060831
10004050002000500000005000300000300070000030700020007000600000603000008050202080001
10546060208680208586408863708570788030248250407025805055536768804760578080403547301
10003080300040600020008000200030500040600040304000503070000000600060007000802000001
10483050465060403040433470604070807432403080502264208080546850268070637536203055371
10500070004000703070000040303050005000503000604000008000400000500040200000203000001
10802445407457804033525070202032585040203882345025846450607745504670605560882082201
10800000808000207000500060604000000050600000000070000030305000006000500060007000701
10207770303085505020202240306555533770506876843427265040202063527658378077505372801
10700070007000005020206000300000607000200000300000004040402000700000600060003000801
10664463233876874070403070347370503040436852407078302030608470402720505888484080801
10007000300000600040204030000040504020006000302000408040504000407000600070000070001
10507080605780502530203066637020805064642020308050807020408023607064735060236082561
10800030408000202000304000700030008000500070006020408050707000005000000050005050001
10472670405028633060702560702436465870805220848080407020804364563356604772302450701
10004000805000400080402000702000000000200030506030500070707000000000500000800000801
14403083505350706876407027746037766774887060508020766657304020637770235763406346601
10508030400040006000307020005000000000006070006040000020004020800030000000800000501
10608040785030375080702060306630678230804040483053704040565080608085858750373030501
10308070200030300050007000300080000080700080002000706070000050606000008060002020501
10702020702455502644588437887055586080525675623570346075575262605032303065604030801
10705000405000300000000000002070800050000060000050004000000000006000200040005030601
10706080405070502724265822803060208027876080284043604285333253608870466280625750701
10002040200060300000500000300040008000003000808000300000005000500020000070000040701
15665080533760537420604320807577625035504838407020522285706050806062606052224046301
10004070000030007070004000607000007000307040005040600040005030808000404000004030001
10875048363850205085642060807050705220305070548840804020434760507470552556266040251
10000050000030305000000050503060500060600040000000802040000000400030000000700020001
10426380785030702725403680508050728070367636725262507050736633524082272670705337401
10200080002070700000600050800060300060000000000000002060000020004000000020200000201
17205046503085707420702030455676708787325047867546366034308088406585462060784220201
10007040005000303000504070000000707000005000000000304000608000600030004080000080501
10532060506360547027207022378540402422707065506850608020406670777040208047738620201
10300030800040000060002000000030700000002000600040002040600080007000702020500000501
10677230704036633220822370446050865550573530552048562320856460808532805060806366201
10000060807020008050800030800030800030005000700020000020000040200000003070400020001
16783030802040508030603054208270687030807035358550638067233070704733663030406080651
10000050406060400030607000004000500080505000000060003060003040300000006000606020001
10236570308020503460308778462020702250303223507026207060207060265026248034444060601
10800000204030800080600080000020800070600000708000508050300050006070003000600070601
10202040305080665540403050227783338023676770805430403070604476506520605380706424601
10502030406020000070508030000000000060007000806000805000800000300080700040408080001
10804047306078745040858033872645745030204530576027304383602820664040655033405050601
10005000804000604000200050004000002050800030800060008000608000208030007050007060701
10683620407280604047608740202082206060505055408660784070734033403037806040523040281
10000020607080004000700000608070004040505000007000800060003000005000702000700080001
13344030604027768786542837307240654040432775528066204054305052734480706726808034801
10004080500070000000700070003000500050400040003000007020005000000020300000608000401
10777040542560808740808020273040502620505080307343878030337673554660647520302580501
10200040400000400080607030000050800070006020800020000060008000000000602000600070701
10605840308535405680502024622050736068526630703077744774805024848686404023865044301
10008000800000705000608000006080008000600070505030000070003000000000503030006000401
10867038533650804037302245602734345325704020502080707043523074403760703030306560201
10605060000020806080003000500070000000007000705000802000003000200040003020800000601
10705060304040602030326080833050405533573632253064308857705720657045585040506365501
10007060207000706060004080000030504000006000008000400000200040004070800060700000501
15225040435834603082504027332680366062706075507456554030276047705060208530255860401
10000070000050005030002000300080002040004000400000006080003020002000400000800060501
10543824573077445040807736808074306070553570407277203876538030888785804728607720801
10000000007080000070300060006000800080000000400000600030000080007000300000800000201
10238244202080377530255030648380266726447223477573734060445657824050256823363874601
10000000200040000000700070000050000000000000000000000080000000000060000000000000001
11111111111111111111111111111111111111111111111111111111111111111111111111111111111
