11111111111111111111111111111111111111111111111111111111111111111111111111111111111
10000000200000000000000000300000000000000000000000300000000000300080000000000000001
15836054602025882360346260704072636324408787757260208042485750644080707054458282701
10000030004040000040008000506000002000200000000050005050000080400040402040000070001
10506750605020787040836062305048708480606683322024346830605040204350507770434040321
10500000408060700060200020003000400000200030006000000000606050500000400000300050001
10585452848044303848708560704230424642337460307430824757205070837626468685607287401
10005000004000806000400000800060004000000050700050006000005050300070000000007000301
13408020403080807040277430456083507042364070222032406034337020505040602858688020401
10008080402080604060000020600040405000008030700080205020004020007030500000003050201
10858080705780404063767060203370407673407055405080604050705055232030477657202060401
10000050804000307000700070400000404000006000007030008040400070002020000080007020001
10544530304038708053502350703565703030438668678060456020376370704047773070805026561
10500040303020008070006000500000500070008060008070700080600000704000004020208000001
14605670508030753080556052867850852072802020706080308520803877405026607030288456401
10007000405000700030300020000070006000200060402040600030705000208050007070006000601
10562040702843374320307772487020303370777250767026666020807036606080575020207040701
10300040500000000060600040003050200030500020004050004080007000007060000050404070301
10604350334420784040203080802067776082405044608020708038285555806040387454506028201
10604000700040003000308050502000002000008000500080806080007000805040300000400030001
10805067787067308767485030708753607520584440504250478070204640704035403280806060671
10007070005000800000003000300000700060000070700070004000600000206000005070606080001
10544040805220707778306744804650552020776540703086506082443748503250365040207884201
10004020200030300060003000600040700030500080707000704050000000400060006000505000001
10552050352030202070452650705030704633205070208388206040862630566060732224807068341
10400030008000203050000020604040002000203000504000003000400000200080300000608000001
10304532304254607027723080602033288070504222484087545750406388808730802630827037301
10800000606000203000600080305000000050400000000030000040404000005000800080007000501
10608650803054707080607580308454227380802733425564468020407055378337324077605332701
10400070003000007040208000200000307000500000800000007030205000600000700060002000401
10435843354585374070305070588630407040347786406044403080302460408270402647287020701
10008000400000200080703020000040406070002000404000806020803000503000600060000030001
10306020805340705470406044886020205024386060802030606060807033703088775030334066241
10200080403000306000205000200070003000200070006050202020504000004000000030003040001
10854320805077542030606560206427774730206740836020706060703882844776306558708260701
10003000703000400060404000504000000000600060704050600060705000000000800000500000701
12408034805830702532207038465065485572645020708070422726305080535260882675507752201
10403080600080006000808020004000000000005020006020000030006080500030000000200000801
10404020732070264050707080603240757730205020447043203030783070308056757220477070701
10707050200040600050007000700050000060500030002000306040000040605000004030007080401
10206050506662204278368663533067632080324253386860267052664835404032807044808030201
10302000702000200000000000005050800080000020000020007000000000008000500020003080601
10203020505030302578528352703060807074545030666055203824257358607760583580247630501
10004020600020800000500000600020003000008000606000300000007000700080000060000060201
18583030433370327330207420203363472057302234402020466277505070802036808027525048401
10002020000070003040004000706000005000703020003080600050004020408000305000003060001
10584078685730406085658060807080403570702070877250803040864660207540783848627020231
10000050000080706000000040607040500020700030000000408060000000400020000000500050001
10444250325020707758404480207040288060585834472376803060253564273078245870804387201
10700030002040300000700070200020500030000000000000004030000070005000000020700000501
17705068806065507620302060587623402634384065248477557044402077605564773020373560401
10006030004000305000803020000000406000005000000000406000202000400080006040000040501
10386060608370278052308033748580307482302025404460802070202280242040303065575650401
10400070400040000030002000000080700000005000500020007030800030008000304080800000501
10444740807065327650426830243040465850545680724063538250453870303653406040705688801
10000080307080002050400020200060200030005000600030000070000050400000007030200080001
14728020207030606080407033806460442030708062574240575046562080406582365050808070741
10000070404080800020403000006000700040203000000030002080005060400000004000504080001
10564470402020802460303767388080506550308453206037302050308070282065533046446050501
10800000407080200070300060000030400020400000208000703060600060006020005000400070601
10705080604080737220502040233578723062268320504780303050308862807830302850503875801
10707070505060000050604030000000000040002000408000607000700000200050700040307040001
10403067208034736020424088233425827040303230475087408276202530882050668075506060401
10008000202000303000400050002000008050800060700070007000507000706050002050005040501
10243380208550208052208250208023504020806068306370673040387068306085505060754070541
10000030607050008000200000408020004040805000006000800070003000003000403000200020001
16587030303038327644768842303880767050557677455067308087406024846630404868306032401
10003020600070000000200070002000800080400060008000007060006000000070500000803000201
10747020483570602880802020435050308530807070506426542040472284525460465430204770501
10500040500000600020808020000050200060003020200060000020007000000000607000700080301
10508280205335505230808033627040474067434730504022373384406036777678406025777028601
10008000400000302000304000008040007000600040407070000070005000000000208080008000501
10336032382660804027807382507767668682303050608040608056552075805740403080803640301
10408050000040807060006000200030000000005000205000805000003000300030008060700000601
10308040307080306050446080285020404837875557824036605352207740783086355020204678301
10002060608000603040007060000080503000008000007000200000600030002070800060300000601
16833050638237305043408037386370483076203075606838556030787086304020708360535580601
10000070000050003050006000400030003030004000700000002040008050007000600000500050701
10232823253072342030706235502084206050474260804643405787568070762753704584203580701
10000000008020000030400030008000200050000000600000200050000070003000500000800000401
10542534407050378230573030875720465687223678262536778050826537665030277747488273301
10000000600020000000600030000070000000000000000000000050000000000080000000000000001
11111111111111111111111111111111111111111111111111111111111111111111111111111111111
