11111111111111111111111111111111111111111111111111111111111111111111111111111111111
10000020000000006000005000008000000000000000000000300020000000002000005000000000001
17703025566820804040778040802030547625802883245570602070702556805056702020827037201
10005070000000600030700040303080000080008000700020008000500000400030402070002000501
15844060842047437540205640207047463080844060308086245084247570204270207080308850201
10000080002000400000602040405040000080500070505000002000004000800050007080706000301
10773776304540407378405030607040277470808740724623808573607085465555352020207086501
10007000004000300000003000800080000030707080000050002000002000000020002040505020001
10302050457047543446858683503723662060704030252030754027744368386070807080406082761
10800020005000000000600000803000205080003080400070008000000000005050300060306000001
10843262333636554750503450583030508036567020307053306086806522502070303260804686201
10000000000040500000500070002070006000000060504050005000308000006000600040600000301
10885468674060307562658067202028403687834360202320654050806062724745564070776760801
10400000003050306000006040805000300000000020400020007020808080000030005050000030701
10304033204040802050807030403330344867424080836050307370337020374062205027848470701
10404000603000200050300050200050000000700070400030400050400070002000500080000020701
10206520806566853645325240806028346340406880802620543050704286606030476850734050401
10700030206000800000000080502040000080704000400070500060800030404060000000600080701
10534030804040302067228030606070308070542045852036204040244020208333606287703030601
10005020700080006000005030602000206000300040600070007060500030200000205000702060201
10608040772626263285803060808328372067307460707350374040302870306850375080705430201
10505020003000000030006000300000002000700020400020007080700000500050000070300000301
10302025806064307780402486856544607570303070807048304060582628347743327640825254401
10504000207000202000500000000040008000807000503000006040000000000000400000200000701
10203680702270466020735267772030277423877427203820336052743650508685208057408620601
10700060600050000050000000007070000000003000300050300050000080500030003040002000801
10753060602030726480255438304037346740706480304022808262557080678080606460807537401
10006000307020000050000040007000000040200060308000800000400080007080605000404000001
10407336453050774033888020506334267078627040602850346440304828203050824080303046361
10707000000040500040000030200000006000007000500020004050800060008080008050805000201
10706056805780703426325540686378405863203033427085404040553050253055802083404550701
10404000200030700000400000300000200050002000004000700070000050700020003000805000601
14503740332060626220202566707780506030574283278277723536455030542520228820303063201
10005000500040006000702000004000403070000000006000000000006030700040000000204000001
10667060606453306080702523546080206037756868503068554867308670305076266224434273301
10500080300000307040500000000080502000000060002000500000500030005000000000000000701
17504086575026604040803752722283404375557020808835802020438050646772874677222670351
10005070002050002020300000003000500000006060307000706020800020000000000000000060001
10428750704020768080368720672070648338856060572020302080806030665842583227532087701
10000040506030006040500040600070000000400080007020005030704030000000005000008060001
10537032406685307057202030608545675030208283405043637570407075808666445060577060771
10003020004000302050008070806000003030207000002000008000602000300030007040200040001
10705080788040207020506062607030704040835082682855507085802880444750308054702463201
10404020707060606000603000008060803020005000800000707000008080700000402000003000301
10302050502080706652368678328030603720804720367670304823344070203022505068674046601
10404050700070005000003000000080300050400040000000700080000040006000402000003000801
10803030405843778060307067872420308067872084243347858040638035835748702086563740801
10604000800000004020508000007080602000007030000000000070006000700070005050000060001
18407026624284688040406525706020405526202040226357856282203040402080204470208024421
10006000000000700080700000007000700070405000500000000000008040303030208000708000001
10846588846622803030468044748663858030508322402027702347574020604060727084456772701
10000000008000706020003000000060000060600020007000600000400060003070000080002000501
10386274206040403754504028526020608450305030708380255330304358665044233680202020401
10005000700030002000007000600070808000605000708000800000200000004000000000202060001
10807063504340783056426570602460872022304038304032773024254575206043862384755065561
10203000600040003000000050800060004000202000508060005000300070003000000000300080001
10508280764084303085683023653058807580503727405030702456704070752053576270704722701
10500070800070006050008060007000202000204000805020200000006060003000200000300000401
10437070382664367044504080305230202073684080276030364843875057805030403762337480201
10200050000000006000007000804030300080007050002000208000300050005050700000000030001
10307648663677602084542864708040763250506563205328608030306760264070202743432033621
10307000000000307020000000006050003000800000308000200060004000300080704000005050001
10805030602370504380483364726072703050858630405880308848638083204080507036266045401
10200070700080500000700000000040002020003000400060402000003000203030200070005000001
10574440884860808274608636404340826030506045267020807076707230506820724660407825601
10007000700000705000008000800040300040303040005020604000200000400020000000600000601
10405776704374332026273060232650806028805050703020247780328423625087608578442540301
10800000700000000020000050000030405030008000800060000050000040008000704000000040501
10735580275234645280737587377050805050254458664872655078504050502530754060374080361
10000080000000000020000000208030503050005000000070006000404050700060000060006030001
10634034253680575037234470803030308026404087407030223780662064326020655532607055601
10003080000060007000000070200060703000804000602000600030007000000060500020004080001
14803056225044406463603030352870708080804640307075506082408038482870603050722070651
10008000004030008000203000700000704070800000807000708000308000000070003020500020001
10807683507050348030488056206645202530274446705438707270803034342062273860705062501
10807000300040000070007000200000003000300000607000005020004030003040000000705000201
10446040802462565875205564656558282083705040283067574075435670805040882863205574801
10000080800050000000800000000040000050007070004000006040000000700030800000007000001
18435740283030788720306785575070403730483388203845402087637227682770207437755067481
10000050404000600000300060003060800050400000800000408000000000000000700000500020001
10375520803248507355427070732020263650207242757840503646352272864326865650606278701
10000000200000006000000080000020000000400000000000300000000000000000000000600000001
11111111111111111111111111111111111111111111111111111111111111111111111111111111111
