11111111111111111111111111111111111111111111111111111111111111111111111111111111111
10000050000000008000002000004000000000000000000000400050000000005000002000000000001
13405065376730806040464080402040375636404436385450708020404886603054703040633026701
10005030000000500020800060505060000020002000400080008000400000500070307070006000401
17843070745066275320202650706088454070625080206068284033525440203550405070808550601
10000060007000700000303060205080000040300030202000007000006000800030006070604000701
10453353605350804527603040508080324680408570736274302587807074245386753040508067201
10002000005000800000006000400030000060704040000070008000002000000050008070504030001
10808020364084728234658652804467776070302030346060722084724783543060708070306048561
10800080002000000000300000305000404040006040300080006000000000005030300030402000001
10227446438746832870602360786070502037255060507065707077607328304030802740202638701
10000000000040800000400050006080002000000050402050008000207000006000700080500000801
10276343244050803875248033805077804654476440707880725060804053448286636070763570301
10800000002070205000003050507000600000000080800060007060308040000020002080000020801
10603056608060507060203050206830362545288020232040507220345080336048608022322420601
10207000502000400020800030300040000000800020400020200050200040007000300050000070801
10706540708628632826788630702035843670406480807420438040703883508070268340764040801
10500070805000500000000040802060000050708000600070800070500050502050000000800050301
10247030408050704047377060404070303050737067422062308040274070608744707378604020601
10002050400080007000006030407000606000800020800080002030400020200000308000408060801
10802040638584522756404060807785785075207520802870325050503750405630624070407540801
10203060004000000030004000600000008000500050200040002070500000600050000060600000701
10707036403077203520206268544788503770605050806073406070848555387233642780656323801
10805000402000603000600000000060004000505000205000003020000000000000200000200000401
10704760205760477050826655672050325338455444305570645074266380605887508045504640301
10500020800040000060000000004030000000007000800050800030000040600050005030004000501
10733040402080754360573574704088654430608880402078702785335070267030805360703775301
10003000304070000020000030008000000070600060705000600000500040007060802000803000001
10204255268080767072388040804333555076552040508620753350605584307080882040602038351
10507000000020300020000020800000004000002000500050005020400020003020004040606000601
10707057508370302486644370324628402668406056347054304050443050544027405057806220801
10406000400040700000600000500000600080005000006000800080000070600030007000608000601
15405380227060622340602684508280406020622884476646463685738030622570252520408078701
10004000300040005000704000004000604050000000003000000000008060400060000000507000001
10232050705628308050204866554040503077277228207076326537507750406087253884562738501
10300050500000604060800000000080208000000040005000800000300030008000000000000000501
13208052736027508070804627743554803627384060806243702030574070335756424887424780721
10007070002020005070200000004000400000004070704000708030500040000000000000000030001
10283450703080447050846380355060533832536020272070202070207060758324528373753075201
10000080204060008050400030600040000000200080002070003060408050000000004000006020001
10274054402227705026506050505634227080602737207026784740804056807383666040384080851
10008050008000203080004070707000004030203000003000004000303000500070003040200030001
10303040826060402030204053606050408070428044245287808033807780645250806056308344201
10602040202040302000308000008040607060007000800000402000003020600000306000008000501
10602070407050606655548538458030803370505730777830305628445040808028208068258057201
10707030600030004000002000000070400030800060000000600070000060006000506000007000601
10304060808245584020807054567520402048474066523468263040684084842732702033884270401
10602000800000003040408000008070606000005080000000000040007000400050006070000050001
14806062683378626070504747506070704845805080577755467748405040506020306470808052851
10008000000000700050500000003000400060506000400000000000008070204020603000406000001
10855878873588303060725042577378657070402542206075502287354080506040436024758346601
10000000004000505040007000000070000020400020006000400000300070007020000030007000601
10264226806030802682306037322050207370602080207730366770607547657083267340606050801
10007000200040004000008000400020206000808000403000700000600000005000000000204020001
10706026708880542082823280304260383047802082404072623027664744806043638676258064461
10308000300030004000000060800070004000508000203050002000400060002000000000600080001
10504560583023407038368027322037606680208754204080508657602030745036753220306286801
10700080800020003060003020008000407000608000708040700000003050002000800000700000501
10754070656452768043507030705430706064748030433060452336473082208060502763666450401
10400020000000007000005000203040600030007040006000403000600070007030500000000050001
10505373863734308024884464603060223380805473207255804060304220725030406848852023661
10205000000000302070000000006030006000700000206000500030002000200050305000006070001
10602030206750408720878322558033408020756350608820408455463042606040303048524075801
10600040500050700000800000000070008040008000400080502000002000205060600030007000001
10335760765320204672202833306550885060403086842070807064705420806360322540303827401
10007000700000806000008000300020500060607060002070407000700000400080000000200000401
10704654203562467087742040573540306082408060207080527280654825668038206235657280801
10400000600000000030000030000020603070004000200050000080000030003000306000000040201
10235330683424735450472326257080803040757283522464635057604020205330624040383020431
10000030000000000020000000806040808060006000000030007000207080600020000080005040001
10472057552560826046852280603050406027605053708020374850484073255080842335608037701
10006080000020003000000060600060605000507000203000700030002000000050700030002040001
17508024767024703822307050358830502070704520602086608078605042446620703030787020261
10008000005060005000303000300000205030400000408000506000404000000070003060500030001
10205547605040753040253082302266806640264474708724403770702055848078422270604036501
10207000400040000060007000500000006000700000706000005060006070008080000000304000201
10486040203253578326302584242863526028505050825036537073455430502040863534802685201
10000040600060000000500000000050000060002040003000005070000000800050500000005000001
17255770728080772820307225752020305750254376208577707057736456872480806322525034521
10000080702000800000500030004020700040300000600000408000000000000000500000200070001
10653740704746207788782060573070265430503622667680803436553826778427388850807624401
10000000300000004000000020000030000000800000000000700000000000000000000000400000001
11111111111111111111111111111111111111111111111111111111111111111111111111111111111
