11111111111111111111111111111111111111111111111111111111111111111111111111111111111
10000070000000004000006000002000000000000000000000600020000000002000008000000000001
13204077465680203020675070303040686665308647265340503080305638302076806030664058701
10006050000000300050700020703030000070007000500040006000300000300070302040003000601
16852020744045246280402480807047575050324030206075842022636780702870507050604280801
10000050005000800000303030305030000040500040602000003000002000500020006030204000601
10688862802320302226505040406020248520706250734367504884807077646534274040603065701
10002000004000400000002000400080000080608040000080007000008000000060006060202070001
10303050422025832787476665207333225020307050854070477073558722766040506060203033871
10400040007000000000800000206000504030004040500030002000000000003050400040708000001
10573452827343537540203550377030805064626040307053504085704775503030402270304523701
10000000000040700000700050004080007000000060302060008000605000008000300060600000301
10542357354030807688487087803082305472453620608240627050604022857482277080368860201
10500000005080606000003070505000800000000070200070008030306020000080004040000040501
10808048807080706080306060806620832757586020542040808760683030822056707074654380301
10806000307000500060700050700060000000600020300080600020300020002000500040000070401
10805350404888576842382220407057878860303850804360638080208255308040644370534080801
10600080807000400000000040305060000070303000400060400080500040806050000000400070601
10574020806050307056574030403080708030655072585066402060333050405478303467207080501
10006070400030002000005060204000507000600040500020005070400040300000608000302080201
10605040486878367324303030407664333035508480803760685040408540207840822030607630801
10203070002000000040004000200000006000600080300050003080200000700070000070600000601
10703034704063308580302444467286805340804070508073605070678236668832337640675374501
10408000506000804000400000000060006000608000803000008040000000000000400000400000301
10808770807220578070824236477040322856483283702450358058588380507327808076602570401
10400020200020000040000000003060000000004000200050500050000050700060005030008000401
10543060505080435730642238707046637740707730408022605246334030237040302840403862601
10007000204070000060000070004000000050800060502000400000300040004070507000402000001
10803548546070238033828060804424378023638070607640576430407875508070763060204057241
10204000000080500050000060600000005000002000800040004060200070005080003030406000501
10304026704580505558447240444748808423507046724082303060478060262057604066406240701
10806000500080200000300000600000500060008000003000200050000030300030008000308000401
18804740677080434250503774307440206060787862575834633444366070485720273280305086201
10003000500040005000203000008000708030000000005000000000007030200060000000708000001
10352070303263407040305354845040606025584528202032575272404380608078756728257535401
10500050600000406080600000000020402000000080003000500000500020007000000000000000301
15404035855072702060705626832255807228337080608555603020246080635657452355287440731
10002050002080003020200000008000400000006060704000808070500060000000000000000050001
10676260702060276070656560667070382455254020373040808020507050468723623386576072501
10000020403050004080800070600030000000700080006050005080208020000000002000006050001
10272037302757206033803050505767857030206487203053724880805043608257466060836070821
10005050002000707030002050602000004060206000005000005000606000600040006070400020001
10805040276050502040408068703080502080788048824866403063606780875570206065807765401
10206020803080802000502000007080504040004000700000502000007020800000705000006000801
10508060404020705564454226374050507420207880426830407385426070406052504026855076201
10708070300020002000007000000030500050400040000000700020000050004000803000003000201
10803060607246234060302075755840508024546068632836877080352064478354508034723770601
10303000800000007040502000005060405000006070000000000050003000600020007050000080001
16802037836283466030808443602030808426803020865366676677604050208070704620302053641
10004000000000800020200000005000800060304000400000000000003080202070504000403000001
10388272665828302030225024632876332070608888404043608485356050706070572022484787601
10000000007000406050003000000060000070200020007000400000700030002070000060003000701
10767332706030503566706068634040202370708030403650637270306726877065265370205030501
10002000300020006000004000600030307000407000602000700000200000003000000000607070001
10508038505620648025283440307540662042806066203056264053725783506042374638567057281
10203000700030003000000050500020003000505000507040006000800070006000000000400070001
10803720833052607053274086763034508480607764303060504637808060466085287450604287401
10200080600040004050002040008000706000604000605030200000008020005000400000200000501
10547020882866538024208070203850308083528050752030487625245053704020803755442570401
10200080000000004000004000602040600070004060003000804000200050002030500000000070001
10408378873238308054744245802040233730406635404552503070604730547080402746854038881
10808000000000307080000000003040007000400000707000300020008000800040706000008040001
10306030406520804830267485555067202080436450405870508223786043707030504042572036201
10300040200070400000600000000020006040007000700060703000003000405040600070006000001
10742660367420803524708357203340764020508056624080307083202430805340237660206445801
10005000700000405000003000200030700080302060006080607000400000500080000000800000201
10506364707584324055225040326880807062202020506060248720447736673085605346453270301
10600000200000000080000040000050704040007000800030000050000050006000304000000080701
10644220284485873840582648633060807080835575633576583087403050305650785040663060851
10000030000000000050000000807070504080004000000050008000308040400040000040006050001
10356086785480533024733580707060403088403047703050662520243036436050652773802033701
10004080000060006000000060400080706000503000402000400050008000000040200060008070001
14207078427044506553608040852760406050407470608083608022306037232530608040567020651
10002000002030005000307000300000702070600000802000205000806000000020005050500080001
10502587802020352070223053508263805280526386504335806770704074435058885430405076601
10703000700070000030002000400000003000400000508000003050003060005030000000306000401
10487020408853725266206582256278773038604030684077455054375240407030634655405263201
10000030700030000000800000000060000030007060004000004040000000200060200000006000001
13258370658030376780303373363080402260623355505567805023636575762250708247352054641
10000080202000400000800080007080600050300000700000808000000000000000600000400050001
10774650604732803642836040875060838380405262222840406463565282674444528420606373801
10000000700000006000000040000070000000300000000000300000000000000000000000800000001
11111111111111111111111111111111111111111111111111111111111111111111111111111111111
