11111111111111111111111111111111111111111111111111111111111111111111111111111111111
10000080000000002000004000008000000000000000000000800050000000006000002000000000001
15607085466420805050248020406030836356408227575370802060605256703046806030646053601
10003050000000800040700080504060000070003000800020004000500000800030607020002000201
17874060277052578660703330406085624030784040205044477074265430602730705060306550201
10000080005000700000404020207040000030300020203000007000002000500050006040608000201
10847588805670607327806060502040445330803220874653203338302056352528787050802024701
10003000002000400000004000700020000080204060000040007000003000000030008060807070001
10305070772054728277455782606458583040808020254040458038835664252020305020208048521
10300020002000000000600000802000408080007020400070005000000000006070400020807000001
10247666785264446630407530256070305072288040506047503072803543303020502380806643601
10000000000070600000400060003080004000000040704050004000806000003000600030500000401
10267877347080203635775063805058607724877230304630356020507028867643864030422680601
10500000002080808000008030306000400000000020600050007060302080000040003030000030501
10504062407070507080608040202280245862324060685070805820774050556082504082785520801
10802000604000200080700070400040000000400060800020800050400050003000800040000030301
10404460507865652654556830508068487580706750508280732050502876405070836480828060401
10600060403000600000000040708050000040705000300050300080800050808070000000600040701
10688040207020508048726070607060808060786085727086503060624050706366404272504040301
10006030800030005000008020606000503000200080800050003030200050200000402000607060301
10302030373483458623204070402287443085203720306670244070204730308270577060505870601
10203050004000000040007000400000004000200050600020007040400000800030000040500000801
10407046208077602680207828664734504520304080604086602030474355483888572360853868401
10704000404000208000400000000020003000805000306000007040000000000000300000700000401
10804860203230486060265784254060333857826348705640422072734830503327304027504650701
10600020600070000030000000006020000000007000600030800070000060500070007080007000501
10472020605030737640528283303045248520304840803037402373636020552080203730405447201
10003000202040000050000020005000000080300050506000800000200020002040604000705000001
10802486835080862066425040307627878025547020507260288750608672406080836080508067251
10705000000060200030000060600000006000003000300030002070600020006050005020202000801
10405066203470505824637830537775305237307025655052308020877060772053603026206520501
10406000600040500000700000300000800080005000002000200070000060200030005000505000401
14403760524070332320706524808230405080225446728875582372766050532360866570806055601
10006000700020008000508000008000408060000000004000000000006050400080000000803000001
10743040706425703030603872283060808064343538505067866237603850504046647334876882601
10800040700000205060400000000040407000000040003000200000400040002000000000000000501
15402044287075704080308277263383203628862050305822303020475040565546563233837850331
10002040003040006040300000002000200000008080204000303040500020000000000000000030001
10684250806050587060485580665020756862642030257080404060304020286576283785535047801
10000030606050008020600060800020000000800050002030008060204020000000004000007080001
10432066507326804024508070406866488070208427702067545560303045504323572040233060421
10007060007000807030005040403000006070208000002000004000604000700020003070400060001
10708030585060304050808027204020503040752057587785704033805480334640606058805524301
10803030807030803000705000004060302040005000500000606000006060300000206000008000301
10207070808020702453844647337080405460502870237730304356833080808045606036554045501
10603060700020006000003000000020300040800030000000200060000030006000304000008000301
10702050306863263030408074456370705026256022878435524020334084646248707085448360401
10303000700000006060602000004040803000002040000000000030004000700060008030000080001
12607027355343355060308476207070705336807040727524643882303080602060404470702024541
10005000000000500020300000007000400040206000500000000000004080504030206000805000001
10388827488478803020646044423243872060507356308054407682462020206060672067868683201
10000000008000806020008000000060000020200060007000600000400040005060000020006000501
10474667707050607526603053665060807570508070708350725630708658234058726730603020501
10004000600030004000005000200060207000804000303000400000400000003000000000806060001
10402034802840424066776330404530777076407082307086682066672826705028458442523048781
10506000500080006000000080200040006000503000307060006000500070004000000000300060001
10607330724032808085364042626035407250506746403030805673307050363056432320804265701
10800020200020005040007020008000505000802000706070400000003080004000600000800000601
10252040272253457027303020206450203028773080732060852543776025202040702378648360701
10200030000000006000003000203080200020007020003000506000300060006040700000000050001
10704387334543806083764482805050882280203462708846205080208560646040504425857082851
10503000000000205030000000006060003000300000502000600040006000500030308000002050001
10408060602260505520574345525025704070876850405640507325672054406060305025286084401
10500070400030300000600000000040005060003000300040806000005000802040600060005000001
10537750433720807334808776802470243030303043324030308073408730207870463750803246501
10005000700000703000008000800080800020408060006050402000700000400050000000200000501
10307882504675636026567020568330407038406040202060733240767767225048505527332760301
10300000700000000040000050000060608040003000800020000060000020007000702000000080301
10328420756784622720377887453060704080637553865583882075404070506740635020767060781
10000070000000000080000000404080602050005000000070008000707070300040000040004020001
10738073238520264068864240506040808042806024606070438640852057283080833235606043301
10007030000020003000000020500070806000202000808000300050002000000060600060007070001
16608085285055807722208070756270202030405720602063404052506055775250407080748030441
10002000005080002000304000700000404080700000202000502000607000000030002080200030001
10506258803040275040447032807752704820325828502332204270405022684026378380705057801
10302000800050000060006000400000002000700000202000004070003030002030000000208000201
10864050606723344477804828523582838076406030526035278044875440503030343452708423801
10000040700080000000300000000080000050006040006000003070000000800030300000005000001
16844560537060624580604478288070504440477733207645604068685632363760508643764037461
10000060603000200000400050007080800050800000800000205000000000000000200000500080001
10442580706475404645232020865040772740304622462620408334554525547436446660408737701
10000000400000005000000030000070000000500000000000200000000000000000000000200000001
11111111111111111111111111111111111111111111111111111111111111111111111111111111111
