11111111111111111111111111111111111111111111111111111111111111111111111111111111111
10000030000000003000005000003000000000000000000000300030000000002000008000000000001
13803058728460806070425050505060782843402227462280308080305587608034302040672066301
10005020000000700070700020205030000080006000700080005000500000300050508040005000201
18325040366045367630602450604063426080275020506037267052654680705740407030205460601
10000020002000800000704080806060000040400080404000005000005000600070004050802000301
10875282706870405387202020507020888280805630453468804852508048858743762080206074301
10007000007000800000007000600040000040202030000030007000006000000080007040502050001
10505020587085437873356373407732344040305050863070258045465643647040204070207058681
10400080005000000000300000705000205040004080400060003000000000003020500020606000001
10466233672867746450803580664070806068582030207034602085504725508080707360403255501
10000000000070500000800080007040008000000060203050005000406000002000800080600000501
10522746642070205858854086307023503282468270205330732060806062222852483050733540501
10600000007080806000006080303000400000000060700040008060205050000050004060000030201
10802032307070707050606050704750283744673080783040705250425080563087307023463480801
10407000404000300070400050700070000000300020700020200070800060005000400030000020301
10403680605434747377466350307074778650505840403660875050506458405060866250245030201
10800080302000200000000040606020000050307000800040200040200080602060000000500040701
10553080207080506053532040706030403060667027322025608060328040408884704763305030401
10002060600050004000002080604000402000500040700020007040400040700000203000306080301
10805070525468655373704070705268322085507680202540867070303650402540862040802380301
10802070004000000050004000400000007000500040400050007080400000300060000020400000201
10706024404042802880804342324763602780802060705038406080723438785738554650482577401
10302000706000704000600000000020003000402000505000002020000000000000600000700000501
10802570405770867020325855833080573867322875804730488024458640707733603062403830301
10400050700030000020000000004080000000003000200020500040000030800050003060004000601
10852070202030347620785484406086586670304820308028202484858050624080703650404845401
10008000203020000080000060008000000030300050603000600000700030008050702000203000001
10402257528050884057355050404273258075255070704370433630706628202080354050803038621
10508000000080200070000050200000005000005000200060005050300060003020003070606000401
10408028804330805438485450874678707638803032338085507030845050642065204032705430601
10602000500040700000600000500000500030002000004000400080000080800080008000607000201
13305240833050222260807357604680506080737833558557232467558020232750575560304027501
10006000700030004000807000007000408040000000002000000000002070700040000000202000001
10763040404477203060206776268040206076533336205067745747707880602028475667467567701
10400080300000302030200000000030602000000020002000200000500050008000000000000000701
16803075445054402070802736867872505275647040503388604050384040872865338635382540581
10003030004030008020200000008000600000007070807000804060800030000000000000000070001
10454480808020732070782580234060756545244040836030706070305030227537334222244024801
10000070708020006030600070700040000000400080005080002080808060000000006000004020001
10658067208335608087504060404666473050807377408074782830506066306583366020288080751
10007070006000607030007080403000004030605000003000007000708000800050005040300070001
10203020522060605060705086406020302020878055225555503077407220883340406085503853601
10606070602020505000404000007040505030005000500000705000005080300000805000007000801
10408050608030605333474227323040305460303320277770403446524060202076808036825085201
10402070700070005000007000000050500020500080000000500050000080005000706000007000801
10205050402788668080303057284620404052332064688857453020486028725877404026446440401
10705000800000007080806000006040704000007020000000000070002000700020008050000030001
12308068828652244080403788703020308362404080687266332432807050602080307440706067871
10008000000000400070700000006000800070408000400000000000002060706080702000804000001
10437577566357707060427084246725787040404246804068404782877080502020243032268224701
10000000006000805020006000000050000060400050004000800000700080002040000060002000701
10277866802040505226305026685070805760807060705520728530502585435046553760405070401
10002000600020004000003000200060303000208000608000700000400000003000000000303060001
10505024606720457062248740308560487056308045202077278045445666504084523765237077781
10607000200080006000000070500020007000708000407070003000700080002000000000700070001
10503250743057703068762068684045807760608288708060608463602030678053827640603625801
10500020600070002060004070008000502000203000607060500000007050004000200000300000601
10643060478328668068308040304570605037632040624080824644822057806080602225247250801
10700050000000007000005000404040200020005060002000204000200080008070600000000020001
10305834825764703083327263603030637830804463408857607030608450622060708387262052721
10402000000000404080000000006070008000800000808000700070006000300040603000004040001
10404050807520205220772886446084507060623450602740708483864032208070703068223087501
10500060200020600000500000000060005070003000200070506000007000608030200080002000001
10644780322680604462705776308760477020203035344030508064305520707230373280405654801
10004000700000706000005000300070600080707060004060806000500000700080000000800000401
10704827204477277053388070838640403042603060804030672380775577873065302436346260701
10200000800000000060000060000050808050005000400070000020000030008000805000000060601
10863780775277435770854545278070402080233342657355437072605030303440685040362070381
10000020000000000040000000304050606070007000000080002000605020200020000020005050001
10444047825470786023345320208030603028806023705060856680788032356060273243604022701
10008020000080003000000060200030806000605000608000200080003000000040800050007030001
13503038772085506748703020383840607060604870507024405075605057585530206060823030351
10004000002020006000304000500000208030300000408000404000208000000020005050500050001
10403288506050766060768055607632607440247276604528804360405064324048624430307074601
10405000400050000080008000200000005000400000705000003070002030007040000000404000801
10748070704853286785507476432554528047804060326033378076343630304030354768605866601
10000050200040000000800000000020000050006040008000006030000000600080500000006000001
17333550378080777520408866832030804870578333704283508074843638674760503283747068541
10000060707000700000500020005060800020700000800000307000000000000000200000300030001
10427250205644602373866050353080762460704467735320306858865772464326855840805437501
10000000700000004000000070000030000000600000000000500000000000000000000000400000001
11111111111111111111111111111111111111111111111111111111111111111111111111111111111
