11111111111111111111111111111111111111111111111111111111111111111111111111111111111
10000030000000008000003000004000000000000000000000200030000000008000003000000000001
16202028566860602080842050204060387688303552572250504070308452807054602060657052601
10002070000000500080500020308020000030007000400080006000600000500040303040005000601
15455050675087774460507230402046886020382040705074382054534770504630807040307630301
10000060003000300000404040802050000040300040802000007000002000300040003080308000501
10457523402640602536707040205040877320404760722456806474403032324443285060807074401
10002000005000200000005000400080000060707080000050003000004000000060008070802050001
10306060637082674676552577307725687050502050538030524063657886335060806080506086351
10200060003000000000500000307000606060004030600060005000000000007080700030803000001
10726823773423464650205520457050507044874020308084602054706668308020704350304772301
10000000000070200000200030008070004000000040206070005000807000004000600020400000301
10253223238080706264885088705026504763247720306840838080603037458776763060432780201
10500000003030308000005020604000500000000070600060003020808040000060004030000060501
10204033205020803020303080806580453257576020686070802370843040235032503024444330501
10208000507000500020700030500050000000700020400080400030400060005000800020000070401
10508870803383327767653830806084463230403830608520263050206226604060335280423060501
10800080508000400000000070204050000050806000800080800040200050304030000000300050701
10528030708040407073572060204080308030438088436078803050364040604782705366304040401
10008060800030005000008030404000502000400050600050005020800030800000803000304060701
10604030824375577747607040503458833034806450804230478020202770604240468030305860301
10308080006000000050005000800000007000800050200070004020700000800040000040400000301
10606075403032206430603528646235805620402040302072702050645253734457436820478723401
10302000707000803000400000000020006000506000704000003070000000000000400000800000301
10606560704440725080435528765030575454386534608540423088423660302435604087402520401
10700080200020000040000000008060000000005000500060700030000040300070005080006000301
10485080308070747450484537604086574880208370502068304266856020835020506680604352601
10002000406060000080000060007000000050800050303000600000600050007080802000506000001
10306236437020235044337070802486558054344030408640264280503776803080868070308045351
10205000000070500020000050300000007000003000600050007080300060005070002060804000501
10308086606770708674728280473762405873208074487052708070628080456047308042605320601
10502000700070200000300000200000500070007000007000700050000040200060005000407000601
14505730782070427470202877808640608020282758576886666764843080265480864520507038701
10006000800030007000308000007000608070000000003000000000003040300070000000807000001
10544050702866608080804558342050604025768586403042455743803840207067364676887277501
10700040300000303020700000000030703000000030003000700000200020008000000000000000401
16206078585025806030208478578437204855643030807375407050288080432848287484726270751
10002080007060004020200000002000700000002050503000802070700030000000000000000040001
10476870705050857070768680554080532725654080273070507060206070524364377438558085401
10000030802020004060500040400040000000800020008070006070608050000000002000004040001
10235077405223804038407040803686547020707246407084774450504035306828533060678050451
10003040003000206050008050504000006060606000008000008000508000700020004030200020001
10404080446040208060408048804040608030888047364887707075504380757220505052403534201
10704030707070504000505000005040402050007000700000306000007050400000505000007000701
10506070604060608287255622272020505380608880436430408386657050803048605088322075801
10802070500030007000002000000060600080600060000000800040000020002000204000003000801
10202020308757223070602046666650505044868027286462645020862058532756607062362330701
10403000800000005030302000002040302000007080000000000070002000400020004080000020001
18204077428328274020407563306060508563506060263446284746605040802080405640506058651
10003000000000800060700000002000800060202000500000000000006040307060204000306000001
10242833846335408030252047368483463040304442302038505762843060608020836073262636301
10000000007000307020003000000030000070700020002000300000700030004070000020003000601
10825373602080703338804036283030405370507060708540753240802657588068484360507080801
10002000800070004000007000700040303000203000706000200000400000007000000000203030001
10803064602720267056363730407530833025305078806047563036867868404066847227677087681
10205000700060005000000070400080007000603000506040007000400020008000000000700070001
10506230847076702022278064523038305280503523403030302478702040538022428840702737301
10700060400020002070002060006000604000702000304050400000006070002000600000300000401
10235050267345366056402070703480308078836050454060655785846076805040604365452250501
10700050000000003000008000702070600030008040008000302000400080008080600000000060001
10402284274488806088234658204080664440707677403554307080806730556030807353533037241
10503000000000406050000000002070002000800000708000300080002000400020504000005040001
10505030705270806370662227428022803060862340402230802668677088403020705048263057401
10300030500020300000800000000060005070002000700040203000008000407050200030003000001
10548480687330608828707433404230826020205084568080502082606870704820372370206674401
10008000200000508000003000200040200060608060006030606000200000600050000000800000201
10405378502827774035637020858840802066705080803050683880634483743082703442342330701
10700000300000000070000050000020505070005000400040000020000070004000302000000020501
10478340848625247550584546363020404080552824646343528034202020405540452030377040531
10000030000000000080000000202020404080007000000070004000702070800040000040008020001
10358058765370254048268570202030502068604056706020238370446064858020546323804047301
10003080000060002000000070500050207000702000806000600060008000000040600080004030001
18705064427074304426307080584460405060407360605046705028603044763470804080663060381
10006000005060005000805000600000304050400000603000406000502000000060004050400030001
10502675603050455080652036704866606550332782408553707660402057563028663250203023801
10602000400050000080007000200000004000400000405000002080003070008030000000807000601
10655040503457478554503383885282256048605050767067767054642420605040842588604484301
10000040400040000000700000000070000020008020005000006050000000300020800000007000001
16762270428060558670407783874050808340352765508478706066738285827250206222734045541
10000080503000600000200070004080400080500000300000505000000000000000500000400020001
10873520605788608858357040366040538620703385484270806382287428864642287730306842701
10000000600000008000000060000030000000700000000000700000000000000000000000800000001
11111111111111111111111111111111111111111111111111111111111111111111111111111111111
