11111111111111111111111111111111111111111111111111111111111111111111111111111111111
10000030000000006000007000007000000000000000000000700080000000007000004000000000001
15605076266820504070442070307080466386402472778480606080207467808063404060778073401
10003040000000700060400050806080000020002000400060007000600000300060307050002000201
15586030442055386870506360705034725070565060706026437056844580402440706050203730401
10000070008000300000602030308070000030200080204000003000004000700030003070806000401
10256643306620804546206030206080532520405450235422408222705077778647388070604068601
10004000007000300000006000400030000030704020000060005000003000000050005080608040001
10202030486023473232228574306668623020707030238050887086623883582020604080402064831
10400070007000000000600000807000606080003030400030003000000000002060800060303000001
10655653356636833780505740853060707074466080505022802055308358403040804280804473401
10000000000040500000600040006030003000000050502080005000706000005000400060800000301
10355254525060604753583033406062403544686540405630422020503062237284257040682240701
10600000008030205000003030208000400000000080400070005060706070000040005040000030401
10806034404040307070508040704670888785386060643020704750388050767068207035632470701
10406000608000500030300050400020000000300080700020400020400080008000600060000050201
10604240407362238535268440404087722230304460308430578020703535204070864470637080601
10700050506000500000000050707070000020807000200040600070600030408070000000700030601
10264080604080403035778020204060503020864036336083406040328050304235204352206080801
10003040600080008000006030407000606000800080700030008040600040700000808000604040401
10302050255645727828705080502328445047603620402820355030308530508620532030304330501
10603080002000000050008000700000007000200080500050004060500000600020000020400000401
10604037605044408540204557647588306470202040803085202040578678776582332820646726601
10205000205000604000800000000020008000404000805000008020000000000000300000400000401
10305780804780275020872267227030788324485454604380485062435630808425207043304520401
10500030700060000060000000004030000000007000200040700040000050200080003040005000201
10865060605060554620737886804062386640606370608062207845446030652050505780407563701
10007000708060000060000080007000000070400030503000300000400080004070604000204000001
10203872734040358036882040703347846047546080604560534250702464407080832060302034471
10702000000040500080000060700000006000003000400030006020500050003070008020503000401
10807042203230306278362760433632808257305033334026606020228040257074605028206820501
10606000300030700000200000600000400080003000007000700060000070600050003000306000201
12207830862030427530607282608460306020554425482265262377387070647520525470607055201
10005000800080003000508000005000308050000000003000000000003080200030000000408000001
10773030204238607070805553823080202053734473408063764342802250706044787756787855801
10400030200000506040600000000080807000000050006000300000600060004000000000000000701
14507044432042608080403587326654804827555060703223605060552030584652682465347470661
10006020003030007080300000003000400000004020702000505030500080000000000000000040001
10654260505030453040248580665060856264532020856030303020506040674767867347756074601
10000060804050007080800080300060000000500060008040004070404050000000007000006060001
10454073605368804025606060802856746080607224805043573270803056306444663050683080581
10008070007000705020004060805000007080202000002000002000603000400070007080300020001
10606050285030306020606063504020603060745083883626604086808720757730506063702383601
10602070807020505000205000003040605080005000200000602000008080500000305000003000301
10402080803030805668232827877060508450206480428340305438823050803086608026776054601
10306020200070006000003000000030300030300060000000400050000080007000206000003000201
10304030402543466040703058444220507065455054377262327060588076862748202042487620801
10503000500000004050402000008030707000005070000000000030003000200020008030000060001
12705063272362328070405867508080407577308040842854428342705060805080506830803035581
10007000000000600080600000006000700040803000500000000000008060805080508000805000001
10233588637635305030876066682475638050403823308077707253328050803060434022274373301
10000000006000706070003000000050000030700060002000400000700080003050000070006000201
10527743504070508783705057636020602360606020608250565840408255734027644340806060201
10006000700070006000004000200070408000805000605000700000400000006000000000208050001
10703045807270262048863530708720254058706078803058336056222842708053836327766088471
10505000700070003000000080700020007000707000205040005000600040002000000000400070001
10502270766028803052485067427078404440607684506030503836806060657067262780207628601
10700080600070006030005060007000506000707000605040400000005070004000500000200000701
10584040448432776046506060706450205056525030827080484335482032303080506622342530501
10400040000000004000007000403060400020004030002000404000300050002050800000000070001
10603423345884302047824674802060557860502468505557602020206430324070206586335048561
10804000000000303070000000002030005000800000505000700030002000600030708000002060001
10302030804630503850525574275074204060362870402470308552828082807030408075576068701
10700060500040200000700000000060004050005000600060602000002000506020300020006000001
10386270636720205367605755602340633040404032558030808064602880507760662460203268801
10007000500000307000005000400030300070306060006030706000500000700030000000500000501
10207568406828763082567020835520208084804080806020673580347743227045402556623430201
10200000400000000050000080000070407070007000700060000030000020004000602000000070301
10438650844735474840247485624070207060234833744882335053803070802570768020674070781
10000060000000000020000000302020606080008000000060004000202050300060000080002070001
10524072862380768025278760308070205037606056403030347860638034825020268333406067401
10008040000050002000000040400080708000705000408000600070002000000040400040005080001
14702082567044303826806080573240605060202530503045802086408044474250806060627060321
10006000002050007000703000500000805040600000203000807000602000000070005050300070001
10708368203060454020843058205585803630752253203478405560202062355036754350207035601
10606000800020000070007000300000002000800000408000004070003070005070000000304000501
10636050405623655248207744247665883034508030486032525077465560405020238638504674501
10000040300020000000400000000070000080004070002000007070000000800060700000005000001
16848880246040525580508766825060305880334282206826408057637433453320305663587023661
10000070502000700000400060002030600040500000200000605000000000000000400000400070001
10667530606456408527838040254080337430203583856850606753822686624756734520704362601
10000000300000007000000040000030000000700000000000700000000000000000000000200000001
11111111111111111111111111111111111111111111111111111111111111111111111111111111111
