11111111111111111111111111111111111111111111111111111111111111111111111111111111111
10000000005000000000000000005000000000400000000000000000000000008000000000000070001
12607058602035388877208280823054204030407077467022737675822737503020328770387050701
10508030005000000000200050000030008040606000008000800000000000602070300050004040301
10808770377674383530504040544470664470207338602040406076435680407020203043305340701
10400040000000000000303050004000200000800080006050005060005040700070402000400040401
10636030807633672275844020307063703222325450445030287340504020747447204070502080301
10200050805000000000500040207000402000002000300030200000600030800000807040504000201
10504220523083255650302060604730246030306073706542302025778080707770804660806388501
10600060006080000000606040508050000080500030800000002050006060404000806000500000601
10552030503020754452304030504053553520237380806048647084806040707084608073662660401
10000080600030008000002040200080008000800000804000007000007030308000008040004000401
10425830204875878070568050642638206087406476604042202657305040404067745070705860301
10002000400000300070300020000000005000605000506000200000205080003000006000500050601
12805044334566806482707026428484534030506480206330853240304074745220605732283060501
10004020000000306050007000300000004060002000700070000050607000000060500000700050301
10267070436860604050707430205274305838208085204027506020582874745082386840607458301
10300020800020704000403050800020003000607000707000604060200000400050006000200080001
10406080403050704085408040383080234080537220836820508040207570807040606044682030781
10304080802030004000700020006060004020000050005000505080500070805070200060006080001
10507050602075575334602342207050605227348074602022408080823050804020337370508083501
10402020007080005000603000600060300000006060800080007080805020005030000000407000201
10503282484070408080402070767080755362708060504630267030607062378325246033378270601
10400000002000603020800060002050002000202080200050600050004000000050006050003030701
10768724473456202050834370402735602080602040244050303622637645822040205640707070601
10000000300000004080200050300050004040600020002050200020000050000060605000207040501
18238020306446265060205060722020466030365545207070505040822070608220504042403060501
10002030400000003050007040606070000020000000602030504020300080300070707000807000801
13705450707275608050845060405070633064628540407020706080408320386520208780508470601
10007000404000800040004080607030008000000050005040308000602000700060600050400040501
10308078758040444645704030307050706734822523325450487473503048403020402050748025201
10706000000040004000005030005020507000300000000000500060004040007000806080004000001
10308585257262505065665080684026702040807022742288303050348060853455828060207068821
10700000200060003060000070200020003070007000008000207000308080007000002080507000001
10258363807050224030806630405320434053238862602020704388206037508074505057304056601
10300070007000200020800040804070700020000000308030200000005000206000806000006000501
10205030704426306260406250805050803586582670662050303285727050303380708743832030501
10002000207000004000407000407000305000000080000020800040006020208000800040003050301
10423056702057552038786037807278508030355047765640828050506070502050252074505080201
10005000803000400060007020006000700050004050000000200040604070405050005000707020801
15204642805030407287205030885060335333402050404457707367308070302020708770204260801
10008000302040700000204060000020800000607000700000400000005060700020803000700070501
10648020808070864770308034275850727760637452866870444035604030234677403070603080601
10700030006030000030002000000070200070700050000080004000402020304000302070803000201
10707773388020385026488280887040303070405070366020502580646060705070436050428633301
10700000600070002000000040400020006000506050600020600080600020005060000030006060001
10603370302822603587543040503838863272288070504728476038708053426076304737206060351
10204000606020007000006020200000005000005020800000000080002000006000200000300040001
10352030208070208070848050737874406067702088602435334360402522478640607780804852801
10800040204000307080300040002000702050002000605000000000506000004000702000506000201
10605428608488744080807780404060404020852440555055848435862062406036224038403040401
10700000400050000060700070500020700070300000200060000040004000600070007040602070001
10548850424050802024427080233040503840207082705070263080508050606370703050203030251
10000060005000208060000050007070606070007060006080006000808080200060600040002050001
14624088303365505050228567606840707057583860806026507487502880555020826288466057401
10008030008000003060004000507000400030002000404000700000805000800040200000007070501
10406070575538568033402580807025333230507022444644708530506020208740407667405080401
10207040400000004000200000302000000060608000300000500060400040200050705000303020801
10644040774455308580203683208235508060306050708870846240864253336070304064605040501
10007070008000004030600000400000806000605080500020000000800000007040005050003030001
10303023204022245040362847533370635472203080278035855634436272807063482020578036401
10206000806040000070000000000080000060007050008050000000000000405000000080004000801
10206430604040707785375426878080364070265554566070387522562280505242835853806240231
10800050500020200000000000800040200080000000200080300000006000300000000000300080001
10246060537550455840643620205658602053454730507370508338207052377374704530733024701
10005000600080000080000020500000202030000020600000505000705060000000600080000050001
10203728606080554073634050727080508050306050585076406020206028804570705088244680251
10306000005060004000004020005030205050608040004050006050205000300040804000000040001
10802082668037266053803255808850608840237048503720423064404070387850802224757054201
10600030600020005000605000802000400000200030204000500070002050000030500020005040701
10476750405850607855808040354030385638707230405060407470426030567020707030455080201
10500000300000700060007070000080002000008000200080200020504020008070802000500080501
14203072642476673030225080883820328077222080826550606060406060487050702835207450401
10002000000080008020400060000080300040000050700000808000500030300070403000800000601
10402654333043506030502077663070504270503470503555652626578040602880408070803658301
10800000005000007080805000700050800000805000600050000000008030800000302070500030701
10676548688044383040303327707824656457303084347460607882207050546866257060682040201
10000000005000400040002000002000700080005040007000403000003050200040700030007000801
10333665208585502055452042428870304060275080507074505073382020804020708752306855501
10004000500040008060002000000030707080500080604000503000500040006000600070006000801
10808070774040404030504532785040604770208360308860763580764665782223277030276050601
10200030006000406000600000004000600000600000300070000050000000000000000040000020001
11111111111111111111111111111111111111111111111111111111111111111111111111111111111
