11111111111111111111111111111111111111111111111111111111111111111111111111111111111
10000030000000002000003000006000000000000000000000300040000000002000008000000000001
14407042832350406050377050303050834522408654445320205040803685405053403060233055801
10008020000000500030800060506050000060004000700080002000500000400070407060005000501
16384060765055677880604350408078542030824080803075334056263250308550402060808640401
10000050005000300000407080405060000020400080706000008000005000400060005070503000601
10358437804440807642508050202030544380503420734345204257802058786274734050605048301
10007000007000700000008000600080000060307020000040008000008000000020005060502040001
10702040877073424462487467404635777080402040657050364068744462253030802080706046251
10800070008000000000800000308000306080002060300080002000000000002020500030604000001
10475778465334378880402480758080803052248050702026805074407747505020507550805453401
10000000000040800000300060004070005000000080202040006000406000008000400040600000601
10632258332040407484527062707067302662583440504860486070306066485554688060648720501
10500000007030804000008060807000500000000080500050004060206030000060006030000080301
10703026307070306060707060408730428287753040465030402640757080832044507034538840601
10608000508000500020800030800070000000600070600080600030600040005000500040000020601
10503430303766752854272220502043263550307520302780676060503582504070668630758020301
10300080506000600000000050805040000020606000700080200050400060808050000000400080501
10332070604060308022863060408020505040258033466054407020456070407375703245404070501
10004050800060007000003060807000807000400060600050008020400030700000306000704050701
10207030374447574623608070505754458058505650306370545080202520706760537020305250301
10803070006000000070007000600000008000600040400050004080600000200050000080500000201
10605038406067405670704533886738504780202020306022504020232482567438466870568242501
10507000603000308000500000000040007000708000307000005080000000000000300000600000601
10805640405570572050443646866070748552878664204440487075452270206327808044403730801
10500040300070000030000000008080000000005000700070500080000050300080002040002000501
10663060205060486550338533805025263240303450304034402547532080587050508450806556501
10002000607020000070000040004000000060300030302000800000300080006060505000703000001
10803863226080727075748050204654343042243030505440365450205727204020526060502046621
10405000000050400040000040400000008000003000800050008070600080007070008080408000501
10208067505680606437455850878776805344303084364035304030285030267023404064504670601
10404000300030500000600000500000700070002000004000200050000080600040004000202000201
16306250687030685680406565505770603040824855478377553588546030262570527630303086201
10004000500070006000303000004000405020000000002000000000006070800060000000308000001
10777070206263808040702288534020505026764638703066834673408730806036576286427377701
10200030700000806060300000000020207000000080002000300000300040002000000000000000601
13707053774067406050303237733755306873744080207262408080564040574486255853642880671
10005050006080003080200000003000700000006080702000807080800060000000000000000020001
10844660303080563050826280375070244246544050532040204020807030676237476587247057201
10000020404060005050500080600050000000800020008020008080605080000000004000007080001
10537074408755803028204040305568432040208264707058472540803064304257538050848040861
10002040003000405040003060804000006030504000007000002000608000600030006020500060001
10405060687030803020602046302070702050345032688438706055608670224830606088804657701
10608060704020503000302000003030307070008000700000207000007080400000202000004000501
10708070205030706345847256373020705780604640865440303452524080505068404056223085501
10504040800020005000006000000060400040600050000000200030000020005000407000006000701
10402050408362465040604037335480306083368078348768554030875057464666302083265880601
10807000200000008050307000003020202000007020000000000060002000700080003070000030001
12208032765752263070407648808020308753404030767754463353308070508080807820707075851
10002000000000600040200000005000300070305000800000000000007040803080202000503000001
10372634442447802060826086352424527020703537802032602632443070506040866077665872501
10000000002000806040003000000030000060500030006000700000400030005040000040005000201
10727438507060204824807066782030706280206030807620636250406363233073384640502020601
10008000700040007000006000600060206000707000406000600000500000003000000000508030001
10407058204340687036844520706260674052804046804074737086526866408034854484875064251
10505000800050008000000020600050003000704000405050008000400050005000000000400050001
10406550343042404026332026382035502550305737508060802426407020442033683760605744301
10700060300020006030003030004000308000708000703030400000004040004000700000800000601
10783040826423642032507080604720803063874070273070632463525037406060706445523670201
10800040000000004000002000202030500080003030006000404000200040002070600000000080001
10603685486886603024226286605050457520605545504455802050505580832040503743883035841
10304000000000704020000000004030008000800000304000400030004000800060506000004020001
10606070807520707870274336372075205040675740707870805424566048703060306065345037601
10200060600060400000800000000040003050007000700080807000005000606080200040007000001
10865630242570807274705483802740462030706032348050606075403320504370368460208753701
10004000800000803000008000400020400070705040007050405000600000400040000000800000301
10808222606746548057255030266760306023508070206030656470382464367024402625732770201
10300000300000000040000040000040703060006000500030000050000020007000405000000040501
10553750775377446580373528753040208040466635756455777087308070502360375040235040361
10000020000000000020000000706040308020007000000040008000308080500060000020006050001
10582034237360354067265470503040807076802066406050547430352042376030447737204053301
10005070000080003000000020800050405000308000607000300020003000000040400020008070001
17805088648072306837804040542460404040302480602024205078706073556650204080632020841
10006000003050004000805000600000606040700000203000306000604000000050005020600030001
10308764402070786040638023603425208770565467705435205460806062545027873340506034401
10408000400020000080008000300000003000400000603000004080007040006060000000605000501
10248080408257685865705838733824553088505070682048687067472780605030883886507658801
10000040200040000000400000000020000060002080008000004060000000700040400000004000001
14354350686050745720206646848080806620338277808686702056784883643820503686668077561
10000080408000300000300050006030300060200000400000304000000000000000400000700080001
10368670405446307533687050253070376760505466768330704776353455546556773220607832601
10000000500000004000000020000040000000700000000000800000000000000000000000200000001
11111111111111111111111111111111111111111111111111111111111111111111111111111111111
