11111111111111111111111111111111111111111111111111111111111111111111111111111111111
10000020000000003000003000004000000000000000000000700060000000008000005000000000001
12806055422460402020735050504060724747408364868320502070503526207063208050258065801
10004040000000200030300080802040000070003000600020006000500000700070307030005000501
15556020446044457220202230406024546020556060606087433087554320806660405080807780201
10000040003000500000406070602060000030600040603000003000004000300080003040507000701
10385524505280807245702050805080377650602860377542503236804043656534675050708052801
10006000008000200000007000600050000070604060000030003000007000000070005040203040001
10702040567063362837466665604644652060606040522020286054758622832060708070707057451
10800030003000000000200000805000206040002060500040007000000000007040500040806000001
10458648577358724750702870564070803048785070605083705088303648503070503740407467201
10000000000040800000400030006050004000000070506070004000808000006000800040200000401
10382324533080204234842068607054206222282340604640447080804048342825563070647360701
10500000003070703000003070308000500000000040700050008080307020000020007020000080701
10803055203050303080608040804470886244733060548020607440662050758045704065536540501
10204000504000600040800050500020000000400080600030600030400040005000500040000030301
10508230608763238626353850806048258480306350808520866050608384204020738420674070201
10200080403000600000000040504080000060504000400030400070400040804080000000500070601
10763060508030506062336020407080207050673076433027204050467040403684704866502030501
10005040500030006000005080508000406000800080400040007060700050400000507000208070701
10405060772878484343402050202265342023405380608650543020505520203240646050203250201
10808030003000000050003000300000007000200050500030006040400000800030000040400000201
10303037406035606730303237228823204430404030308076507020422447233372443620872763201
10705000303000703000300000000060004000405000206000004030000000000000200000400000801
10303380702320526050774363868080662858343846208340834055482820805665607062708320601
10300080600030000080000000004020000000006000600030200080000020500020005060008000301
10746070606060277350338473404032586270706660403047604434375030622050503260407576501
10008000308050000080000080002000000070300080207000600000300030002070706000402000001
10504342888080276064676030207224876055273070804660675440308756403040776050606056551
10408000000060500050000020600000002000008000400070007080700080004070007050802000301
10204052306740504747845250365887604228702055642047706050487070636027604025708750201
10602000600030400000400000300000500050006000003000700080000050300030006000403000201
16408680866050434880606364208780504050574887247426382338343030485850276430408024201
10002000500070005000202000006000208050000000004000000000008020200050000000506000001
10483040406342704060708688282030304074645363606033775524408680608056544574454587701
10400050300000703070700000000040206000000060004000800000300080006000000000000000601
16502087252075505050305533748647307575364050707532306070236070466233266628864780821
10008020008060004060600000004000200000005030407000603020300050000000000000000030001
10833420602080743040788220875050455475328080285060802080708040335438786857886064601
10000050403040004070200030500070000000700030003030007040205020000000006000007070001
10287042202728408047204030706465768020803725607045532830208048407324844040726080341
10003030004000807030005060807000004080707000004000003000406000800050005050500020001
10307040277020206030207026304050504030562025268587302032607570787320305085705262201
10707080404020207000807000008080207040007000400000604000008070700000705000004000501
10603020605060605627282347562030803350606680386360607433844050807076306088675082701
10808060200020002000004000000040400060400020000000200040000030006000207000003000701
10703070706735478050604072553640205028883035743467874080433064428837607023253550801
10803000700000002050705000008030708000008040000000000030005000600050003020000070001
12806082883875388040508882803070604634707030764734658667706030208020604830603048731
10006000000000600050500000005000200030305000200000000000008040302080807000706000001
10752575828467802030856057753626824080606785506056304566758060406020867076464287801
10000000005000502080003000000030000060300080005000600000500020005050000060004000601
10564776206070505287602048667080802680305050503880433420308455746042267750403050401
10003000500040004000006000300050402000202000506000500000500000003000000000404060001
10604073208630256072223770702340366046506042308053442062442433505045253862733082671
10307000300070008000000060600080004000805000203030006000800060003000000000500080001
10304620364074806057878036557084408380202566504040608674203080556062225240506486301
10500050200040003060004040008000802000603000606050700000006040008000500000700000501
10775060862637524048404020405620304026287060662050463582752074504070305523753640801
10400030000000003000008000608080600060005030004000808000200050006040500000000070001
10402442382526204082647256207050838520302372505555507050405460274050504825485078221
10506000000000804030000000008080008000800000408000300020008000700020502000005020001
10602030206750303220525775773088404020442230504580207326353033407030507043272048701
10200050600040800000400000000050008080006000700050702000003000202030400040004000001
10452760578370504642603445503350722050704053564080605055402730505530242370702252601
10002000300000706000007000500050500040504030003070503000700000300060000000200000801
10405366206633253043472050488440602022304060303020736650374385825075208527464480801
10400000600000000040000070000050606040007000800050000030000020005000208000000050201
10245550356875763740558282338080603070264546636747672085505020206580857040664050781
10000060000000000030000000503020606020003000000020006000807040400020000030003040001
10757037635430424024743440505030702082307023307040253630323045356040364484807067201
10005040000030004000000040200050407000404000806000200040003000000070600030005080001
12808077572045202254802080574680307050806770406055702065202026553450806070422080351
10006000002060005000607000300000602050600000305000703000708000000050006070500040001
10608742206080846030823086703263708870462252304874502670504062268024482330402042801
10707000500040000060008000800000005000500000507000008080006030006070000000607000601
10723070807244266268405643427734274085605060883086373057236540504070535682302667501
10000050700080000000800000000040000070007020004000008030000000700080500000004000001
16756260284040823720805336883050303780622247303547206072626885325220706567426086771
10000060605000600000800040006030600040600000700000305000000000000000700000600040001
10286730205347403776378020734050265450705855554740404358753552668534865880702677701
10000000200000007000000060000020000000300000000000700000000000000000000000200000001
11111111111111111111111111111111111111111111111111111111111111111111111111111111111
