11111111111111111111111111111111111111111111111111111111111111111111111111111111111
10000040000000002000002000008000000000000000000000400070000000002000006000000000001
18704057274730805040375060602030733228404875544640202070502373604065503040744072401
10002030000000200050700040508040000060003000300070006000400000600050803030005000601
12663040336053384470807270604033762050726020202063768077786270703440302050408230401
10000040004000700000808030303070000020600080707000008000002000200070006030305000601
10874342203450307674504070504080553750407440557237304566602043873326565080303073701
10005000008000500000004000200050000070504040000080006000005000000080003030502060001
10503040554058723242656557808327778060808060644060686024365258343080408070502042331
10700060004000000000800000204000208070002030200030006000000000007020200020308000001
10428685737787276520608840424050305027286080406082802064207254602070706360205673201
10000000000050800000700020008070002000000080804040006000802000003000800070200000701
10363655627020402443784033304067208527467840605830255040803062267373522050327250801
10300000004040203000008060708000400000000060600050007080502030000070004080000040301
10306056804070206050304030705370364644348060746060502660234030677087806046854380801
10702000305000200070700040600080000000200050200080700080300040004000700080000020301
10206220402425737657826260305028877870502570402580653050607665406020676450288030801
10500040402000700000000030306030000020607000200050800040700060804060000000500070501
10674040405070305086438060408040205040234044333066704050265040307376606744407030801
10005060200020003000006070502000508000300030800020005060400060800000807000807080801
10308070523432453652206080708666348023502320206420222030708530603370568060202850201
10704070003000000060005000800000005000300020200040008070400000600040000060800000501
10508033206053508540302883223326607450304050703023403030426685847632787860557648401
10404000207000708000600000000070006000703000205000006040000000000000700000700000501
10605880406840648020832256566060554734653283703430633026233220402823206073807420301
10300080400070000040000000002040000000005000300050200030000030200030005040008000401
10347050302080223570856485707057438420603320704044608465486020835030207650503254501
10005000802080000070000040002000000060400020403000600000400070002070702000205000001
10706224245080342032683020708486725022672030307780326650202526802040463040202033841
10408000000080700070000080200000002000008000700070004040300040007050003020302000501
10307043605550304634485260475288603243205063547043707050528060458082802083706530801
10704000500020800000200000200000800050004000004000200020000020800030004000204000801
17303350744060587430707268208460606080867823533854647783857080378730475280706052601
10008000300050003000703000007000604030000000003000000000004070800080000000502000001
10776050308228307030605835455040606077284585703047846227702660508037487328872722801
10500040300000505030500000000080207000000030005000600000800060006000000000000000801
15208046832063204030806282653777207882634020507643703060673030382255672346756340261
10008050007060002040800000003000400000006030203000506050700060000000000000000080001
10632420703020624030477270867050724385836020457060802070202060672545868586278036501
10000050507050006050500060800030000000200030002080002060207030000000002000003030001
10366064806684206076407060508282345050707646506024732370507054508737855020824070221
10004060006000304020008060702000003050804000006000005000308000500070005040600070001
10807080558080504020503046406080704040624048236734208028504580854480203024307452301
10704020807070704000305000005080205050006000600000605000002020300000808000003000601
10602060203020408674787387727020203520308240376860608346567060204023202082476026401
10607020600070007000003000000050600060500020000000500070000020002000305000005000201
10808030405663476040708065722320406048745057257723332060443038787764304056382350701
10807000500000005070808000004040304000003080000000000050007000600080007020000020001
16308032653557433080702586704030306755805030538463466662303040705080504330505028781
10006000000000400050500000007000700020206000200000000000003040504080504000507000001
10384338586678504030228046743478538040307834308032608248277060606070552086336453601
10000000003000206020006000000050000070300030003000500000500080008050000040002000701
10755623206080304826402084763030503540207070304640575870706583386023338750405050501
10007000200070007000005000500030705000707000805000200000800000008000000000808050001
10603043605250825086833770804630222043403027407025658033854876304078858637623075341
10403000800050004000000060700020004000504000608070006000700040005000000000800030001
10306240436028204064565066824076206370204638608080403663404030234042648440805763201
10800060200080003050005060006000302000202000505050700000002040002000500000800000501
10878080727434343088703030405440806032443020676060532744848056506060607257876880501
10700050000000008000002000408070400060007070004000306000300040003020200000000020001
10704248458772704055746544503070846750402238404424705040705560358030204343763023421
10302000000000404060000000007080002000800000408000600020005000600030805000005080001
10304030405270407730386632274052307050345360508670307725787076804080605037668084801
10400020700070400000800000000050002070004000300020503000006000208080600040007000001
10656350823240702455202827708250686050605053588060703058505470604530578870507465401
10006000600000806000006000800020800050507060002030304000600000600030000000400000701
10204583206358364083634050782750704028504020807060227870273643662087304638624580201
10500000500000000080000020000050407040005000500050000040000080006000502000000040201
10268330576284883720334623486060706030545268825458872022304030203360464050634030761
10000080000000000020000000605060408020003000000080006000206050600020000040005050001
10358024252260783072535330504070504042802038503030882670428026772020645486308058601
10008020000060006000000070300060205000505000802000500070007000000040300080005030001
15707078758024306833503060425680708060405350606068807032705082827850606070758030731
10002000004080008000804000600000604020600000607000807000304000000060002060600030001
10505682703020253030264082807356307220278623302538206740802025573033263680303087201
10205000300020000040003000700000004000700000404000007040005080008050000000704000401
10536070407782478662607266283353237084407070238065633046685880307080752237606786401
10000020700080000000600000000070000070007040003000005020000000600050400000007000001
17352880273080436220608742365050406380585883606363404042624687834580804658636047771
10000030604000500000800050006070300080500000600000302000000000000000400000300020001
10752320604835503333433020844070376470506548325570206663563847845283578720804642601
10000000300000007000000070000030000000300000000000700000000000000000000000800000001
11111111111111111111111111111111111111111111111111111111111111111111111111111111111
