11111111111111111111111111111111111111111111111111111111111111111111111111111111111
10000020000000003000003000008000000000000000000000300080000000006000005000000000001
17602035563550707070327050706020337825702473442730502050804568607046403030448088801
10005050000000200050700030302030000040008000200020006000200000600080307030004000301
13773040654083863540808320806062776050656040403035853065345470402660408040302770201
10000080004000600000207020702040000040800050602000007000006000700050008080806000501
10262572207560203746305070603030444570603520263755504467703047668537435050308044401
10004000008000600000007000800080000020208040000030003000007000000070004050208070001
10806060467037824753458325205885725080204030356080784064238676835070607080807027351
10800020004000000000800000607000307040002060800030002000000000004080300030404000001
10373343223345726720506420533050406025368080402048807028508543502020405620502286701
10000000000040500000500050004050005000000060508030008000403000007000700040400000601
10584265882050507248436023407066506652567350506430726020708055737342885040243650501
10500000002020502000004080508000600000000040700050004080206050000070002080000060801
10702067207070806080506040506580454568747040762020602670624060457034303048542350801
10402000604000700040500050400040000000200070700030200040700080005000300070000080801
10802550805685746274746720707053536560408250407330788020608384508080475580688030501
10600030703000300000000040706020000060504000400050300040500030202070000000200030601
10523050702020807078326030403020502030683036643033407020358020603426402822203050501
10003040500070007000005030402000407000400030800060005030200060400000205000706050201
10206070682826826623207030302384466047204320804240523020406320404330782080406360201
10502060008000000070005000800000005000800060400040002030700000400030000040300000301
10202065307044502550502225434647802650507020405062702060272447672427868830666675501
10307000406000606000800000000080005000408000207000002040000000000000600000600000701
10602220305270286060646235554050268336475784407740362024464530408246204083702420201
10600070300050000030000000006030000000007000300020300050000060600030003050003000501
10684030504030362630742825505086634760607740404073403266335050742080604870202527201
10007000708040000070000060007000000080400040702000500000200030003020508000506000001
10707484583020284048722050308654233034348080807770236830407676203030444070608058571
10602000000080400070000020200000002000007000400080003040800080005070005040506000301
10304066606470704324755320825856802483306067522022305070362050268027304025502260601
10202000400020400000400000200000800020007000004000800080000080400080004000804000501
18502530884050728350203337507570503020764653886734627542623020672520343530206068601
10007000600030008000404000004000407070000000002000000000006040800040000000708000001
10782060707587604070404268238030404052684574404075572444406620805055573246442883501
10200060500000802050600000000080608000000060008000300000200040004000000000000000201
16402087246086307080502587638287203286726020707722205020226070484782452764548850581
10006070008060005040200000007000400000007040808000703030200060000000000000000050001
10684830803070663070535560575070785745632030678050503030807080772386734885876045601
10000020807030002060200060200060000000600030008040004080206030000000004000004020001
10872078806286407058803040808686444080606352508058524660705052204727635060737070641
10004050006000504020007050606000004060604000002000004000604000400030005050800080001
10302050663040208030806082306060504080658044763722403046202630456670303025407383301
10402080403080206000207000008040407030008000400000708000008080400000608000005000401
10206080704030403676477587323060307480207240727680805775232020208085705035228042601
10705040200060002000004000000070500070300080000000500050000070003000404000003000201
10607080203658354070806054855440406074865055667858576080528063248474502042255820601
10208000400000004060207000006030302000006030000000000060004000500050005020000020001
12408054787682358070206475202040202385206050683247428354405070608070603380804084621
10002000000000700080300000002000200020803000700000000000004080704060302000608000001
10656888657564502020824068545828276080806342308024803832354050208070343036273864201
10000000008000307080007000000030000040700030008000800000500050003080000070002000801
10374374404030508458702053262070306420303030706620423280605885322063258520303070801
10004000300020005000005000400040707000707000303000400000700000002000000000705080001
10308038602250858045767480506820646063204085502037378068263677605022577463633036861
10405000400060003000000070200080008000605000804030002000300030003000000000600080001
10506380347067706067466064446027702240405586506030203228307060542048276340607322801
10700080300060006050002020002000406000302000306080700000008040002000800000400000501
10365050245444572067208080802630808075438030565060828742235084804020807267477540201
10700060000000006000002000702060300070006070008000408000500050006050600000000080001
10703356853364706028665267208030442380703453405736302040805350586070802658533064341
10402000000000708050000000004080003000700000502000200080006000700020203000003060001
10204050704440207540343762483034704040432870407270506333282038708070508067475074201
10700080600060300000200000000060002040005000300080305000005000303040200080008000001
10236720333380604767805257307420385060703067838070303056802340504250375360302278501
10004000700000705000007000200070700040505080003050805000800000600080000000300000201
10707476307644685067653050672340205084508070607070466450524456738076407444553470701
10300000300000000060000020000020404070006000300080000020000050006000208000000060401
10456240222535253770634888783040407030537228566746284062804030808640437020763060571
10000070000000000070000000503040807070003000000020007000302030200060000050002020001
10682032657830622047768550605030502077302038502050438350757083572040447256603067301
10007080000070006000000040800080705000605000405000300060004000000030300020003040001
12506062532067707263202020322640706040703820705065604028804073248530705050252040771
10007000002020004000407000800000604070200000608000704000403000000070006020700040001
10806673302080454030627024503885303670843654408577304730705063543042333380403063501
10405000800070000050002000800000006000400000504000005040003040007060000000704000501
10686040206743463664302376435837723084506030552072254072242750602040623875405753501
10000080600080000000700000000080000040002040008000003040000000200070700000007000001
12335470333040627780308738265020305570626238802878404087646873843780703633447043741
10000050407000300000400040003040800050200000400000302000000000000000200000300070001
10546520407725205668875080886020422630407562845340507225783656562746225430806385401
10000000600000005000000080000070000000800000000000200000000000000000000000200000001
11111111111111111111111111111111111111111111111111111111111111111111111111111111111
