11111111111111111111111111111111111111111111111111111111111111111111111111111111111
10000060000000004000003000007000000000000000000000700030000000002000004000000000001
13605024554620402070554050308040778336305352558330806050506536207072608030287022601
10006030000000300020200040207060000060007000700040002000800000800050804060005000401
16583030874086476450203520305045237020246020803033687024252880307660404020606250201
10000020005000400000405040702080000020200050503000006000004000400030004060302000701
10855454703230207644405020305050445280403320482648508865304026376634744070207024301
10006000005000300000003000400060000030807040000080002000003000000080007070303050001
10806040744073626584866524405626223030506050225030837082328887278050404070504053561
10800050002000000000700000602000503070003030300070004000000000008030300060406000001
10357656555527568360406580684030804065665050508048306063202333207040307520507268501
10000000000070300000800060003080008000000070707060008000404000007000800080200000701
10543462324030706227264022505055805286884220603620575020507043632822856050278760201
10400000002050205000005080806000700000000070600050003030404060000080002050000070201
10403054205020305020703070407570356246764060448060706520285050368074208023274840601
10306000508000400070800030300060000000400040600060600060200020004000500030000050301
10705730706265753443333650806045624420502470207540638080606478708070754420344080701
10700050708000300000000060708020000020203000300030400020600080805020000000500070301
10876060303060606052638070608040205070463026688038403080646080505335505245204080701
10006070600050004000004030202000304000800020200020006080600020500000406000204060301
10606070553583834522408080303752348024703330406240682070206820805880252060705470801
10703080007000000080002000200000002000400070500020005020500000500020000060300000301
10303088405068507570402758878352508740405050502072407080367523473724682520655528501
10402000807000603000400000000050004000605000705000002080000000000000700000400000301
10502680503860223070423464342030328277258737607640228025835550406442508067208660501
10200020700080000070000000006080000000005000800080300080000070700030003040003000601
10532060208040265570482726207056524420407620803062403264233030766020608770408582501
10008000302080000080000080003000000050200050607000400000500050008060705000605000001
10604682365060456072224030206855275025445050507460842730502862804080262080303087581
10404000000040300060000020400000007000006000700040006040500070004080006030204000201
10702022406560804857785880464676208625206057858075503060573060646023503056604230601
10704000800070300000200000300000200030005000003000200020000050700040002000504000401
13405820437040447650505872606530408060424628653726737828726040582660436670806076501
10008000500030008000503000002000605080000000002000000000003060400040000000404000001
10757080606577408020508748625030602063752434202023834283302830806052257233876447301
10500020800000507050300000000020404000000050006000300000600070002000000000000000701
16808058255077804030604635455374203684428070508362704030387050244348425627578850621
10006040008030008030500000002000400000002040304000606020500050000000000000000020001
10826750502030342070777760447030242674762020462070606030802080446345587482454062201
10000020306020002050700050200060000000300070005080007080405060000000003000008060001
10758045308886805082406050302478384060803553704065584840802042708357538030655080651
10006030003000405040008050605000003060304000006000003000304000700030007030700040001
10405030372070802060402027205070706080224027662436704054606880537650403062405655301
10205070308040204000602000006080708030007000600000205000004020800000707000008000801
10802070508040207253578247546070207760808370477350806745834070305083605068447075701
10707030300040005000002000000030400050200040000000500060000020007000806000003000701
10308070203767883040206043437470202082558047284236858080735088475424405075427340801
10407000700000002020802000007060206000003050000000000070002000600040004050000020001
16308062825676324050708282603040805577702070724528332777302020208060202750504054541
10005000000000400080600000006000700070708000400000000000004040802070803000808000001
10867224868457507040827023454223756040804336206083608232354020206080878046857745201
10000000003000705060004000000080000020600070008000800000300070004080000050006000401
10626283403040604453506044452020603580408070504640566440308755838056768480405020801
10007000300080008000003000300040702000607000308000700000400000005000000000707060001
10505047307840364025228430506740588073203063206043627035343524803047675343246052231
10406000400050005000000030200050003000407000407040005000200050004000000000200020001
10408440868082602048723032888036304570608543708040804227506050247046625450408536401
10600080200060003080005020006000608000708000205020800000007060003000700000600000601
10224040377376846076804030208620807062547020587040782786688023207070603753583220701
10500050000000008000002000705040600070003020006000304000800030004030600000000020001
10303777734625405042724536503070253550508844703564203020302750748030405666876064521
10805000000000205030000000005080007000300000306000600030008000300030307000005050001
10308020207660808880726235688033602030587360806630705885482038503040404028384032301
10500020600070700000800000000040006030002000200050608000002000704030800020004000001
10763240838270408868608652705230536020507028444030705052605240404730858840803828701
10005000800000307000004000700060500040405080004050206000600000700050000000700000201
10503836603867674037856050357650505056808040402050363630667654357047408566554640701
10700000300000000070000020000040804080004000800060000080000080005000306000000030301
10428750842873523340437745662060205070226884844243876026503020605350646020385050571
10000060000000000030000000205020207030003000000080002000406030800020000050008080001
10653075878820636048344460405040506044205026202030723750355054385020667833605043601
10008030000040007000000060400050206000402000706000200080002000000070800070006050001
13203058754035406775707060866420503020702550806025608073206023674850205060286070381
10005000004040006000408000700000603060400000408000705000708000000070002080400030001
10508635505060486050868022708727508670685287805778202370308077773084888480206033201
10802000400080000070004000200000005000500000306000005080003030002070000000505000401
10576060502445774377204587238233252086804040654083566057547530208080286882702752601
10000060600060000000800000000070000070002060006000008020000000700070800000004000001
15744880328060578850702787853070407560763225402554208025663888388830202785566065281
10000060206000300000200040004020400060600000200000805000000000000000700000500030001
10266420508864408864862060735020524560404584578530304747258577747542845420803843201
10000000600000002000000080000030000000800000000000800000000000000000000000700000001
11111111111111111111111111111111111111111111111111111111111111111111111111111111111
