11111111111111111111111111111111111111111111111111111111111111111111111111111111111
10000080000000008000008000003000000000000000000000600070000000005000006000000000001
12408084242640702020644040805070558257308572355480502030802784303032504060278022501
10005040000000500060200050402080000050002000400020008000300000300040803080003000501
14433080433045242240604570205082283050743050407077767074466670605540406030406580701
10000070007000400000802070807060000030200030805000005000007000600020003050204000801
10648383602830807643703030607070444650802560276256308673707048348342763070803038701
10008000006000600000003000400020000020705080000020006000002000000020002080205080001
10404060463057432743846426806644573080305050827050444076855678768040708060405044341
10500070003000000000700000506000504050005070400020007000000000007070600030604000001
10684325658227764330206750627040305034433030705084508036802353407060805560307852201
10000000000070500000700020002040002000000050203070002000506000007000500070200000801
10873343354020305658885035203062703277628580207440426070605088384523726080543520201
10500000005060702000003080602000200000000070300050003050204040000020003060000060501
10702045302070602050206020605270245686687040347070802340746080336022307047664880201
10307000608000200020600040800060000000400060500040200040400070008000200060000020501
10507270307587868782474280704086367270203540702250423050807347806070245450525030801
10800040205000400000000020503040000030807000200040400080500030507040000000400030801
10584050805070803087225070705020202060845033426042204040652060708787407873404030601
10004020600030002000004070605000307000700040200080003050200080600000706000508040301
10308030665888238388708030704842784088602320507640352040803630408770482080508480701
10706050005000000060002000800000003000300070800040007020200000200040000030300000401
10204065303044307520408223235553608780703020308025607020455745263583435760278225501
10606000704000802000300000000050002000702000304000003030000000000000500000600000501
10803660405630757070735267232050555727236756802270763073764220202788705078505530301
10500040500040000030000000002030000000003000400080500060000030300040004060003000401
10288060507080465270287828306086627360802570707072703874636070684070604670302686801
10007000707080000040000080008000000020700030703000500000700060006080605000502000001
10502836287020534033634030306422223087257020504320683230605375702050463060306083381
10405000000020300050000050800000002000005000700070007040700050005030008080604000601
10706088503460208527338780837324308528202078462067307050778040572055605083707830701
10303000400060800000800000200000300070008000005000500050000080300080004000502000501
12503430226030664860304775404870404020864788768853448655373030265420335450304064501
10005000700040008000703000005000608030000000003000000000008080700080000000807000001
10428020307685807020805335543030607022475638206055545334503530407075723854772464701
10800070400000302070300000000040308000000050006000700000300070004000000000000000701
18704073385087203070207626458266707237722020402538606040773050356623465863585850781
10008040008020003020700000005000600000005070508000502080300040000000000000000020001
10855360307040557080743420373030482328854030887050605060307060235654262823867082801
10000060806050005070700070800020000000200060007050003030408050000000004000006020001
10625033207688507062505070604657262080708764805036654720404045202466622060553070581
10006020003000804040007030302000003070703000002000004000408000200050008050400020001
10604020628040605020307047308080502070655063754563307034806570227230708023302652801
10707080505080804000602000002060204020003000400000305000005070200000605000004000601
10705070602060507354463342722070504880608780744330705736568020608065802054443085501
10205080700070004000006000000050500080600020000000600040000080007000805000004000401
10602040408344775050508055343280502055873075836245633070783082678227804077578430801
10504000600000003060804000006020705000003020000000000040004000700030005030000070001
12406067457744665030708537702020708376304050676337338568806050308040708470604048281
10008000000000300020300000007000800070308000600000000000002070404040207000303000001
10682753677765504050536023825628446020807846703083202765838050205070572042783486401
10000000004000607080008000000040000070300040006000300000800070008030000080006000801
10347776508070803423706085437080407730606080803780445620808482623035873580604020601
10008000700080006000005000500030607000703000303000700000300000003000000000304080001
10306068204450884084667230704550836057702086406065574084286453502028777624667066421
10303000400040007000000070800050008000802000806060005000400030008000000000600060001
10703740722047804027562048666066806380503484606060402383602030553067842530303723301
10300070200020005080005020006000705000607000303030600000004020008000800000400000801
10523020886862676065306070603640605064822060538030377873744048305020506838636860501
10700080000000003000004000402050800030007070005000304000400020003080700000000060001
10506866533882303052422565707030474270506228605323404050808440884080608636448088481
10808000000000702030000000005020005000600000707000300060005000600070207000006030001
10306060807330202350545322387026208040732420303420307484884062402030602052687026301
10800040300070600000700000000040007050004000300050608000002000406050200030004000001
10346820567680302876504236606740284070206053864020603036204640403830278720404234401
10006000600000806000008000800080500060207080005070802000800000400030000000500000401
10205553608285327076257020577750303067204020307050575720382843264067508238777540201
10200000200000000070000080000020302060008000200040000020000050008000207000000080601
10732830468274334530655423527080304040728634377645854078708040508330826050888040461
10000060000000000080000000704040405030005000000050003000404020500030000070002050001
10738076324750427043552750204040505022306063603050642340675055656060587653705078501
10008050000020007000000070400030203000702000206000300040004000000080200040005050001
18804038854036308328403050433880203050605760403066202083204074634730308040885040531
10005000008040006000208000400000606050400000502000704000503000000070005030200040001
10408488304080328020664063305434704650235286506367604820302062644077445640602044701
10705000400050000020008000400000007000600000605000002080007050005030000000304000701
10844020607442767878405255253376472085304030748032368034762870704080526642603475501
10000070600030000000200000000040000030006030008000006040000000600050800000008000001
17464440746020666480706738863040407740883675804646305086568683362580808235542072251
10000080707000200000300060004060500070400000800000408000000000000000600000300040001
10247750306484403376545070486030257870808238286530804378542282333736353770602888301
10000000800000007000000080000070000000800000000000600000000000000000000000500000001
11111111111111111111111111111111111111111111111111111111111111111111111111111111111
