11111111111111111111111111111111111111111111111111111111111111111111111111111111111
10000050000000004000005000003000000000000000000000800030000000004000006000000000001
12605055367240805020463050205070265763306647363750304050802842204056605080777045701
10007060000000700040600040803020000060008000600080002000700000400060602050005000201
12475060238056566450303570806046755080642030304063346072337820208520607030802680601
10000070008000200000707050405030000040700050203000002000008000500070004020605000501
10868343803370608242608030808060854340502880837868405635502043578524352030805062501
10006000008000200000006000600060000050804070000050003000004000000020005020506020001
10704040646033437735262444806326347080708030665060378048623456653080705020803076731
10200020003000000000300000406000206080003060500040006000000000002050300040602000001
10226433347556756340506440842060506063888020402036803023706254407080505540402258401
10000000000080600000700080002050003000000070407070003000606000008000400020300000801
10543855377040407428428023707044708428234560706250878070806062282334663070352860201
10300000006030202000004080302000500000000050500060008020505080000040008050000020201
10506055206070404030502030704360343388243030748070308520357050755076602074837420801
10605000403000700080800060600050000000500040400030300050500040002000800040000060601
10808450708632522783528370403083227830404230508230458020506265703060273240353050501
10300070302000400000000050603060000030604000600030300080300030508020000000700040301
10488020307050307038372070504030502030725058444068604040876030205736202856606030801
10007030700030002000008040802000404000400040600070006020300030700000408000302080501
10203030852335683233502030305783446038408520305720386030508440602660228080304660401
10503060002000000040006000300000002000500030700060004080800000400050000040400000801
10303027305085603470407644276287806750605050202037605050752628442424554780545366301
10205000706000602000700000000060007000605000202000004040000000000000300000600000301
10706240307470456080277736724060588752887636302560584033732750407734303028606470601
10700020500070000040000000005020000000005000200030200040000030600040006050005000601
10687020207060558550546343305038764440806560206076608673235020286040402570802576301
10005000802060000060000080006000000060400080208000400000500040006030805000806000001
10706578385050342073444080402432385034738020503240426640707557208040287020504067621
10207000000080600060000040700000003000006000500040007030300040004040004070604000801
10303037604520202435825860446344405423206035382034506050488040323026608048803850601
10405000400080800000400000600000400070005000005000700050000020700020003000307000501
13602480685080563620304325406720406040778264278378342742354020734360265750806066401
10002000600060003000503000006000207060000000008000000000002070700070000000304000001
10354060708258506070708532263060805074534528607065767344603840502075682363622253601
10500020300000406080200000000080803000000050007000400000600030002000000000000000801
15506068652066302020203538385587207632323080807477402080463080464352784445837370281
10005080007020002080400000003000800000007040204000205040500060000000000000000080001
10434760503020874030246570243070528463468050537060402060302080647887558758557046601
10000030606070004030600070800040000000200070005050003060707040000000006000006050001
10256082402857207083505030404367628070205465207028866570202034802464885060765060461
10004030004000803020002050508000008020504000006000008000406000400070007040400050001
10304050575020504040703026304030202080364042847858705043405540272670403062308644201
10803050207070808000802000006040603020005000600000706000008040700000603000004000601
10607020508050808852437654546050706470404720344320506865326040306034208055542067601
10607020200030007000005000000080200020800040000000300060000040002000402000006000801
10708050402426752080806042664380603053632077682336448020867058227252202073523650601
10208000800000004040505000007020407000003050000000000060003000400060006020000080001
17408076726574626070207384703070608466406020636677233837802020303070208860603042581
10005000000000700060600000003000300030307000700000000000003040608040805000405000001
10373252734777204060448033523852747050708745402055306683454070206070264057368887701
10000000003000808070005000000060000070300080008000400000600060008040000020004000801
10247864703020606446804085463040203420603050605320733620808383832036457540706050701
10002000700020004000008000700080407000707000705000200000200000005000000000504040001
10707022502860323066345520702470468042603054705085886022425522502058227837526087641
10606000600030007000000020500060006000508000207080002000700030003000000000700060001
10206750553084403088267078546066804740203333402050203676508050327087876540508754501
10700030400050004040007050002000505000703000503050200000003020002000200000500000301
10647060682458354066608070305470405038332020486020567867672038803070407225864620301
10700070000000005000008000204040300060003030002000607000600060002040800000000070001
10402852422873707053585532604060442780604543306745303080308330868060307726287044761
10606000000000704070000000006050003000600000608000400050006000200030806000004050001
10607020704520705550466753735044402080664630502430304733628035604020604023485035501
10300070600050300000500000000030005080002000400060607000006000208020500070003000001
10844540883640702868404235502670782030204044363020408047707550304240346420408662401
10002000500000604000005000800050500020302050004020403000700000300080000000800000701
10504436705277273022672080642330708037407020206020376330538568462043307852353360701
10500000500000000050000050000050403040003000700080000080000060003000504000000040301
10862620384453333560347376257050303060653284254724648072406020406770544080265070451
10000060000000000080000000806020207070008000000060005000608040400040000050002080001
10477063327750465083754630306020805077608083202050626420365034463070378354304065501
10008070000040002000000040300020307000607000802000700030002000000080700020003030001
15407037368065503273308040265580404020707220802085504054705047452860706070262020331
10004000005080007000603000600000306070300000603000208000308000000040008070300040001
10804458406080443030353052706224303870422248608748306380405028244043554230407043701
10502000700070000060005000500000007000200000207000005070007020007030000000206000501
10734080207867287224503884828653864022605030567065336052384560607060774334302755301
10000080800030000000200000000070000030007080003000006050000000300050600000005000001
17856460684030665570703878764040307870757435305368708078426643247360408464764084821
10000020805000700000500020007060800070700000200000407000000000000000400000800020001
10766760308442507423547080277040427660603747568430402283545763843726363330403656701
10000000500000003000000030000080000000400000000000500000000000000000000000600000001
11111111111111111111111111111111111111111111111111111111111111111111111111111111111
