11111111111111111111111111111111111111111111111111111111111111111111111111111111111
10000030000000005000005000004000000000000000000000700080000000006000008000000000001
15202073855370204040345020708060366748605247725280607040605872206036207030483045601
10003060000000700060200040504070000020002000700020002000500000300050207070002000301
14765060855028658870603550703056647060327050803053424078574880306640705040708830301
10000030007000400000208030407050000080700050807000005000006000700060007020403000801
10658727406630207586807030806070355540806360847455705723808084876373274040304033701
10006000005000700000004000400060000040503050000070006000006000000080007030808030001
10204020226053342434562258406327767020208060275020455044554224822040808050702044251
10800040006000000000300000806000203080007060700030003000000000005070200060207000001
10238234877784267730603780778080306038685060603077704063306665305070405320408577801
10000000000020300000300030002060005000000030702050007000302000005000500020300000201
10732382746050702653476038806038805588428750603280866060508047435385282030336480401
10800000008080305000007080702000600000000070800060003060205060000050004050000040201
10304062804030403030505020806750444264254020728050203520775060426038804076442650201
10808000403000500050400070200060000000300050400020200040800080008000600030000070201
10707580802767886682577280608044887580208220302540575040702625304070773520785080801
10300080502000200000000080508020000020704000500060500080800070804050000000200060801
10823040307070404064246080504060607060333054582047506020775060202857605868203060601
10008080500050005000003020805000605000500050800040006070400040700000203000403030501
10605060758374436424304030407557426057308330606820726050407840504480745050302430801
10306060004000000040008000400000007000800050400030005070400000400020000080300000701
10408028602087606750207247428253807220807060405074804020574268233675883570822458701
10305000306000706000700000000080007000506000304000005040000000000000300000300000401
10606750807360543050385364647020422487766252302320778046357880407262703066206440501
10700080600060000060000000006060000000004000400070800030000040700050002060003000701
10545040808080226360758563403034436220702760608032606232537060675050703420505522201
10003000603070000040000080004000000050800070302000300000200060002030505000206000001
10502258624070455063523070706822855048337070206830262520402637205030342020402035421
10404000000040200080000080500000004000003000300060003050300040004030008080607000601
10308052508380206423672470544263403667307052658048403020475020426047607078208450701
10505000300030500000500000600000300030006000008000700030000070200020007000308000401
18602660558040652220503755502350502060288383485332235278242060763750628630205022701
10003000700080003000206000006000502020000000008000000000005040600030000000606000001
10254040706428305080306832244030802088478228708065464236405380803037262642734865701
10200020600000508070800000000020602000000080007000300000400030004000000000000000201
14204052278032507080602857525242707567226070305757604030737060688458446835634360471
10008030004050006030800000006000200000002030306000805030700030000000000000000040001
10236620704040485030655770366070682568425070644030803030506080377375488677343046801
10000060407020003040400050300060000000200060002080004060707050000000003000008020001
10524032808466703063507080502825783050603622504064378460403072302856457070753040851
10007050007000602020007080207000004040306000005000002000707000800070005080700080001
10806080377030803060502087208030306070285067737568702064402640854680302056706236801
10608060602020402000706000002060502020003000800000208000006050600000406000006000301
10504050206030805453723357868070302680502760234350405847562020306086305075525027701
10305080300060006000006000000020600050300030000000500040000020005000502000002000201
10608030505846338080808064247540302074856086782243752070472028368243702065387270301
10706000600000008050408000007070602000007040000000000060008000400080008070000030001
16803057443787658040208767506040603283506020452573263372803040603050406640807062851
10005000000000500040700000007000200080606000800000000000008040304070605000402000001
10638823653744207080637065675742735020702673508075504338287060703070466035222723601
10000000004000604040005000000030000050200080006000800000500070003050000060004000701
10454865604040307286707046345070604630605050708880363430803628334034782230602030601
10008000400080008000007000800070306000708000708000600000600000004000000000805070001
10405035605280373055663660806580582084306036404065747046246722308083476563725028651
10703000300050007000000060300050008000405000403050004000800020005000000000300070001
10208820748032806077543084352023808820304453202070202676605060425088748660408676701
10700030500080006070004060005000508000702000205030200000004060002000400000600000601
10864020386823838024303020207620405075567080788050662723844084808060408386868550601
10500030000000002000007000706060200040008060006000608000800020002040700000000040001
10804484735535405084436863608070685880806754807332802060305870272080708642584038481
10504000000000202080000000003080002000700000702000300050005000400040506000005070001
10704050208520204750385353722063404080633630406750507343584035405040206055582046801
10600030500070200000800000000030003080007000700050805000008000808030700070002000001
10325760572330506566206672707740275020308087872070606028304220602530454680204586301
10004000800000708000004000500040800030707080008040302000700000400050000000800000601
10607726808345263085587070337240608033206080507050773670363454673084203587578340201
10700000600000000060000030000050203020005000300020000050000080007000303000000080801
10855340734446784560253262272020308060626423846672453065706040806540784030862060871
10000040000000000020000000606040304070008000000030007000606070700030000030004070001
10767034467530364025427540305060706037703047806070544420774083437080256423208074301
10008040000040004000000030200050305000205000505000600060002000000020600050008040001
18605037336086308774207060324630608070304240704078508062504044674450306040268070831
10006000005030008000403000600000607030300000405000402000606000000060007040500040001
10407634703020885050474082603455707680766246706262303250705067755047674750606026301
10404000300050000030007000700000004000300000506000005040008060007040000000805000401
10734040608744326838303433356264743034603050773036443055266240702080357276508282401
10000060400080000000200000000050000020002060002000007050000000400060800000008000001
18647870427060832720705336226040804820444548503786505066842276233380503387336068231
10000020606000600000500070003020700030300000200000208000000000000000700000700060001
10547850608233802532423020773070374420708536386580507473563326675767864470603325601
10000000400000007000000080000070000000200000000000800000000000000000000000400000001
11111111111111111111111111111111111111111111111111111111111111111111111111111111111
