11111111111111111111111111111111111111111111111111111111111111111111111111111111111
10000020000000004000006000008000000000000000000000600050000000007000008000000000001
13802027738270306050265040808020523758406322426580705030208258203054403050258088301
10007080000000300060600050805040000070008000400030003000400000500020802030007000301
18238070287086358870203440408034343060373080403075743047582670804820804060808470801
10000070005000600000605040405070000080600050204000008000004000800080003060608000501
10575285305280308456706040305030255460604420763484503546204027555268548060508052401
10008000005000700000005000700020000020403050000080005000007000000040002060808030001
10505030436052366425374522302437638060507070428030764037566532874080605070403066741
10500030002000000000300000702000804040008050200040008000000000006050800080302000001
10745545826564624840208780587050707037573030806055703043502552703020203530607828701
10000000000080700000300050002050004000000040708080005000707000007000200030500000401
10278258458050202826557025303064306482247230304430728050302054744223276020725770301
10600000008040702000008020607000600000000030200070002050406070000030006020000060701
10704054503050707080604080302260736656565080886070402580867050565063706035252680401
10603000607000300030600080600040000000600030700070400030800020008000200070000030301
10707780207327455343326280602088356570704280603670747040706856604060487730863070501
10300030306000700000000080208060000080308000300060300050800050602040000000800030801
10787080602030807036634050205080802050585024623073705030452040205727205634804030501
10007030500020002000004030706000805000500020700080007020300040400000805000806080301
10802050438376844343204070507766248088803450402470258060304670508520578020805820201
10803030003000000020006000800000003000300070600060002040500000500080000080800000301
10206086705044704850607667578332408550802040202058508070676382542272444220252643501
10603000503000203000600000000030008000708000603000003020000000000000500000400000801
10803250406830285070752236252040544728332348805220285072746760306765602023506360401
10300060400050000080000000004030000000006000300050700020000050600070005060004000501
10573080508040423320457476707074247870706450206037803224325030426050302660606478601
10004000506040000030000050003000000040800040407000500000200030006030203000603000001
10308367328080328034872020403774874035767070603240575280507385807030288070303076821
10704000000060500040000060700000007000007000600080002070400060006060005070507000401
10204074303230304837682560747852303462208026623035408030644030732075306042202430601
10806000200030400000200000200000700020007000006000500080000060700040002000804000701
14502860243050572380804632303380302030634767556834554377852030687770824540607068601
10008000700070007000802000008000203040000000002000000000005070300040000000404000001
10447060605422707020307837755080303062423284608075853635505350807055758637243565501
10400060500000206030800000000020303000000030008000300000600070002000000000000000701
13802025654027306040502466746366404724647080202765205070253040732782248237582230381
10006050003050003030600000005000300000002030602000407080700080000000000000000080001
10288580708080335050368320238080724583574060667080406070406060833228774365448084501
10000080702060004050600050500020000000500020008060002040607070000000007000005070001
10582027704377707088206060807865256050604355505072573730807074802878853060448030861
10007070003000307060006050806000004060208000006000004000308000500020006080600040001
10608080252030207080608044804050306020574037468765305024803820465460407022506238501
10204070308070807000207000007040806040007000700000504000005060300000302000007000801
10605030402040308657638658252020708320603840344530302872445080402076608064783047701
10408050300070008000003000000040200040700040000000200070000050006000305000004000701
10706030404435574060402064478640504062648078433345722040232052357344205085662640401
10703000800000005060407000002050205000007050000000000040004000400060005050000070001
12305043727462488050503442704050708662403070635643742686307030808030406470307076361
10002000000000500080600000002000400050307000500000000000004060204050604000605000001
10747878647242506020783046377226375080406466503065407456365020604040526082736352801
10000000007000205030008000000080000080800080004000700000200040004080000070002000701
10676376704060707278702076464030202220704050202580752220807532722053574340706070501
10005000300070005000007000800050806000806000406000800000600000006000000000608050001
10404052207770465072422630407570643058508027406057832042353762808074837547434045531
10407000200080008000000070800040004000705000303050006000700030005000000000800040001
10706580647065602048572033357057402580804674803080408832802020826063266570403356801
10300070500060006030005060005000206000608000204050400000004040008000200000300000401
10267040752224856022504060408360406063225040245030225853425048208050307425863780801
10500060000000002000006000408070200060008030007000507000200020006070700000000030001
10304248588328408044232335508080887820804226407235406040408250335060708336254063231
10208000000000305070000000007030002000200000308000600020005000700080302000008040001
10502050603480503760345777563053302020744280503270204837646023707080707074382056801
10800080600060200000800000000080007030008000700040504000008000703040500080006000001
10223350665250808745702354508730856020602026778060308062505270603850332330504236701
10007000500000806000008000700080400070706020006030207000500000800080000000400000501
10407436502878747078262080358720402038205020708070722430668558827028404377657580301
10500000700000000020000060000020705080003000600050000030000040008000204000000020201
10264230343737737530353632837050707050376855563364855055708030702670375050346050281
10000030000000000070000000704040404020004000000030005000307040300050000040003060001
10553037252640327066583580503080402066708083404050346760224047753040724782607068701
10005050000080008000000020600040602000403000204000400020008000000020700050003070001
14205057425037605872402030566320505060305750403032308052305037644540502060828070621
10005000003050002000602000600000807070300000303000507000202000000060003080400050001
10408888606070748050683087303658306480545882502562605840802042657023382230603078701
10506000200060000070008000600000004000200000604000008070004020005050000000705000401
10836040704863277632402523566862365038202040564073885066528520703020675586708677301
10000040600050000000400000000050000060007080003000004030000000300020400000003000001
14768760522060442520306665886050508720278562406658705025286285467880205755688088551
10000040203000200000800080007080400070600000400000702000000000000000800000600050001
10568320202527607283826070222050382330308832855580203527556767468837875560303277601
10000000500000008000000060000070000000800000000000700000000000000000000000300000001
11111111111111111111111111111111111111111111111111111111111111111111111111111111111
