11111111111111111111111111111111111111111111111111111111111111111111111111111111111
10000080000000003000002000007000000000000000000000200050000000005000007000000000001
17702055224680605030578080306040747755605745888470302030807722506042805030837028301
10005060000000600020500040502070000050007000200030004000500000500030208060002000401
12823040254063228760407430308085824060223040504027548022374480508780706050202520601
10000050004000800000505050607080000040400070306000006000007000600050002060303000501
10323454704870303478408040408070732730205660877676404677502076232242877070406084801
10008000005000500000006000200050000050307080000060005000008000000080005020308030001
10407020224066544685334443602332656050605060757040544025665345366030504040307074721
10600020008000000000600000503000702050007040500050008000000000005030800070506000001
10235264656282258530606880684020304055264080508032807025502336708060404370507526801
10000000000060800000600070003030007000000050608070008000607000007000300070400000701
10452875246070208547655047505076502632352730706320236040508083323663878070838640201
10600000004060303000007060503000500000000050700030008020507070000020004030000030401
10703027505030405080806040308760628722347030758080506640574040658082507024333470201
10805000203000600050600020800030000000500060200070500060300030002000500060000020601
10708770602373863335675560705055566650504660605740543080503766808080585720757040201
10500040207000300000000070202030000020305000300050600060300070804030000000200060201
10346030505050206057787020504020305080627035257076805050568050603588506886304050701
10002050200080004000003070805000608000400060600030002030800050300000308000605060701
10402070528224756538307060207753278022803530504480278040605740704640683020706340501
10406040003000000050006000400000004000500070200060002060600000700070000080500000501
10308026403074605670503682237464207660603060405082808020683286444827755740673462201
10708000802000608000200000000080006000808000507000002020000000000000600000200000401
10205540507470363020336857854030378836755782607540443037533280503758806082203730201
10700050700040000040000000005050000000006000300070800080000050300070003050008000401
10485050408020728620285372706082822520503850404083302628328030826020504680704635301
10003000308080000020000030002000000020800060808000200000300070002040305000805000001
10302348725080883037634050603375587072866080506440473520604444405040574060304047541
10204000000030300040000040200000006000005000300030002080200040008030005070807000201
10404084605220708753223240365845705425206028243083208080766020744032307086702380701
10803000500030200000700000800000200070008000008000500060000070700040005000402000201
15708440246050386860205858406420803070746736352634656534872080587570758720508032501
10005000500070004000507000004000704060000000002000000000003020600050000000708000001
10232080505368202020304847235070403043426664503086235524504550607064664785855383401
10700060700000402020700000000080603000000020008000300000600050006000000000000000801
12607067386023603080206377236846205864558050407273607070363070822587735622678830451
10007030003050002030800000007000300000003070404000607040800080000000000000000040001
10233780607070557050755330446020773685882040654080508070606030427275643834854054701
10000050402070004060700070800040000000600030005070005080805080000000002000008080001
10873053603383305076608070604532646020206347208053783220208066205387457030226030251
10006070004000404050006020302000008020208000002000004000808000500050007080200070001
10506030462070607040306078308060705080627058755233206053404530737360703082803554301
10508030404060206000808000002040407070007000600000806000005070500000506000004000201
10207060808070502777276543883050804440605840245540508853533020206032407048634054701
10408070600050002000004000000080300040600070000000800080000040007000407000003000201
10806070503488445040608052658270502044722064863568632020232037236832403057525480701
10608000600000006050205000006050304000005060000000000040006000400040006030000050001
16804085645364627080704776203080206543604070465762885735702030808030607570203034761
10007000000000800040200000002000500020507000800000000000002020402070606000706000001
10432225428348606080787023523543228040806843205066803536748070302080626052263755501
10000000008000703030003000000030000050300070006000300000600070004080000030004000701
10882646504080207227503086428040506880504030805540233270208653587025757850204080801
10003000600070008000006000200080302000303000308000800000800000008000000000402050001
10304047803650886057682580702780665068407026706045786026822427303058667538236052361
10803000800050005000000070700030006000808000403080007000400020003000000000500020001
10304330263043306044625084237066608770403434708050302863205020628064767340706537401
10200070600070008080003060004000402000703000208020600000003020005000800000400000301
10487080288373782065507030403460407028533080657080785362456055606060203738228520801
10600070000000007000004000606030500080004080005000706000300070008060200000000020001
10206375683448503043628576808030237360603838408842203030807280258070504443332085421
10507000000000304050000000008050007000500000307000300070002000500080404000002040001
10304070702720204870867527738048603060738840606340407266557085705040408083847025801
10800050400070600000300000000030008040004000700020506000005000404030800050008000001
10542840754680208664704267502870535060207054868030404044508540305420846870807525801
10002000200000504000006000600040800020805070003050802000500000800030000000300000801
10206374606644432037372020226380206026203030504040767630872387243078703526546760601
10500000600000000020000040000060404060007000800050000040000070006000305000000050201
10628240838543263830684837488070402020228535865588447048803060407450328040658060751
10000040000000000080000000803020207050007000000080004000602060600050000020006030001
10247077832580366052874480808020502077402028204020785450464068444040746254608082301
10006060000020007000000070400070802000406000403000400060007000000080400050003080001
14707028582087608863806050252460406020607470408063804084704055865770608050848030851
10008000006070007000405000700000402060800000207000502000308000000050004080300060001
10603366207040245020527065708337706260262247304847207270507024882038324680607078201
10503000800060000080006000600000008000500000402000006070002030008050000000304000601
10262030708542774474403343286676754046702050662047448072722770805080476336404465301
10000020500050000000200000000080000030007020004000004030000000700050400000006000001
18727820545020747670508676722050703220883484703852504038788747328440606757546083651
10000020205000700000500020007080600020400000700000706000000000000000400000400030001
10485280603485602223888040277050844550804583446880205285743575363473346320707763501
10000000700000002000000020000080000000700000000000400000000000000000000000500000001
11111111111111111111111111111111111111111111111111111111111111111111111111111111111
