11111111111111111111111111111111111111111111111111111111111111111111111111111111111
10000050000000008000007000007000000000000000000000400080000000006000007000000000001
14702088642880706070238060202040326446205834322670503070407765306053508040783057701
10002070000000700040400080707030000040006000800060008000200000700070406020004000501
15723080276087225620408880303044632030528030202048837087775680605740604050505820301
10000070004000500000807050605070000070300050307000002000008000300050006060307000801
10456762404460403748407020508050336770807570884542507365205058484848235080402074401
10007000005000600000004000200080000060808040000030003000004000000060002080208030001
10208080367023637648345862804333273070207040338020244075343473643050303060403056681
10300040003000000000700000404000702020006050500060008000000000007080400080505000001
10678282787373837570406570254070207052768060802024706088705464708060408530805687801
10000000000060700000400050007070002000000030408060007000602000008000800030800000601
10635224846050704664832062705078208472485350402830872060304022532837345020264580601
10500000006060708000002070402000700000000030800080002060207040000020004060000060301
10208042606050607020802060803240734746256080743070507350262040837052404068862350601
10504000404000800070700020500050000000400080800040600070400020006000400050000020501
10302240605567653687827230303072272450204770807820425050606833708030648670648030601
10300030805000500000000020603020000020803000400040300030200080807060000000600020401
10378060505080302076388050408070802070434032726064302040848040705357803373502050401
10002040400020004000005070606000506000400070400080007030500060700000207000405030301
10805020262734582275202020607253686038606270504870532080602520606380736080407730801
10308060006000000020003000200000005000800040700080004070600000400060000080400000501
10303034602084306830205552833224808840806040807082707040562323762465576730644668301
10706000404000405000400000000070008000307000207000005080000000000000300000800000601
10602220304370727040876343455060667222844862607240872047832550705458306063603520601
10500070700080000030000000007030000000003000200070300080000020800040006020006000501
10547070607070688640883532303088745440403780506064404328783020222080604640602343801
10003000306060000020000040003000000070400040803000400000500050006070302000502000001
10808452275070276032334070505358888055867080402230632820603743308030655050307077251
10807000000030800030000050500000004000003000400070008070600020004060002070406000601
10202036507520303447477670342258805665708035468025306050358050242022705066402620501
10703000500050700000700000400000200050003000005000200030000030400030006000402000301
15507740568070368520804588303640503030448387573458445234486080348760255680602066301
10008000300030007000402000007000305060000000007000000000006030600030000000506000001
10645030206876502020506733677070402062744462205053337382506820404024328424587563301
10700080500000703060300000000080604000000020004000700000300070007000000000000000501
17708046788057403070605842822266708258626080707722702080543040784666256334884240741
10006070008030006060500000004000500000003050604000805070700070000000000000000020001
10663220303060364080845620687050447776727050552030706080302040324848686864756025401
10000050304050007040400080400020000000500040007080006020807050000000004000007040001
10555032608473207022607070703878343040803453406028332270706088403722567040278030351
10006050007000603070006030805000005020505000002000003000205000500050002020700080001
10606030267030304020602075507050208030676045886562206057306620277860403085404463601
10708080607050805000207000002040803080006000800000304000006020200000303000007000601
10308050504080704833234628478040306630307640722480705486586080203026706062635088401
10404070400040003000007000000080400020200060000000500060000080006000405000006000501
10202050707272544040405067674520303075373053775786328050385028766762802055566230601
10802000600000005030406000005040406000005030000000000040002000300040008040000030001
16308056338846446030403553406030408675202030452254768274307030403030506720608062861
10007000000000300050800000007000200040307000400000000000007070707070208000703000001
10674443656322408060567084526358223050404734502038205585847080305080625084562344301
10000000007000604040007000000040000060700070008000700000600070006020000020006000701
10573447605030208864308035676070306220304070204550468660407762365075347540304050801
10008000300080008000002000700030308000202000206000200000600000002000000000802030001
10504045504840757027465760504430476025406086405084527087234783706022588888625046781
10805000300040002000000020700080003000307000607020005000400050004000000000200030001
10605760626053703053822048346086202530303383702080305452705080244085543470506337701
10300030800040008040002030003000203000305000705060200000005020007000300000300000601
10346060834255558043803050707560806024478050887080428827567038304060703277453830801
10300060000000008000003000307020400040008020007000402000300050003060800000000020001
10207563728623607026652448502020727330704486208524208050708330557020703882788088471
10305000000000803040000000005050008000700000403000500080007000300050305000004060001
10208020604420808650762363433062308060746460604280508586578055607070606084665038801
10800050200080600000200000000060004070003000700060407000003000508060600040007000001
10483320758860308744706476306330247030208068845030306088206820607220252570305576501
10005000600000203000005000700030300070606060005020408000700000200080000000600000401
10204743505536363042328020838740705058508030702080754750573446374078504785544680301
10800000300000000070000020000030608050002000800060000040000030006000508000000040301
10553870884743285760356235637080302080278863628242374037706020406870633040445030781
10000060000000000050000000306050808070008000000060005000203080700050000060007050001
10236052372880245035256350506070505047608062405080332480345052636050573446703036801
10008070000040002000000070700080204000407000502000200080008000000050200040008070001
13405083442082805526206030737630208070303260504033805032603064427730503060886080431
10003000005020004000607000600000308030300000203000405000708000000080008050600060001
10205357804070544020533042302765503680386437807387407470507068538054367530406044801
10703000700030000080005000800000006000600000202000007040005020003070000000807000401
10356030706365636385504544887874725022708080333077227058376230403060648536704258201
10000030700030000000800000000020000080003050004000003080000000400040500000006000001
13335650558060578820508586258070302880756725402457703026878257573620203572756048731
10000080707000700000200040005080700040600000700000504000000000000000500000300050001
10874350205788503383477060754020757550206436842630202783652453453564575480305543701
10000000500000003000000070000030000000700000000000500000000000000000000000800000001
11111111111111111111111111111111111111111111111111111111111111111111111111111111111
