11111111111111111111111111111111111111111111111111111111111111111111111111111111111
10000070000000008000008000005000000000000000000000400040000000007000008000000000001
13507036478230206050575080404080753334205724656440606020308348805023303080687042201
10006060000000800070500050608070000030002000500020007000300000800060307070008000201
14745020232077752570203630404076634040382060706036768056635740807830303050807740801
10000060002000500000407050805020000050700040206000008000002000200020004060303000201
10287352204440708655207020705030838260303840676576607785303033847576285060306062201
10003000004000700000003000600030000020808020000020004000004000000040007050407080001
10802030486074737224882446708532444070207070828040783068678228733070302040208087371
10400020006000000000500000304000403020006060400020007000000000007040600080705000001
10528525886837588720307380688050706067752080806025702022407755704030708530602366501
10000000000080600000300080005030003000000030206080002000204000002000800060600000601
10366735876040404886728044805086403565555850804350332020608035555378557060447460501
10700000003030608000006070205000400000000080600020003020305030000020004020000040301
10508087206080503070207040704720537655825040828020207240466070274058807078564280701
10804000506000200020300050700040000000400050400050400030400080005000800040000040401
10806540805272854864238250705047575640203760805750828080705858602070485550467070401
10300050702000200000000020503020000020705000500040700060300070205080000000800060401
10834060408020803082275040708060505040425046438073308080344040207658304484703030601
10002080600020003000003050804000808000600060500070007050600080700000503000506020801
10202030858626324862608040703572652058506420704270876070307450402530275050604750501
10806070003000000030003000300000006000300070400060008070200000700060000050700000201
10304043808042807260402386332723305560406020208043502040824734434452643760476242201
10207000503000802000700000000040006000208000307000006040000000000000800000200000601
10607380302480646070883683536030342647447646605280285087378280404868706066805470801
10800040800080000080000000005070000000006000300030200050000020500060002050007000801
10837080703060387220888656308056824780808230408046607742786030763020506860203255801
10005000406070000080000070008000000080500050605000700000200080008060507000206000001
10506576574060525072828050508764586032462080804870488860206747807030385060305047741
10203000000080600060000080500000003000002000500050005050800050002060008030603000301
10203042207520307787485270267426306832506062675074705020545060535023808044502270501
10704000500020500000700000600000800060003000005000800080000070300080008000504000801
14505880328040473460304487605820604020647864284256625747328060523470358850702062601
10002000500050004000303000007000503050000000003000000000002080700030000000602000001
10265020502856308060704563657060804085784255806056677886602360303064882234573373401
10400070500000706060700000000030208000000040005000500000600030007000000000000000501
16705068547066504050604424425685805776574040404245307020553080788865676448448260761
10008040003070002050300000004000500000004020505000306070600080000000000000000040001
10473540408040742060732220237040282475845040583030706060804030833485237647632025801
10000040708070002070800020500070000000500030002050002040304050000000003000004030001
10348066204328208055404050306427543050708232402044723370806063408487427080867080741
10003050008000803040006080804000005030308000002000004000603000400050002080500080001
10708030766080308070705063502050502050558033386458306074406860337850607024205263801
10508040805070602000707000006020308070006000500000402000008070500000208000003000201
10205020405020207667843885736050502730806340254660506266326050402072602072247077201
10505020700040004000003000000040800020500020000000300050000040008000807000002000401
10705080702268243030405083287840207022433062226248478020545054575284807045443230601
10605000600000007080702000004040508000003040000000000080006000200050007050000060001
18806046664773367040605877608020706588205030746772283333507060402020503450302057571
10002000000000500040400000008000200070504000200000000000008040608040802000406000001
10642658268774507060666022757543834040804533503036602353583070804020688083335887501
10000000008000707040008000000030000040800020008000700000800030007080000040003000701
10478442805080805738206032856040602550804060402330746550705554462035553350603060201
10003000600050005000007000400020308000603000803000200000400000002000000000508080001
10607086305680533058778770207430466068208062708075746068556274804045858285234034881
10702000200060008000000020600080004000306000705060002000600050005000000000500080001
10204680327062508045443035838035805520507888203020606568204020388054278630506376601
10800070600060005020002070008000205000505000408080800000006070002000600000700000401
10787080326865535085204060507550803086583040823020545772226067503040603532488830801
10200020000000002000006000303040600020002060007000803000600040002080400000000020001
10407576674743408025767434203050354620404472405258304040807860757060307645748065571
10305000000000507020000000007070006000300000307000500040007000800080606000003060001
10407070506660608250445877655042808080688770806430706586726038805040703066773084201
10800020300080300000500000000070004030005000500030605000007000804050200020003000001
10888780343220804366303584404330374050806025858060503067807270505360485860506385701
10002000500000503000004000300070600050502040008070208000600000600060000000600000301
10203275705752672082475040352320603042707060507030354530446554234042608236788660701
10600000300000000080000070000070807020002000400020000050000070005000805000000080501
10562640546576854870246622558030604070478746876373887028205020305840734050372050551
10000040000000000030000000305060607030008000000020007000403030400040000030008050001
10542054878270857072232470404070808033808082203030352270522082745080427554307026501
10007050000030002000000070500040805000506000806000300030003000000060700030006070001
15206065488033502276803060378340308070302560206055702088207084623280303030557080551
10008000007040007000507000200000603060600000807000408000203000000050004030300070001
10802275806080448060357085304786707520838864208636304370603055565034542880408047701
10802000800080000060005000400000005000800000503000002050006040007020000000808000401
10785080506436636746706458787347757085305070873075446025364680606070247672606373401
10000040300050000000200000000060000060008040004000002030000000500040700000003000001
18434880564030455630602656765020202450233853507372605062875438738460508337564047721
10000040402000400000300030008040200030500000800000205000000000000000200000400030001
10376240808643302365558070876070377740602633672270305332245773684742576760803587501
10000000600000006000000070000040000000300000000000800000000000000000000000300000001
11111111111111111111111111111111111111111111111111111111111111111111111111111111111
