11111111111111111111111111111111111111111111111111111111111111111111111111111111111
10000000005000000000000000002000000000200000000000000000000000002000000000000080001
16606076702073785853604770848032806030802028256066334382333755803020822260635030401
10708080005000000000200060000040002040402000003000200000000000706060300030008040501
10305320424676466260803060577780828880302653805050502086283560403060403025305260801
10300020000000000000808030004000800000600060004060007060002030400060607000200080501
10444050403448863438742040308084603463776380488070262520204020383454502020608060701
10700080806000000000200080808000602000003000300080300000400070200000208030804000601
10706770628052447380703060405770477040607072807655802044438080605260606640306784201
10300050007020000000503060604030000070700040500000008080002040805000306000300000601
10423060803060763848802020402044824550262630203073885044203020308078604035448280701
10000030400050003000006060600080002000600000603000008000008040802000007020008000201
10587540506273422050562020744764703077405348402042706647302050804036637040806270401
10005000800000200040400030000000007000207000203000700000703070002000005000600080301
18303044734884208324508052844875377080607470506870583730203048556620606343444030401
10008070000000202030005000700000005070005000300020000020707000000060200000500040701
10328070668280608030308630807288806555202025808035308050848634844083872860707437201
10500080600070806000308030500040002000302000405000304060400000300040005000300060001
10803040208040505028808060346060728020357430572270305030407570803040808028333060421
10608060608070008000300070002050007020000050002000804070200020307020700060003060001
10506060707078763728505443305030804858587078605028507050522070208080346480406053701
10306060004020008000808000400070700000002060600080003030407060003040000000606000501
10207852876040505040603080367060745222708030507480847070404045666476688025638280601
10500000005000202070400060002060004000206020300020300060007000000060005020004030601
10363724585257208020847580707276405080807030463020307444863785777060506230506030201
10000000200000006060800050300080005030200050008030300040000020000080207000405050301
18455050205638728030205080326060848040623784405040608020782050404740708076602070801
10008060300000005020003030402060000020000000703030807060300030400040206000808000201
16804340404547307020734070202030742026544830805080705080305320558860205750305320601
10006000702000600080006080205020007000000070006070302000306000200030300020500040601
10608052523020344543802020207060807725767886724360476283204077806020305050563048501
10408000000020002000002080008040705000400000000000800020004060004000708040007000001
10408672748377605027222020583043503040305056843472806060878040335683638080707028461
10300000500050005070000070700080005030007000006000606000307060003000006080407000001
10473585806020368080402520404750632087682427403050404482504036407035402028505046301
10400070006000200020500080703060400050000000704080200000005000703000202000006000801
10702050302754808620703370805050207738236480684040407373458080708420302253538030701
10002000702000008000206000406000606000000060000030700080006020605000700040007060401
10882042404048335045575032407584808040675088848360876050208030507020778038706070801
10003000502000300030008040005000500070007070000000200020708060808030006000704050301
12302572803050207672205050634080668528602060503648403366202030608070608820702670801
10003000704050700000406080000070400000408000700000500000007040400040504000500020401
10655040408020236250406033572820786240385866832340343022803080673553504080707040401
10200070007030000020005000000060500050500030000060004000805070307000403030204000701
10602664584070437025754460234050207030604080433060405630667040207050387070528252501
10800000700030006000000070600060002000804060800050800020200070004020000070004070001
10302540207572606485227040706486337756678030602322656085705064265074202427403050731
10507000507080003000003080500000008000006070400000000020003000008000200000200030001
10287060607020805050424070753464802073202084503373543830303277678850308660505883801
10500060402000203020700070002000807040007000506000000000503000002000205000406000801
10507647202857755050804640204080406050647880672077552582575087604054237076507020601
10400000800020000030400060700070300040500000400050000050006000300050004080704070001
10252640445050608047827080623040307370402087208050774080803070705220708020605050221
10000040002000602080000030007070203080005060006050002000808040700080200020002080001
15854064803646602070753367306480707038886830704045802877608880683030285256762022801
10005070008000006020005000303000500080002000705000800000808000500070700000003080501
10604050287885388023707450208023334470204023875864307750703060303530808487307030301
10305080600000004000800000205000000060403000800000700070400070700060808000702050501
10728080424276707240703636708445804070806040407230378830642287788050605053605050601
10006030007000003030700000600000502000803070300070000000300000005050008070002080001
10405037604074244020633385236460257843605070474024582445256477402073844080375067301
10408000208080000080000000000030000050008030003040000000000000805000000070008000301
10604840206040604646285768574060877020282347287030568286277860808225533587306740531
10700070200070400000000000700070200030000000700020400000008000200000000000600070001
10824050223450542540858320804865808044822660205470808772607073423847208430538085301
10004000800030000070000080400000707080000040700000803000604040000000700030000020001
10805358407080778035457060667080704060208050884063407040602072602280702075768460851
10505000004060008000007030008070604030807080002040007020706000500050803000000080001
10303052425037826042503887807330508830626075308820782078707070886540406268657036701
10600050600080002000603000707000500000800080706000500080008040000030300040007080401
10745260802430705828703070684070253575306580605070803570234030684040203050482020801
10200000300000700050007080000080008000007000400080300080504050004020807000500070201
13205056436543382080368050724880733028586080752860808050804050744070305324508570401
10005000000030002020800030000030300020000040600000707000300060800070206000300000701
10206567343046508070406044283060402620508580506776232837854070404780704020806748301
10200000005000005020802000700050600000802000600020000000008020200000804020600030501
10576356268022376070406677505774874854406077578540508546703060654422666040532080801
10000000008000600030002000004000700030008070003000308000005080700040200080006000601
10436346705437502043858048652380802060267080206063603075325080203030808762602322401
10006000600080007030005000000050304080600080403000703000200070007000600040004000201
10408060328040703040406524488040202280703360503640867620735525576255438080838020401
10300030003000304000600000008000400000500000200060000070000000000000000020000030001
11111111111111111111111111111111111111111111111111111111111111111111111111111111111
