11111111111111111111111111111111111111111111111111111111111111111111111111111111111
10000070000000004000002000007000000000000000000000400080000000008000005000000000001
12505053534360404040322040306030583723504864266850205020704866308032206050637078501
10007020000000700050500070302040000040008000200060002000700000800070505050004000301
17542060683053644560806670502056885060754020305085358054882860604650302030307680201
10000050006000400000204020505030000050800070407000005000008000500080005030505000401
10585735203730205372808080403080767450206760445436607557204044227633754060202085501
10004000006000200000004000800020000080805070000050005000008000000020004030806080001
10702070385036552452444377708233563030607070532070332027272447557070404040302062881
10500040005000000000200000208000505050005080800040005000000000004070200080705000001
10757445354324365770305320653020402057348040604086507043406854506070802720807236301
10000000000020600000300030008070003000000050803040004000603000005000700020700000801
10866783363060408372472065503087407267848720706830745040408045734244756030262870201
10300000002080606000005040303000600000000070800060002060206080000050006070000020701
10807025608050706020506060705430772267747070266040508270888030354075308057666620301
10408000704000600070400080500040000000400030500040300070300020002000400040000080401
10602450706654434576237760807022234470505730403440354050804648306060236570423070701
10200050502000500000000060406060000050604000500060400070800060206060000000300050201
10686040803030706035652020404040308080727087277025403050772040703678406443608040401
10008060800060008000007030302000507000600030500060005080800030300000804000704060301
10305080576364287573302070405522375076205260803360743020504760503770356040605650801
10806050005000000080007000800000005000500060700050004060600000400020000030200000701
10705073504073302630805664872887606280503060304054807040558583547834883270583834201
10208000707000307000200000000020008000305000503000004060000000000000600000400000401
10302260704730424070276245674040557385742575505320645063833320707274507024507830601
10400020800070000070000000005080000000004000200030200020000080600020002060002000701
10565050203040735870744862808074483480408470706032604464258050535070807880705463501
10002000404040000080000070007000000060400020703000600000600070008050802000407000001
10306585564030476038275050808265467027687060707360388870208736206020572040408036281
10704000000070200060000080700000006000004000300030002030800040002060004030206000301
10707066504230703773765230356828402575502037766025403040554040823038402082307550701
10607000600050200000500000400000500030004000006000600030000020500060007000402000701
16506350473070647860504742402740707080774468442553543225633030657440223830308057601
10008000400040004000802000005000702030000000007000000000004080700080000000707000001
10755020206278206060604772732080807074478885708072765585702350708056738777887522201
10200070600000204080200000000050707000000030002000300000600050003000000000000000801
12305037857026408070207883665226802822465060708444608040352080558435487848447770471
10005050002080004040500000005000800000007070507000505030400020000000000000000040001
10637830504020346030888330247040544822344060875050304030306080854526466626363048701
10000020407060004070300020400060000000600070007050005080606040000000003000005050001
10386082308763203032402040604776648080407735503078675470402034807474385080285050831
10005070008000505040005030206000007030706000007000003000302000400060008020200050001
10806050372060703020208078607030403040234052633288502027803850272280304063403326201
10206020703060208000205000007060306070003000300000804000005020200000802000005000201
10206080207080502527687576778040202870807860248850802588246020805072605038644032601
10707080700040006000002000000030700030400070000000400060000040008000807000002000701
10403080407872682070208046733520804037546062673258383060245044724537204067473380401
10402000600000002030403000004080805000007040000000000020004000500060008070000050001
14605026645732223040605865702030706524307040676787722476302040302040403580306064781
10003000000000400080800000007000600060304000600000000000003050708080604000407000001
10274535456244803060645032733674725030705223707024803443527080206030456063467687601
10000000003000307030008000000050000040400080002000200000700070005060000030003000301
10533663704020605343203027662050304320502030202780854660602443334058876430503070601
10008000800050008000003000600070205000803000203000200000200000004000000000702040001
10807044403560386082257240505580776053307058507038852046674724408074266552375037321
10306000200080003000000020300050006000404000703020008000500070004000000000200050001
10708520686043606028485044555084708540208634205060803768407080365023883350203825401
10200040500070004080007070002000307000402000806080200000003050007000800000800000501
10456020356254288076508080506650607086338020464070882654456043306080307857537320301
10800080000000004000006000407040300080003020003000605000400040002060500000000040001
10806477333252405055763287502020284280602356804877406080508370252080208785588053571
10602000000000805040000000008060004000800000706000600030005000700060208000003070001
10804060208650305370866574283023502030264240306740408432468074508060303036566035301
10200050300070400000300000000020003060003000700060302000006000305070800080007000001
10866220263870806764202383702230667050807056874050308055306550303840342840404856601
10002000800000207000002000300020300020504050008080304000500000300030000000600000701
10608225506825328073545080422640702027207040306050725660683782674056703486765570501
10500000500000000070000040000030603040005000800060000050000040005000504000000070501
10352840835484678670455756337050508040826264533543324024304060602870476060865050531
10000030000000000080000000602040406050003000000080002000606030200070000040007080001
10785058374520376056832750707050302053802037508070766340852065743050437385208062501
10002080000050003000000030500080602000504000308000400020002000000060500020007020001
15808026858027305667402020467680607080403230408086406058505048667370808070558050851
10007000007070007000506000600000203050600000302000807000807000000020008040600040001
10404364703070325030446037506337607630826667707853803220508025437052333430503085201
10508000200030000030005000200000008000800000306000004040003020003060000000608000701
10433060705557748647805353778466644075702080523033835065254660506030485383606332601
10000020600080000000600000000020000080002040008000007080000000200040600000008000001
18864850265020378620708662558050403260476663602886802058687748725220802657255087271
10000040604000700000700050007040300060800000500000703000000000000000200000300070001
10446830805668704664725060775030834780802278347240803332835684468626466620502448401
10000000400000007000000060000070000000700000000000500000000000000000000000500000001
11111111111111111111111111111111111111111111111111111111111111111111111111111111111
