11111111111111111111111111111111111111111111111111111111111111111111111111111111111
10000000002000000000000000007000000000800000000000000000000000005000000000000050001
12505063803036242855203220233083607060304056755048877285438642305070526770283020601
10407050002000000000700080000030008080607000005000200000000000302050600020005080601
10308530343434764360206080264750624760603577308050204076888250804080703055505620301
10600050000000000000602040006000300000600060008050007030005060800020706000700030801
10536030603855553666753060206046807685238720228040542860608060542468402050408030301
10400020506000000000300070605000408000002000700020800000500030200000504070806000201
10203350732055736750604020806220258020404076302786303024483050607540506580605522401
10800040002030000000305070706050000020800060700000005050003070406000405000500000801
10637030304040678867707080203024226870352550502067366064604080306057704086728820401
10000050600030008000006040400070003000300000205000006000004060507000008020002000501
10548640704626654070473070433457703022506838805047505555403080205047454080306740501
10003000800000800050600030000000005000504000608000400000302020008000008000800080801
16304078545562802745702056753654363050807340402860467440702028283440303856787070401
10005040000000406020008000300000008020002000600050000030403000000080500000200040701
10448020587460704030302750202445508868205033807072208080267355422084765740604782201
10700040600050606000303070500070004000303000405000704020300000700060003000500070001
10503020402030306038808040476040547060368350887760203050803760202030505054838070681
10605030304040003000500020005020008040000040006000405070200020806040400060003050001
10502040503042754738508848304070605627363043708087203050237030608080583470708033401
10702030003050005000708000200080600000004030600080007050602070008030000000402000201
10808372874060604020605070464040673545405020702570623050402072444266625088554220401
10200000007000203020300080003020004000305040500050600020006000000050007060003030601
10674736858435506080436540305668208050706080878040205642522633578080302740203020601
10000000400000004020400020400070004060600080004020600020000060000020406000305080701
18754020702533225020502080864030443080622682607020202020867060708740407053308040301
10003020700000006020004070802050000080000000508060306020200020300070703000308000601
14703540707278504040224060503030842063333340702040207070508260266720304850703260601
10003000703000300040002060203030003000000070005020408000505000700080300070800050601
10507024678070523646402030505060407533552374252670536643504072308070703040288023301
10505000000060005000003080007060305000500000000000800070002030008000707030007000001
10605468776848305026643050836037802020204083658448808080736060723246636020806083531
10400000500020003040000030600080007070002000003000802000708020005000004080308000001
10335625707030337080502260603620782048523666707030507643804048603038707036805057501
10300080007000700060400060603080500070000000806080400000002000608000407000005000401
10706020702763304230305820806060308547564280655030307764645070605640606342373080201
10005000407000002000204000802000502000000080000050700050008060604000200030007070301
10344063707046343085846057404842803070277047428640688030802060502050872058507030401
10004000405000200050007070006000400080003080000000600020807050404050004000304080401
12703858302050606584306060882080346522702030406774502733306030408060307420405340701
10007000804040500000508050000050400000404000300000300000008040300050305000200020301
10857080805070674680204083322330222540637327763320753065505070333582402060406040601
10600060006040000050008000000050500030200040000060002000408050502000802040206000801
10802425765020246073267250226020403070804050238020208460228060508030555070772478301
10200000300080007000000070800030007000507020700080200030800080007070000060005050001
10604670608668703575463030805357335822263020808488652066804047836042705854306050381
10706000406040002000007070300000006000004080400000000070003000002000800000200080001
10752050703020404030427040445523403033208056703555346330305635664330702460704278401
10600030706000403030200040005000308060005000802000000000406000003000807000408000801
10703452507848267080207630308040607020523540428038736457475038208022665036307060201
10800000800050000060600020400020200040700000600040000070002000700070005060602040001
10528760333020402083448070868020508330406086308070727050207050404240507050502060521
10000040005000507040000080004050707080002040008040002000807050500060400020002020001
16577023307557405040766874308830807063734770607087408448607430763040265726655087401
10005080003000007050005000407000800040003000708000300000304000400080500000003040801
10207020765345246048604840206023478630704072845365805670307080806770307352608070601
10607030300000002000700000704000000080802000600000800060600020400030808000305060301
10764020462273408450308875502625504080204050807630834860765533422070708036403020201
10006070003000002040600000700000603000608080400040000000300000008080005050007070001
10604053802072776020873775774380457473202050234052677325628588706025228020673036801
10505000202050000030000000000080000030004050003030000000000000302000000040004000301
10803270307060603334353366882030223040355246667020458567624670408855455334705650341
10300080700020300000000000600040200040000000600070600000006000200000000000200080001
10382070677680666360356470303622508033875750708770405235307086572882304320374077601
10004000300030000060000080500000508040000020500000208000304020000000300030000060001
10206433702070523068583060727060608030802040573045404060805042203450706085684330771
10408000002060008000006030003050408070808050004050005070202000200030603000000060001
10608083432055834072203668403680406480525028207680247048804030746830804743275063701
10200050600020003000707000306000500000700040603000500040003040000030500020003080301
10235720706450703862203030266020876853302260208050707330535030645080503030827070401
10700000800000700070006060000080008000004000500080400050603020006020305000400070601
16508056246364723040537070843280883025426030468880303020404050353040608246805230601
10004000000020002080700040000040400050000060800000505000400060300070802000500000601
10605642448064507030806037248020708240305320205488284745422050405240804050304532801
10200000002000008040703000800040500000805000600070000000007060800000504030300080501
10888325832072853080702254708488886725407036427470208738407080865866238060388060501
10000000003000600070008000006000800050002080002000704000008060600040500050003000401
10242583205534505063523052356530206020375030805085303063282040707020607772506823301
10005000500020003060002000000070407080800080202000202000400080002000400070002000601
10807060365030706060707765322040702230208770505770788630885342424685752080763020201
10200060006000305000800000006000300000800000800020000030000000000000000060000030001
11111111111111111111111111111111111111111111111111111111111111111111111111111111111
