11111111111111111111111111111111111111111111111111111111111111111111111111111111111
10000080000000002000005000002000000000000000000000800070000000004000004000000000001
17803066385850802070684060607080756853506738525720802050306286602058607020655075501
10005040000000800080700040808070000070008000800050008000200000600050606070005000401
12728080625022638620506570606038863080362080304067344065346370702650203050403620201
10000050004000500000304080508070000080300060704000006000005000300080004050605000401
10577744802720707458604050408060282380804430464252505385807067233288765060708065301
10005000006000400000007000300040000030408030000080005000004000000050002050306070001
10706040384052872576626842207677344020408080834080638086273336835060205030407074451
10300030003000000000500000405000508020004080300020005000000000003070700040505000001
10366224684534873250603660727080808075257030307062604036606454206040406420708682701
10000000000030300000700060006020005000000080405060002000306000006000400060300000701
10456744854080806548474075604057504656262580208570255050708048678335473050434350201
10800000005020605000005060802000600000000020600080007050202060000070003080000050201
10307026506070307040704050305640746276574030667030806330263070252082607054236560801
10608000305000600040700020700040000000600050300020500030600080003000600080000080601
10805830405632522876548560403033357640705850808750536030702227706040546560886070601
10400040602000500000000070202060000030406000500040500040200070607080000000500080601
10263020706060205076388020404060605020734035834026408040653080608874703428807050201
10006020400060003000005020806000206000400070700040006070700030200000406000306070201
10802070273647763778408080307786388048302880302280375050702850208860535070506760601
10508050004000000080006000400000004000800040600030003020200000800050000050400000201
10308086404075303750505534864426703850203040404084608070283353658367864280546487301
10405000208000505000400000000040004000603000605000007080000000000000700000300000501
10208460304760468020364736678070736234365788804840427065847830502583207034305280601
10600070200020000050000000008070000000002000800040600070000030200040002020006000201
10835030506030826640363376307033547770602470705058702734274030752060405550404237701
10005000502060000020000080007000000080300050406000200000400040008070303000606000001
10706853747040678024225040708384255085336050306770643720208272204060248030408067371
10304000000030600040000020700000007000002000400060002070300070005060006030703000401
10306074504680604654458870457248704635305065335044502050488080234075807042505840801
10306000800050700000800000300000400060004000005000500050000040800020004000402000401
18803320833080255850805752706660502060467628737854886376655040823530468450407052301
10003000400040004000502000002000804050000000004000000000007060300030000000704000001
10575080202846403050205454737040404035542233805066583487304870407037526826356423701
10400030700000402040400000000060505000000030002000700000600030008000000000000000701
17208078256066807080407453224344504864877030202727406070757060282375233832345520541
10008060008060002020800000002000300000008040202000803030500080000000000000000050001
10458250806050243070466730428060473373533060235070702060607060782864634287446088501
10000080507060004080300020700050000000200060004080007070205040000000003000008040001
10582063702432204085405030603326642050608638708027238470808035807544472060332020361
10005020002000505050002020408000008040704000005000004000302000300070007020300080001
10802050257020804070408054605050802020383077644852603077408250564240707034406258601
10707060603040204000708000005030604070006000200000606000007020200000306000005000501
10204030208040407437855833475070607460306520787560303843628040507084403074538084501
10307040700080006000007000000080300020200060000000500060000080008000703000004000601
10503040308887258060603052745880304022385088887623747080424072656323503064463820401
10505000800000004030508000006060406000006050000000000070005000600070003060000050001
12702026372337828040407332807050707233802030785853254638702020302040804680308046471
10003000000000600040400000003000300080803000200000000000002040702020805000405000001
10776237774455303040634068336587473040603254707078203336538040202070466047643482501
10000000004000706040003000000040000070300060008000200000200050007070000040002000501
10457453504030404832504066226030703380404020403340336670706847654067876340304020601
10005000700020006000004000300050406000204000207000400000800000006000000000508050001
10208085307430224084262320807270766027706022603034457037765284407066327457856022751
10208000500050008000000020600070008000703000207020008000600020006000000000300030001
10804760845027403056584086335074408450605474606060306552703060875067546420805225601
10400040800070002030002060003000806000606000408070500000003070007000300000600000501
10854040438862265077608070502870606083683020548060468546548068308080207754458870601
10400070000000007000002000408030400070008050006000602000700080002080400000000040001
10707464535437406087737684604070325580804832808642607080804640864080408453558025371
10203000000000603070000000008070004000500000505000600040002000800060808000007040001
10707060708480505780222273473048703070856780808840304224267044207040503043582062501
10700050300080400000200000000030005020003000500050803000007000302040400050007000001
10337540553260504365503876705270645080304078865080507033806750808750633280308543701
10006000700000708000002000800060600050803030008070202000300000200050000000300000301
10408836603667632044836030775440805047207070202080224780482336842027306646257720401
10700000200000000050000080000030603060006000800080000080000030005000505000000050201
10458330445747338470322828853050608070727656586836835062303030704730477050478020381
10000060000000000070000000703040408080004000000060007000608060300070000050008040001
10452066565360562055653830508030502068802057408030684320664034423020525484405037801
10004040000020003000000030700020803000304000605000600060006000000050600020008050001
16405086247075406877708050325530204080508560302074406056603078878740808040465030531
10008000008080003000406000700000405030400000603000506000802000000060004050200070001
10808844703020475080868054406238702530277645402375304460406035457076677250204074801
10706000300080000040005000300000004000400000304000007080002020004040000000404000701
10884070702427324623504224648735427078604020875086526075622840302060552256607575701
10000060300070000000200000000030000050006020007000002060000000700040700000003000001
18334730852080734450706637724080302760726542703824502083654546425880603332748062261
10000020203000600000400050004050200060500000800000602000000000000000700000800070001
10757220806447502746287030262040524250702528567870606273474363657445453440802245301
10000000700000008000000040000070000000600000000000600000000000000000000000300000001
11111111111111111111111111111111111111111111111111111111111111111111111111111111111
