11111111111111111111111111111111111111111111111111111111111111111111111111111111111
10000020000000006000008000004000000000000000000000600070000000004000004000000000001
15605023725760803060774040508060427824505788623460602060804562402075805030722074201
10008060000000800080200040405050000040007000700030008000500000700030807030005000601
15848020632042434750705640806028356070344030703046378057837420304670206080306780801
10000030006000600000505060204020000070200030205000006000006000800050003050205000501
10722484807440705465708030808060253460504270253758803442707026843582578070806045801
10008000008000300000008000200020000040503040000030004000004000000050006050605060001
10802030783068453384685755203836345040303080748050862058553472466060608080504034731
10300030005000000000200000805000608020002050300040004000000000007050300060803000001
10576436768338784520607440676030408054327050607032504062406663204040307230408687401
10000000000020700000800080003050008000000020507020007000802000008000200040500000601
10337252583040608348353025202038304235688420802880756080202046736875557050268630401
10500000005040303000005080207000500000000020200030003080605020000020003040000030601
10406024508080202020302040607440372262535030843030504360236030662046608067552330201
10402000604000600050700020300020000000700050400040500020300070006000200080000080701
10603530206534235526485460808056262430808730405670385030504875403060527680462030201
10300080603000500000000040205080000070707000600060400060500050603050000000700040401
10676080504030607034225080502080807050865082743056803060724050706266405758708050701
10004050300070006000006030708000202000800040400030004060800060200000705000804060801
10604080484877728835206040802725336023702820304760245030706340802330222030408470301
10605040008000000060005000700000002000600020200040005040800000700030000030300000501
10507023704063806660506575222824408650602030405084508030273476658254326660237348201
10307000603000504000800000000030003000505000503000006040000000000000700000300000401
10407540202720727020864866384030265252658465408540827057626560303837402048204370801
10400040600020000070000000008080000000005000800070400070000050500050002070007000401
10685020207020674250685644605083276860608830608077806684543060233070504380804324301
10006000304080000060000040004000000050300080604000700000400060005080305000603000001
10602777773020578062257040802285865057285050707660263450502654404070384060708084571
10204000000040300070000040500000006000003000200060003070300030003040004020802000801
10403076302630808878644370223342408724605035625038307050377070277027504058204460501
10603000400070300000300000800000300050007000006000500060000040700020005000204000201
12308270258070238320708658305320505060576788663382426644375050677320836470403074701
10005000800070004000408000002000404040000000007000000000007070200020000000805000001
10575050408473208020505272353020702034275662202046576687402270602046635773727844501
10800050800000506050200000000060306000000080003000200000800080002000000000000000201
13603028526062702040508538588838606665638020208778603020843030324545242836567730561
10004070007030002020600000006000700000008070202000806070700050000000000000000080001
10854370606050728080874560543080237476523070362030508080503020738382384534865088801
10000070604020008030300050800060000000200040006020003050406020000000002000006040001
10328072605334704046306070302778352080704555407035232840205023202273438070685040341
10008050005000808030005050703000006050806000005000007000307000800080003050800080001
10507030372070508030302078405040503050653044752423407023202420383240503068605536501
10403080703060406000303000007030607030006000700000803000006070500000303000005000201
10505020405070608762534237486020702320706250626580204383533070504065408086767046701
10508030800030008000007000000050300050800080000000300060000070008000606000007000801
10703050202625774070807065866360507072235035274275427030488024777727707072465850601
10305000500000008030503000003070808000004020000000000040002000800050004040000030001
14302042572486742030802427707040206688403060758778882247308020307040603350407064651
10008000000000300040500000006000300020506000200000000000005030208030207000507000001
10664755248732703020266062876376855030504558608074407736532050507070728053376538801
10000000004000805060006000000080000030600040004000700000400040005020000050007000801
10542845304020205385403047475080805440707050303480457470703777278047758460705070601
10003000300020004000005000200060402000802000408000200000300000005000000000506050001
10402045806420823044576530304820688082805066507078337073388858508055686856632044341
10706000200060003000000080800070005000205000803040003000800040004000000000700050001
10405680333053502073657077484028707430305454306060804384807050365066848820606786301
10400030300030005030007080006000703000204000406060200000007080005000600000500000801
10723030673348444083204020305570202025277070857040552275624045704080204837576280501
10400060000000007000005000306050200070005070002000204000700020008050300000000020001
10207568744682206033628457705070258620505866504883705080704370585080504323866075281
10205000000000604020000000005070005000300000703000300060008000300030407000006060001
10503040705260304870475236782088203060882580806870506562246054503030305057228062401
10700070400050400000700000000080005050007000200020306000005000503050700050006000001
10486250665380602347306632303770334030308087485030403066806530706350653650602875501
10006000200000404000005000800060800030405040003080806000200000600030000000700000501
10606454202367847086663040637440802055207050508060824680838332266048706686875860601
10600000500000000080000050000070202020002000300030000070000050006000803000000070201
10478530582743445850627377766030708030344477482276884067505050207230555050643070741
10000020000000000020000000603080407050007000000080008000302030800050000020004050001
10235082268860227032322260702030305044404046403030876360772065263040235248708063701
10002040000080007000000050800050408000206000203000600040008000000080800020002050001
13803028628073303234802060468660506080708370406037803086604078377480306020378060871
10004000007020007000703000600000705040700000302000603000802000000070005060800050001
10505442803050453060752053503467507330657643506653806730404084224058464540204078501
10806000200070000050007000500000008000800000804000003080005050007020000000403000501
10454070608864867854408277354634588088503030243033464022858330508060227576506343801
10000050800030000000800000000080000070006080004000005020000000300070400000007000001
16767350485070744630605585462030602540672767708228508056783532456860406427336084661
10000030703000800000600050003040800050700000800000408000000000000000800000300050001
10644450803754805644234040533060433360602645628240304332563827576432435540802364601
10000000400000004000000020000050000000500000000000200000000000000000000000300000001
11111111111111111111111111111111111111111111111111111111111111111111111111111111111
