11111111111111111111111111111111111111111111111111111111111111111111111111111111111
10000050000000008000005000006000000000000000000000800050000000004000004000000000001
15505026456780708020447050702080344686807772436650207040503737807064805040337068201
10007040000000400080800020605080000020008000500070008000800000600040403050008000401
18868060635024322440706280202038725030825070707048253025268630608450408060607380801
10000080003000700000206080207040000050400080304000006000004000700070007080305000301
10484863407440707873206060502080544220203830775327305548304063848558375050506052401
10007000002000800000005000400060000050507030000030003000007000000070008030703030001
10502050722077673486662224407652828060505080374060284072535252672040803020707073571
10200060006000000000300000207000206040007070600050008000000000005020400070808000001
10283235357523468320308760248050206066274050503048602072404373506020704380404444701
10000000000040400000200050004060002000000050602050005000807000003000800040500000601
10876676288080608356567033506046807782722480202640334030704048526347547030265750201
10200000004040806000002080703000600000000060300060004080805040000080002050000030401
10202067802050505070702070407670356258656050674040407520556080422083402023787240701
10708000802000800080200040600030000000800020800080300070400060007000500080000020801
10802880302564548348237630308052436720805550804870763030608632803040474730325050801
10500080503000700000000020206060000050203000700030700030700050308040000000400040501
10745020507070206087377070807050702050786032526065508050782050802673402857303070201
10006060400020007000004080303000604000400020400070004070400020800000707000203050601
10608040623434422643204030204387777078804570504870588080604560505340222070202570601
10703060004000000070006000300000007000300070600060006050400000600080000070700000801
10805045403037606680505422852833602760302080702042703070756344858354864650525886301
10407000704000207000400000000020002000503000805000004080000000000000600000700000401
10605880705380667050777554544060784854236423608240627053265460403555306056405640601
10500060600020000050000000008070000000002000700040300070000020700070006020007000501
10378050506030554760553776406062452330408460306073208242443070885060804650406584301
10004000802060000080000070002000000050600050706000400000800060002070204000808000001
10203242325020834076373070208776652045844080403320328480405554702050873020803047851
10606000000080400040000060800000002000006000700060007080400070007070005030402000501
10405046504320404335283880544648805535307044847037502040857060343068504065207760301
10305000500060300000300000400000300060005000007000500070000040200070005000402000601
16606360556080277830706238407470807070378722346758663286642050525480387640803052401
10007000400070006000402000002000306030000000006000000000004020300030000000307000001
10848080806876806020302823353050406054854433307082377826506270802042265563352437801
10200030700000305030700000000080603000000080002000200000400060004000000000000000601
18705062854067405040808842646422304325822060203765605030585030786445554537846430651
10002070005030002030400000002000800000004050504000604070300070000000000000000080001
10882850402050887020736820675060745858683050474050402030503070355753273852367083601
10000060504020004040300030500030000000400070003050002070307030000000005000005020001
10552052607254806085305070206644834050204823804054468360302044307224337030458080521
10004040006000607070003050702000005030305000006000006000406000600070002050800070001
10302040755020303040205062502020807080524058574763802084407750246550208087206852201
10207070807040208000704000005020206070003000400000604000006030400000305000005000401
10506080704020202682785474637020305420407330662270204578843070603028208033834034601
10403040400080003000002000000080500070300030000000500070000080007000704000007000401
10802040804725862040307042875820805076838065876885473060466057562558208045528220301
10703000500000005040304000006070308000004050000000000070004000400030002020000020001
16808078673632822030804478505080402635307040687628284877305040804060503860406046751
10004000000000600070300000004000700050806000800000000000006050705020808000207000001
10584655255767204020342076542435255020603824203034705246434080508070562066355557201
10000000004000506060008000000060000070500030003000500000200030008050000020008000501
10687548803030403848302052287030405530404050705230628720308774768043355440702050701
10006000300040007000006000700020606000404000806000400000200000008000000000208050001
10404035207770383054757770706740552022402062602022726056782544605045866675756032771
10305000400060004000000060800080006000802000203040002000800050003000000000400050001
10804460235036604052238045238046504870202368506070708426704080858072462760705438501
10700050200050003020008020008000402000205000303080200000004030006000700000800000601
10382070734473756037207040704570507087385040538030248877554083405040702852428260401
10600030000000004000002000508020700030002040007000606000400050007040200000000060001
10306834858732505073886857608030222880805842305768205020205230824060608563467057271
10802000000000205080000000002040006000400000503000800050006000800070305000003070001
10608060405350802380533674336078306050235780407570704457747076303080407063222023401
10400080200060600000400000000070008070007000800070606000007000305050300060008000001
10744670758670708527206326602560758020702067262030303044407360304460368370603738201
10003000300000405000007000300050300060204070003080403000500000700060000000400000601
10407774603526886035625080722780406084806080406080858830836846567027204358587760501
10500000800000000070000030000060805020004000200030000060000020002000507000000070301
10888460466673485270235674448050204050632248653646227058308040608730534040358080281
10000050000000000040000000703080606040007000000030005000202030300030000080002050001
10835072534440655057756870507060302033204073808060775480884027758070842486702057401
10003060000020007000000070300040403000205000305000800070006000000030300040002070001
13208053384054204827602080375520207030408670708067702056706033587440808070744040761
10006000003030008000802000700000702080600000503000608000707000000080003070400040001
10404842206030787070274067807852204340854862806526402360803046642033576550305036401
10805000300080000060004000700000002000400000508000004060006020007060000000305000401
10433020303668852682703872388587874033504060228022622025387720204050858662604366601
10000020200070000000600000000050000040002020003000004040000000600060700000006000001
18487360665020255580407764458080308640337463605687705023833474684350507727538056581
10000050203000200000400060004020700030700000600000807000000000000000200000700080001
10765230304862806442722020626030425470603556878670203346743555587855777570405564801
10000000400000002000000060000070000000600000000000200000000000000000000000600000001
11111111111111111111111111111111111111111111111111111111111111111111111111111111111
