11111111111111111111111111111111111111111111111111111111111111111111111111111111111
10000040000000005000004000005000000000000000000000600080000000007000008000000000001
12405058877270605040678040808060867284703243663380304030707432708052405030578064701
10007080000000200040800050302050000050002000700050008000700000600060206020007000701
13237040527072378730206670505028382020363060202048257047642260807760308060803760501
10000050002000600000602080206080000080400050802000002000005000300030006060404000301
10743428403560208352706040207070523850303220264645406227708043332784854080604025201
10008000006000300000007000700030000080202080000070007000006000000060004020304060001
10807030284026765737438578406678237020403020426020746025577726667080403040805066731
10300060008000000000200000707000503050008030400030003000000000006030200040606000001
10276728375688742850404570574060207063877060403026608078702333605050306720503478501
10000000000020800000200060002050007000000060408070006000504000004000400060200000701
10647765286080605362333053403027503425444730507630347060202083248344557030225480401
10300000007050802000007060308000600000000050500080007040703080000070008060000070401
10702034704060206020604050803430378633428030543060202760574030366046804083627580601
10507000706000400050300040800020000000800020800050500070200020008000400030000080701
10804340205343226833872620702057326770408880604250534050503878404070482750662080801
10200060307000300000000040405030000070204000500060600020500040605030000000700060501
10352020306080607023743070508050403020342028678044704040835040407727706468808070801
10005030400040004000004050206000507000300030600080007060500050300000603000507030501
10806020663287684623406050402356567045802750405540323030502380507260877020205870301
10303060002000000080008000200000008000800060600030006040200000800060000040500000801
10705033407035506460505228485878405420405080706027204060657742576458865680887742501
10302000403000803000600000000050007000608000406000006060000000000000200000800000701
10208620502550643030228648478060677572255642808660438038528870208324503064505320501
10500080300070000020000000008040000000008000200050800020000060700040002050005000501
10256030205080622440547442605022786320707640802048805423536050776080803260402233201
10003000605040000080000030007000000020400080406000400000800030007020608000704000001
10702764446060526035733040304374466043524080404440625380808578603050482040204067221
10804000000060700020000030300000005000006000800050008080500060008050008070605000301
10604075208340506588742660484622504347605073348083706050584080424036603053803880801
10708000200070400000400000500000500080005000007000800080000030200070008000608000401
13304440682080464560604453502430803060248828447374663237332050447580873660804074601
10002000400070002000406000003000702060000000006000000000003020400050000000604000001
10745040704664803070707878722080505063756464804044332645506750508026775477686262801
10400020300000708030300000000040406000000030004000600000700020008000000000000000601
14702044675027804060703255888873508347737030502627507070444020842374723888254380861
10008030008070008070200000003000200000005030604000306030400030000000000000000080001
10362280705070763040423670675030783467746070538030508080808060465565873435432022801
10000070806030005030700020500030000000600060003040007080405050000000003000007040001
10875033404756606038606030406628467050304338502035325520306033602435237070574060331
10006060006000607080006040606000002060203000004000002000402000400040005040500020001
10802060585060306070206067403070605020328023366483204046706520558370603063803725701
10207020607030207000604000002070405050007000200000504000005070300000406000005000601
10403020207050603443773637475050304220508830357580504883753050806068804057553065701
10506020500070006000003000000080700050700050000000800040000050005000705000007000601
10407060503822566060404035325230805035265063856578574060588022585844608067846620801
10807000500000007060205000007040507000004050000000000060007000700040002040000060001
17606068682784286020305735306080806225706050258456548457607060302080506530805087671
10002000000000700080800000002000300030608000300000000000005050404020607000205000001
10233452268685208070386062728748842020403762506076404536773050806070264034884372801
10000000006000405070003000000030000040500020008000600000200020004060000070004000401
10778755705030507325808056535030203580605030508560537660607453642068783270406060601
10002000500050006000005000700020406000705000208000300000700000005000000000706050001
10806056502740377087777840605330645024506026606024787042467762704087784634255057541
10707000300040004000000040800070008000606000707030006000500060007000000000700030001
10707720527038406057224062848064606620503325305060207476202030337022854670605862501
10700070800070005050004020002000503000204000804070200000004040008000300000700000801
10242020584684474072604050208680706038638080664030654767432054406080206853445640301
10800080000000002000004000306080600080003060003000607000200030004080300000000030001
10606734487782502054622782308080665660407236206586302080808660745040505645524043541
10408000000000406080000000005030003000200000805000300070005000200080802000005080001
10405030405730604660434824258032705070856720705730404837332076505080708023226053501
10200030300080600000600000000040006050006000500050506000007000506060200040005000001
10847580628220304273203675806380485040307065327060605043207830808370776420206428801
10007000500000407000007000200050700080206030002070602000200000800030000000500000701
10702657602777544055322020424560404053406040406040446440563756363037405636644880301
10300000600000000020000070000070502050003000400080000070000060002000302000000070701
10433570384378355530865364224040204070758726257344845055206060802530573080764060361
10000020000000000030000000707050706080004000000030005000503040700060000070006030001
10555026242550724054755730802060306035302063603020524430658037452080447283704074601
10005050000040004000000050600060808000806000606000500030007000000070300080004060001
15502035347067205524307070334660708080303320805087506036202022245440707060544030761
10007000008060003000707000400000602060500000206000403000306000000050007060800080001
10503282602070755060743032706676203280766286504422204660406088376072677840303054201
10302000200080000040003000300000006000200000606000008040002030005020000000608000301
10375040406764428724308544228223485063402070553063777037382520706020486334402628301
10000080300030000000300000000050000040007060008000007060000000500020500000004000001
18376730385080842740705286272040307480688568208378506083666225286370308377234033671
10000060502000300000800080006020300060200000500000703000000000000000600000800050001
10264720306437803554687070257080887870602262787670508765584476785365456470707886201
10000000800000005000000080000030000000500000000000800000000000000000000000300000001
11111111111111111111111111111111111111111111111111111111111111111111111111111111111
