11111111111111111111111111111111111111111111111111111111111111111111111111111111111
10000040000000008000007000006000000000000000000000400070000000003000003000000000001
17806058465740305020245060803060228457202883867840408040407536508025302060486076501
10003060000000300030200070302020000060002000700020004000500000200020302050007000801
12583080458056388430706360608045366020822050704058222064287260606370602060602880601
10000050003000300000708080302080000040500050406000004000007000800020004080707000401
10663457803570502485207080504050322220206770453848804438403085426444368070508037201
10004000004000700000004000700030000080807060000070006000004000000080008040808050001
10608040377037572382782677804358467070308050577050656042452437677050707060302056251
10200050002000000000400000203000603040007060300070005000000000003040300060805000001
10682837727537235230302260353040807035822080305075506084807562407050606750706454501
10000000000050600000800030007040003000000040807070007000707000007000200040300000801
10343342644070604255443022602034605337626230604430782040206028284832875070873740801
10200000008070802000003030506000300000000060300020005080302070000050002040000050201
10405052205040206080605030702540787674542080524060308650578030643076603044776620301
10806000302000700050700050500060000000500050700030200020700050002000600020000060201
10408420208575258747372680407045456240405730808850784080807263205060522240278080401
10400080506000800000000080704030000030506000300050700030600080603050000000400070301
10635060403040408035884060702050604050457062683082702020224080608632305385503060501
10005040700070008000003020705000702000300070500030002070500070500000708000404060601
10506060227356748744502050402633888068504220803260672020405720204420785050807340201
10406070004000000070004000300000006000700080200030005070600000600060000060500000601
10605055703075705720505548632742706270503020205073706060725877538788362760744855401
10503000608000605000700000000050007000408000203000007030000000000000800000500000401
10508350802770243080322533427070533757738577402350536078734770802884707023202870201
10300040300020000080000000003060000000005000400020800070000050700030005030005000801
10552040604040585480562863705046647570403770304088306658244030687080804580208826201
10003000407030000020000050004000000040400050808000300000300050005040704000404000001
10308644573030523033242040403543866064848070706830587740802437302040745040603084771
10707000000020300050000080400000002000002000400070003080600050004080004080703000701
10505028304520302766245270387427202465607022323077606080437060723043605045403440301
10705000400040800000600000300000200040007000008000600040000020800060008000708000701
15502780888030266450404883702870508050848723262823834286434020277650857730408057501
10008000700060005000206000006000706030000000002000000000006080800030000000806000001
10628080608272406080307582547050306065864875804067377332708530605063564473644286201
10400040700000805070800000000040505000000050006000700000800020002000000000000000701
17708077687077602030206787665567204888547040308663606050277080532473657822635650261
10008050002040002040200000002000500000007070205000706070800050000000000000000070001
10582320508040685050584560834020325237647040434060402060302070268833336786354055501
10000070302030005070400020800040000000400020008040008050404050000000007000002050001
10335036708453502022408030306457822070605878602037283570404074605247384040248070461
10005050007000504080002040503000005040507000005000002000507000800070008020600040001
10503020387030405020804047805040608030325034777825702077405730537760703033706673501
10808080405050508000508000006060702030004000300000507000007060600000306000004000601
10806070308060608754755427756070506740602480326270706473664060707025603048746032301
10308040800020003000008000000060300030800020000000800040000060004000702000004000701
10702040503766787080407033458780508032367067623387368060624038745454204057262360301
10605000400000002040305000005050207000008040000000000060003000800020008020000020001
12507046726572634050302667707060405388502060258686642252602040405080306770406056661
10007000000000800020400000004000800080405000200000000000003060708080808000508000001
10848234852626304030453077885868466020202772508088306474636060304040843064745272601
10000000007000504050002000000070000080400060007000500000200040003040000040005000601
10754283804040502626605074527030603770705080804250734220306264284086776620302070501
10005000200050007000002000700080703000702000605000700000600000005000000000208070001
10606047208340745044327780805280345065508055307036486033442755702068774843568074671
10203000800080003000000080800020006000204000208060003000200080008000000000300050001
10402360345086302054773073332085204850606677407050606876306080644064548420303342701
10500040800020003040002070006000508000705000507050400000006070002000700000200000701
10466020245645688047704040403580407043567070574060853687352087708080703863727760601
10700050000000002000003000308060400060002070002000705000500030005040700000000060001
10603467545526804072258235203070366660606438702823605030808270324050805884823084451
10408000000000402020000000007020006000500000304000200060006000200080503000002020001
10404080408250708550466487746087604080448650503220405372635033404050402056634072701
10400020200020500000200000000050007070005000500020707000008000807040800040005000001
10254430646460603678207626604430687020607076232030707046503870705650735620306386601
10006000400000506000004000600040200060702040006050602000800000600050000000300000801
10706646305573658088777030332330707046608060806080332780733657225076806427755270601
10200000500000000060000070000050807040004000300030000040000080006000403000000030701
10236460875225784650635384364060308050622438274357367073308040303560657080848070561
10000060000000000020000000208030603060002000000020004000402080400060000020005050001
10435074667880282063244840406040304054302052202060487430853068883080367538606037601
10007050000040005000000050400070507000208000203000600050004000000050800020008070001
13303026523083505325808080432470508020308230605056302083704057472440502020537040421
10007000003040008000304000600000608040200000604000205000204000000080003080200060001
10504426602020528050788028805838702240882483704384307770403056883058788740803073401
10206000800040000070004000600000005000300000502000003040006070005070000000205000601
10584050804465488442807372688574566037405040887067363068558680204030753362404376201
10000040500050000000600000000080000030007030006000008040000000200060400000004000001
15348350378030826880707457244060804850624243804228703042235537652230804522346033861
10000030708000200000800040003080200040500000400000304000000000000000300000300040001
10866840408265706455823080626050634680702285567220402776852622844484286360708435401
10000000300000003000000060000050000000600000000000500000000000000000000000400000001
11111111111111111111111111111111111111111111111111111111111111111111111111111111111
