11111111111111111111111111111111111111111111111111111111111111111111111111111111111
10000060000000004000002000008000000000000000000000600080000000007000005000000000001
16504056578430603050663040506060352362404588587820308040806563305038604080243072301
10008040000000200020400050404070000030004000800040008000600000400040608030002000501
13765080436063538780508330604022826040567020805024447063754570606840802070405520801
10000020007000400000805040607030000030700050402000005000006000700040002040806000501
10267263707760806286402070708030776420402880742873708538202076728875326030402028401
10004000004000600000002000500070000060308080000030006000007000000070002040807050001
10503050285034287328544888608427527060808030835080573025243242237040803020306035571
10600050003000000000600000507000503060002070500020004000000000003080700080307000001
10856743325243482260507880383040208065388080306062303074205425606080502820406274601
10000000000040300000300050006030002000000020503030003000408000004000300020300000701
10762773558040505457786084604046402737676850302570476080508066464767244040456860401
10200000004070305000008060808000400000000060800060007040607080000050002030000080401
10707078502030406030802080205370833776742050445080304670634040286048508045225870601
10207000306000700020300080600020000000600080200060500030400030008000700030000040601
10404260405725836684684770306062385840208240708220235080506573304020883830577070801
10200050805000400000000020705040000030703000600040200020700050308050000000700020801
10864030707020708037237020307070404080258046848088504020258030507355803633307070801
10005070600080007000007020207000703000300020300070007030600060400000508000707050201
10404060854338472583804050702726847053807670303850342040808830806230253050607370301
10503070003000000020005000800000007000800080500060002060300000700070000050400000501
10402076607055608880303863865455205730704040305087208040436554548382242230245432701
10408000506000305000700000000040002000203000306000007080000000000000600000400000501
10402220805580277050643788682050374525563226205750225022558270304377704066202370801
10200070800060000050000000006020000000008000700030700040000060700030003030005000501
10863030805030228530674623803086838680506760302066503327846030832050303880703586601
10003000404050000080000070007000000050200040802000500000200060006020802000802000001
10706685368070244032562060205638435088788050705440845550805886606060636060708055531
10808000000070800080000030500000002000007000200070006040700050006070002020807000701
10807073506220305826726540774267303757503074863044602060233040324068404042203670801
10202000200080600000700000200000400070005000008000500060000070700020006000602000601
15507740876030254750208628608520302030276225586856567875486050557680355660507037501
10005000400050006000705000004000505020000000007000000000008050500040000000406000001
10472050208547803040206435577030508054268555402046842532508780703084872354536262701
10400030400000405030300000000020407000000020003000700000300070005000000000000000701
18305037537042308070207285845345406676626080806334608040427050263727476785458440581
10004030002070005060500000007000600000005050803000207030200040000000000000000070001
10367230704080368070254650883080444472526050353030206050807060768527682485587045501
10000070604020005040800060200050000000500050003070008070803030000000005000007080001
10367073308525302072503060803328358030402857503054687420605075605267832020322050771
10008020007000503060003050308000003050303000006000003000202000800070004040300030001
10603070643040807050707056507030507070673053272528607087705870236340508082304838301
10808040406040203000406000004070208080005000800000603000008070300000805000006000601
10305030407020408646757323538080208650604330644340403832473030706078803072587024801
10406060600030004000007000000020200080400070000000300080000020008000607000005000501
10203060407823885050808085843240202043447053438682684060855072382537604068542630801
10204000600000008030804000002060506000005050000000000080002000200050003070000040001
17602022567385578040605264202060305735302030876435636466802020408020808850305074751
10002000000000300070700000007000400040604000700000000000005030407020206000302000001
10326654575526805040736082238263632020704458705076707532274020602020687027246836801
10000000004000305020002000000070000030500070003000200000500060006020000070005000601
10488562408030606352508073572030503470802020604480836560202447238062626340203060501
10004000800020003000008000400020206000806000602000200000300000007000000000805080001
10208084205730556067742630405320766023803023804056845025752365804063566754865066771
10702000500020007000000080800070007000407000506070002000700080008000000000600080001
10405750855037506066846022874035408260307387605060608852703020546022226380203265601
10800080700070004030005060007000304000408000602060200000003050002000600000600000601
10562040347828243046207060605460404073338050323060234822377034508060402584523650601
10800030000000007000008000507020300070002080008000505000700020002020800000000080001
10506663485656703038784763607080728440304538702453504050204660687080605852326078551
10607000000000508080000000002030004000200000304000400050007000300030805000007050001
10802040404880506360764642523082407020374820804430707778248048305050504075836072201
10300020800080400000800000000020002070002000600060605000008000202070200060003000001
10375220276520606778606636404520578020508035236070702052507530507460563630805582501
10007000200000502000006000800040700020403030006040707000600000300070000000800000701
10208855602468862073238020425350308067707070607040628360872458525088308752665760601
10500000600000000060000030000020307050007000500040000030000020006000208000000020301
10782680436862458830245373226080306060642658486673225042604080404350488030763080351
10000030000000000040000000403040205030006000000020006000404060700020000080005080001
10624073226830674046382840802030702078605073205070283420245024556050578882308072401
10004040000030002000000020500020505000705000607000500020007000000050300070002040001
12306057285075505327606020356520308020508360704025708034806057324720207080263020631
10007000004040002000206000300000303020600000803000402000604000000050007070700060001
10208845305050576070245058407647507380624822503562407540806042534073583520807037501
10702000700060000020006000300000003000400000505000007040004020007020000000505000801
10488080805457368628404475584763522077406020686075435026534560308050637783606288701
10000060600060000000400000000070000030004060007000003020000000500050700000004000001
17443350573080373360502587288020204450224762605446502034545564244670402448654056381
10000050607000600000300020004060200040700000500000805000000000000000800000700050001
10584650808283807383766030435030856730508352525480803843233835583748573280303635201
10000000800000004000000060000020000000700000000000700000000000000000000000200000001
11111111111111111111111111111111111111111111111111111111111111111111111111111111111
