11111111111111111111111111111111111111111111111111111111111111111111111111111111111
10000060000000007000003000005000000000000000000000700080000000007000007000000000001
12607053838830304060447050802030583585408346656440604050803377206046304070378048701
10003060000000600060300020407080000040003000500020005000600000300070702030006000301
14538080577065688650503450703043553060533070203057733028272880604240808080202570401
10000070002000800000804020504070000070400050805000005000005000800050005070505000701
10273477607660607225805060502070266420606570324868603822804064883462367050704073701
10002000007000800000007000600030000080302080000060008000005000000060003020504030001
10503080626063648636622256405674385080508080846040667087277755534070408050508045571
10200030005000000000400000803000307060007040400030002000000000003020700040806000001
10662445674352652250304440572080407066555080405034304038403727806060807440702865701
10000000000080600000600020008080005000000080806060008000407000004000400030500000201
10528485254020705577633043305053707446735720806820848060607052875485546030742630401
10200000005040806000005080208000400000000040800030002060403020000050008040000060701
10505026307030303040304020704750335332532050637030207570543050485034205046546860501
10207000407000200060700020800020000000500050600060200040200040008000700070000020401
10707730203285436836262460704044642530802330802380325020508363405020577460733060501
10300080808000500000000070206020000050303000400080400070600020708020000000700030201
10745030705030808087837080208070406080855036757055502030833070403678607473202020401
10007020200040002000004030404000303000600070500070008070300030400000802000404050601
10408080662255284277206030604644888072208640405630563020207440206550327030507330501
10205020003000000060003000600000004000500070600030005040600000500060000030200000301
10607034706024504880404624522547804260203020704032306020434676646626872540555273501
10805000408000207000500000000050004000704000305000002030000000000000700000700000401
10807360504470482030566875485040735555453253502850773066344850608785502056308340501
10600020800080000030000000005040000000006000400050200050000060500020004060008000301
10255030807040227370264462806084673380806660306046804264652050722040407470502622701
10007000203040000060000070005000000060300040204000600000600020003080202000805000001
10405652855070476088463080803738433064262050705420463770802364508060357040707033441
10603000000030800070000020500000004000008000800050004080500070003030005080804000601
10407078406330706654764620823274808446406047878022507020838050746067604056707540501
10204000800060800000300000600000800040006000005000300070000020300020003000207000501
16403460842040742230802284406370406020875538444288377575462050668880877520306052601
10006000500050004000602000006000508080000000003000000000002030300060000000303000001
10728040605246202060404764668080408048744376703082268365507630207075437238866357301
10400060600000707050400000000070803000000060002000800000700070007000000000000000401
13605065453057803080607668828337605836446060406742803050824020786368763235337880521
10002020003060008020700000004000200000002050306000403020200070000000000000000030001
10585420707060236040524640732040257848583020754080304080703080822338636653774027301
10000060206030008080300070400030000000300070004040005040306040000000008000008060001
10678065703333404022805050708653672050608753807046237760504023802834726020672030661
10008060006000803050008020802000004030706000002000004000302000800040007020600040001
10305050868070606040602025802030807060454052528567607043405680432270208034604473201
10308080805070607000703000004050204080005000300000605000005060300000708000005000701
10705070806080407287782784874020804270304750236620407523326040704065404048257026301
10508060200060008000008000000080400060500040000000200040000060004000405000007000201
10804030305535448020607035332240506082624027783435342080268087353773206058388360501
10305000700000007060503000006050202000002040000000000020007000800070007080000030001
14204085243382888050805544303060203342502020346274446466706070708020706270802047471
10007000000000600070800000006000600030808000300000000000007050707060407000403000001
10367477267237207070426078282872463060502566508023203634678020605020836044367265401
10000000006000702060004000000070000020700070003000700000600060003080000070006000801
10854768703030608676302073325070708370307020606580352680308537757088457360708050701
10003000300080002000005000600080802000402000408000500000400000003000000000503050001
10802066806740755077265760402370352052208022204038853033573686704034354822452078541
10505000600080002000000040700070006000802000707060007000800080005000000000500030001
10603470287077805044385047383048306420707882704030707635604020648073266470802343701
10600060500050004030006060004000703000505000506040200000005070002000400000600000501
10524050844538773034606030302370804074352070656030624575663074804070404534665540401
10700060000000003000007000703070200040002050005000706000600070004050200000000060001
10403547283862503057334646704030724340606538506422303080606340422020205422256084241
10206000000000606040000000003070006000400000502000400060004000500050703000002040001
10506040307440803380583557487027802040785530803860404354675044208040605076652085701
10200040300070200000600000000070004030003000800030804000003000508040700080003000001
10727270283360603236207863505340352030607028586060505086806250408270566770204368201
10004000600000206000002000200080200050306070008070703000300000300030000000500000501
10207228304565252045732060232320303087402070702040268670223526246057207735742480801
10400000600000000060000070000030508080005000300020000030000060003000406000000080501
10845670374364682470428653855040505040725256345773285027302060506830458060467030381
10000040000000000050000000708050307070006000000040004000402080600060000040005030001
10484057284620274072678220207080308067502035306070722360568085873050876278707026601
10003060000020006000000020500050803000308000305000700050007000000030500030005080001
18406044525084808476603020364520706050608820404044203086805022632570705030737060531
10006000004030008000706000700000304040700000707000204000603000000020006080500020001
10503847806060386080435052303424705440737674807827804870803056285085845270803065801
10305000700050000030004000400000008000200000203000008070006050005020000000206000701
10465040706646644752208342543285456064306050275038536042462330608040673256208362201
10000030800060000000200000000060000050008080002000002040000000300060700000002000001
17266780878080476270706483738060404880363266408884604045432475376380204245385068781
10000020404000600000400030006060300070800000300000303000000000000000700000600040001
10575530704646802748386060275030883780202778527830702457488846763482784230604277801
10000000700000007000000070000020000000800000000000800000000000000000000000400000001
11111111111111111111111111111111111111111111111111111111111111111111111111111111111
