11111111111111111111111111111111111111111111111111111111111111111111111111111111111
10000070000000008000004000003000000000000000000000300070000000006000007000000000001
12205057652650404040326040607040462633806542735520302060608542408076805030683076201
10008040000000600030800060607080000070002000400060006000200000800020702060008000401
16772020724047544280803780706063648030622040607065842028332540308430702040304340701
10000050008000700000802040804080000050200080703000008000003000400020002070807000301
10357478603260807557706050302040844530506630278828408582207035437443547050506082401
10006000005000800000002000800070000060602070000060005000006000000080004030502030001
10705050742075577332485785307777434080202070862060455044538745353030603040605065831
10600060008000000000200000802000303020005080700060002000000000002040500060704000001
10737842464568387330506830322040406022732040806088207045604573202050308480503733601
10000000000070400000200050007030006000000070405020005000504000002000200050700000301
10354286284030203655663025804048506643543320207570834070402023447588526040362380801
10300000003070204000008020203000200000000060800040002080308050000080002040000060701
10808024204080503070806040508220442742682050677030307740843030243074408073245520501
10306000408000700050500030800070000000300030500050800020700070002000500040000040701
10203320307264625845687280204078577620502240707830886080405226502030887380437020501
10600060608000600000000050406050000070202000200040700050800080703030000000400060401
10886060308030308023555040706020608020344044262054404040664030808733707872608040801
10007030800030002000003050804000303000400030600030007020300070800000607000602050301
10308020686734767588804030605252386085803240703230542020602430606220862030307660401
10304020005000000020004000800000005000300070700070007030800000200060000060500000601
10803064603057304820608377843736202260807020607085302050845423752736474860776678501
10405000703000806000700000000050007000304000804000004030000000000000300000800000601
10504360402350446020255424333050657676455843207570832044374670203363402042304250401
10500080600070000020000000004080000000006000200020600060000080700030006060002000801
10346050402070233580365843506043687240803360307058704738336030447030308880807754801
10008000402050000060000030002000000080300080805000400000300050005050806000603000001
10207545463060374086274070606634543057334070402330858560303454203070284020308023741
10308000000030300050000070200000008000003000800020002040600080006020007060205000501
10204063706680808287768580364375504486404084322042407030376020576087806085603570501
10304000400080200000700000600000300030006000006000400030000020800060005000403000801
17608680422080556650608564702670707060476386766832423658768020342320662380206044501
10003000400060005000404000006000707060000000004000000000002070300060000000803000001
10262070808345304080604285447080705063258828405063344834703720203087322887525567501
10600070200000505030300000000030808000000050007000700000700050002000000000000000201
18407063635077307060508454867885803547783060502633504080374020825575826226875450461
10003080008070003030500000007000400000005070502000806040400080000000000000000080001
10787270202080478040228540634050786325646080428020703060405070482545575638353058601
10000060502060004050800080700030000000600060002020006040508070000000005000003070001
10335058802782803077706030602735233060503646607083862630306063508843326070773080761
10008060006000306040008020807000002070203000008000004000506000400060003020300050001
10606020342080306040402088202040207020747078352825205045203520262670706054805488801
10603070302050406000305000002060607050007000700000205000007020600000407000003000401
10803080205030803665544552832050708260806530636460205756528080207054603078255022301
10807070800080008000004000000030700080800060000000300050000050005000502000004000501
10205080502432242070606052338340805057676082278326423080834086882858302078838760201
10304000500000007050302000002070404000002060000000000060008000300040006060000040001
14408032825532745060303873603080504563307050836756635364604050602040402870305074861
10005000000000700060500000008000500030402000800000000000005040702020305000205000001
10365268572445707020762073686523245070406248504072507876276030807050484036436784801
10000000003000605020008000000080000040200020004000800000400070008040000050003000401
10756832603060504825805065742060205570202020205550555430702782253058563360304030801
10003000500070005000006000200080606000602000305000700000300000008000000000803040001
10802053803580525064423360802530728078505035806054555057463454804062747635682024681
10203000400070002000000030200050003000208000507050003000600030002000000000300060001
10804560338054607065262077653033307470602573708080504863307040734078564380404566201
10500070300080003030007070004000708000203000807080500000004020008000500000600000401
10256050425575355042507070506760805088257040848040225555747084503070304253468820301
10800040000000002000008000504060600080003070006000204000600050004070400000000050001
10403823253635307067586345708060838820705364407467502070507370522070708238728083561
10205000000000803020000000003070002000500000402000600070003000700070806000003030001
10407020704730602770373276876083503040874570808870803478843064604070405057852055801
10500080600080600000500000000080008020002000300030406000004000204070500080008000001
10586730488370803666402867208370647020502076245040304077602520503870554420204777501
10003000200000603000004000600070200080708040003050702000700000600050000000200000801
10403644504555736078254070528430204036504040504080835430268487627037407687487860201
10400000200000000030000020000060705080005000200080000030000060008000305000000020701
10336460236534673780373828467060706050385856287684453046208060603330622060847050381
10000050000000000050000000605070606080005000000080005000806070500030000050005050001
10484038234280656037686580302040408024302076204020244820444044475030454546405045701
10003030000020008000000050800050805000208000503000200020007000000080600040003030001
16503075564078504454306030622560402070807260602063406072604072228880608050343040241
10005000003020007000807000600000508060200000506000206000505000000020002070600040001
10308366704080547080373042204468705530266373707775305350202045587067553720508027201
10708000800070000070003000500000002000500000603000003070003020003080000000203000601
10348050507525224586208676667744853038603020247078437023242640203050832664606644501
10000040600050000000700000000040000030005070003000006050000000800060800000006000001
18823380445020226780206532747040504850387848705267402047464886754540406377535042321
10000060707000300000700050008080800020500000200000606000000000000000300000500080001
10775650505447603482667050575070255750804472888520302733667755647866286670606752701
10000000600000004000000050000060000000400000000000300000000000000000000000500000001
11111111111111111111111111111111111111111111111111111111111111111111111111111111111
