11111111111111111111111111111111111111111111111111111111111111111111111111111111111
10000030000000008000006000007000000000000000000000800040000000005000002000000000001
13708052422350303060535080207040248436205235885860605060408654704073207040658085701
10002020000000800060800070302030000050002000400080008000800000300070202050008000401
16652020725035867720303550302066755080838030406087367084752540503550506040804720201
10000050004000400000408020806080000030300040707000002000004000300080005030608000801
10287654406620607723204060204020727570402520567548503323604055655383868070703033301
10007000004000700000002000700040000020603080000050002000008000000050007070307060001
10804040285073874862373744404856783030303050275030263028346455556030806080705086531
10600050002000000000500000405000704050006060600020003000000000003030800050604000001
10758525884542743440406630765070603066853060704038207052605478207050604750705562501
10000000000040700000300030003030006000000070302040002000807000004000600030700000501
10437637486020207445337042404074604638652540304650673080402025575488352050226780701
10700000008030207000006080305000200000000050500070005080503020000080002060000080801
10608055207080305020807020807820583657544020862060208680242040824035307085627730701
10508000604000700020300020400070000000700040700080200080400020008000500060000070601
10702260708378386487568640303035234340304460202840856050702528406020824660763060601
10700080404000300000000030502050000080405000800070800050300020202030000000400070501
10484070604060408038483050203040706080625034748083605040387080602638308878305030601
10007020800080008000002020502000307000400070300070005030600060700000306000205060201
10507070846657526877404030802773376044606380703220736050208230703530748060405750601
10302040005000000020008000300000002000400060400050003060200000300050000060400000801
10506073605046207640208434536846303220804050803024505080275268554342428530757387201
10402000806000707000800000000020005000605000405000006070000000000000400000700000601
10602420304470453060287348564050432276272846804720638036854230608782804065808530301
10700070200040000070000000008040000000008000500060800060000040700080003060005000701
10677030302060555470485234406053728550303240802024304356346060525030608460805436701
10007000205080000040000030006000000060400060804000200000600050006080707000705000001
10704546724060425035638020708383583087537030808370288460502228603080264060403088641
10608000000020400030000020200000004000002000600080003030700040004040006020807000501
10204067407780406722745550387783208485706078274066402020526030324087502086404650701
10404000400060700000400000700000400060007000003000600050000080200020007000308000601
15607220756050828850604634206230202040778885556473484625652070846270425520603062501
10006000300040002000202000002000302040000000002000000000003050400080000000402000001
10242080708567803030604372835060402056236234802083342738304240403086465547358276401
10800020700000503040300000000040405000000050002000700000800070006000000000000000701
15303082377034504070707626733872303624833060708355206080688080528564532275673420881
10006020008050004060200000003000600000003070807000705060700020000000000000000050001
10757480704050526080538850346060227787828030334070307050407060686337786443284086601
10000070708080003050400030800040000000300020002070004060707020000000003000002080001
10662085407844504058304020202856787040604745302043248650306056704484357060534050581
10004040003000405060006030208000005030808000005000005000406000300060004040300070001
10803040772030302040607052807080506050762037832582307026806670334850704063502547501
10408020407080205000804000008060406070008000400000805000007020600000806000002000201
10604080603070604847724482765020206640603470488420708447848050708076705082835048201
10208040500080006000002000000080300040300030000000500080000020005000705000002000501
10305080307853442070405084535370307052535056846274258050464072332548703075362340201
10503000700000007080202000004060303000006030000000000080008000800070008050000070001
18703063732885358060502638507020306348408050683348837583303060403070707830706087831
10008000000000800080600000007000500020305000600000000000004060804020705000508000001
10637637282338202040434055752882324050504773404043604732644030803030877063335545501
10000000007000803060002000000050000030200070005000700000800040002050000060007000201
10774283807020404482306023248040704760507060507330425730803274625076433330507050401
10002000800060005000007000500070802000507000208000400000800000007000000000406030001
10604027304380456062324570405620763083402025503083626032584587408067845332678078381
10506000300040008000000040200080006000508000205030008000800050003000000000300030001
10502780468088303046353043375025207730708482806070308332702060526063826660403856501
10500060500020003080003070007000402000207000207060500000008030008000500000700000701
10444050888577232072806070206520604047634080876020683345887065307030606566865450501
10600050000000003000004000508040400030007080002000306000600080008040200000000080001
10803665767465202027637747704070788740307763207525404080803670877080204667836082551
10206000000000604080000000006080006000400000406000500060003000300030606000002070001
10202020507340402530355447288038607080563750704430405448346078606030806077745068201
10700080200040700000700000000080002030008000300050602000007000302050400030008000001
10557250377320206423702228405460877070407052657070606085503430602680266350706786801
10006000300000402000004000400050600050505080006030508000700000700080000000400000501
10806772307437758062524070625440305023205070306040545650382642238045702524724820401
10300000600000000030000080000060202030004000700040000080000050005000708000000070801
10453670248833252580263564657070702050373745255534344082204040707830463020266070751
10000020000000000050000000404060405060003000000040007000708030800060000070003060001
10648057254520562037355540806030703082503023802050245460784055884030682366505034801
10008060000020008000000020500040502000408000605000600080004000000060200080002050001
15705057627057207572507060838670704030704560603066307062508048283670702040377020671
10008000007080002000206000300000608070200000402000203000204000000040007080300040001
10803572507060843080528057408584608450828563308388807630207044875056287560802032601
10802000600080000050004000200000005000700000407000007080008060004080000000803000301
10826060206272246264605245866384546052503080876067774087565530406030462868603643401
10000020800040000000500000000060000050002020002000002080000000200020500000006000001
12536470734050644420602882823070706670746887403732406082268435764830704448757047471
10000080704000300000200050003060200060500000200000303000000000000000400000600070001
10565350808552402628623030875040382270503356673250702325334344684873344260706528501
10000000800000005000000050000020000000700000000000500000000000000000000000200000001
11111111111111111111111111111111111111111111111111111111111111111111111111111111111
