11111111111111111111111111111111111111111111111111111111111111111111111111111111111
10000070000000002000003000005000000000000000000000400030000000005000006000000000001
17703054445650407030434080306070876663805253222760504050405683604063802080255082501
10007020000000300050500060807060000070003000500080007000200000700030405050002000701
17428040327068562860507650702057577030875080404024827025253560507280706050504350801
10000080007000700000703060808030000040600060308000008000005000700040005080806000601
10888342606880505683205040708040423830404670555837608523702025756428727040308083401
10008000003000600000003000400020000040404040000050008000008000000020007040806080001
10805070646036656463767443608856845070702050656020654053368852666030707040207025651
10700060003000000000300000608000502030003070200040002000000000007050300050305000001
10573774332887526470306540674080807055552040508038806088502478508020203650206464301
10000000000060700000800040004080006000000050408060004000607000004000200020200000501
10568842284030605456252027707047505333232270804450547060302023434247673060523230601
10500000003070205000007050408000600000000020800020007080508050000080008040000080701
10308034604040607060602030805460773827757060738050205370876030525034708044432430301
10302000304000800060400020500040000000700070600020500020300070003000600020000060501
10802380602654237574764420606084828840607220704260564050408482404030527730666060501
10300070804000400000000020507040000050403000700070400050500080608060000000700060701
10868030804070502034484030408080402040322022626084806020374070708582704322602070301
10006080700050006000003040406000808000400070600020007050700060800000705000603060401
10504060264887662833406040308574585034407220203780624070208620502540743080603240201
10706040002000000020007000800000007000600050300030007080600000700080000070200000501
10503023207087407380503724457637606670806040702072203030775556843573243250477767701
10706000304000707000300000000040005000807000603000006040000000000000200000200000301
10704750208630675060364224856040563674465323705240442085347680602258305066804380801
10600060700020000040000000005030000000006000600020200080000060300050002030003000801
10247070507050286850575282403032228330805640802047402638622020682080603240207353601
10002000402020000040000080005000000080600020803000600000800070002050804000804000001
10507875226070843028528020702833834086527050202680785660505572802020773040707028471
10502000000060600030000050800000004000008000800030006070200060008070008020506000801
10703044704750307358235780456327706756502048464082408080832020645026705077405580701
10802000400050500000700000800000400070002000003000400040000040500080006000605000401
12803620527020353840608867708550503070754658626224774733432040584650446860807078601
10006000700070007000305000006000408060000000004000000000006080700080000000204000001
10836050505243308030204355345050403074458555504087673887308670704085562254382838201
10700030200000407040700000000080504000000020004000800000800070006000000000000000201
16508055787054404080405334578622708534566040704577608050823060636777543866332340521
10006040004050004030700000002000600000007080805000406070500040000000000000000040001
10533270203020477020262660346080232727825030444030704050502020548356363776823072601
10000070806080007030200020200060000000600070008020002040405080000000006000004060001
10765035506222408034704040403884658080706868703043378350705078304854526080366080281
10002080005000206080005070603000007040807000008000006000504000600020008020700030001
10206070632080702040404063803070204040552045735623705028608720646470804033204285801
10508080705030402000307000003020808020003000600000206000002030500000604000002000701
10207080807020608387384223486060404670308620587840503735662020502032302046436073201
10303050700060003000003000000040400080600020000000600070000070004000306000005000501
10207060303372633080702088862670406027458032385546854040672074355365802025783580301
10202000400000008040803000006060702000007070000000000070002000600060005040000080001
16603034462876864040708554506070206583702030853425633627208060505070604340705036421
10005000000000700050800000003000600020607000800000000000003040704040803000808000001
10878865633638805030436022848266244040204737603048602837276040705050357082632374501
10000000002000403020002000000050000060700020003000300000200070008070000080002000301
10346287706050306647403068888020507570606060206820523230203658426072275470508060501
10007000200030005000004000200050802000305000502000700000700000004000000000302080001
10706046405250773084753560302360576035207024603057327024767866505087384882752087621
10405000700040008000000060600030006000205000304060007000500040008000000000600080001
10708730774087607042373053387083606420306836305030702588607040666055224240306724401
10700060800050002020003080002000703000407000402040400000003020004000800000700000701
10434020727867766073504060304850305044447070437060432755843032308050603723872760501
10500030000000005000006000807040400050006070008000304000800050002080400000000070001
10205262824677307066332657408040258630405378405437407040405830766030206625845068871
10506000000000502050000000008020003000500000707000800030007000300050302000004020001
10803080505650306470325556447052705020663720202560703374477027502080307054423042201
10800020800020700000600000000060004040002000500050205000008000308030600070007000001
10324880885330708246703674303740525080408028564080606072706250503350528230507385201
10002000300000204000005000200070600040807030002070505000500000800020000000200000301
10208724807223752075382080375880607035504060602080868540564764872027604262672720701
10600000300000000070000080000080202070005000700040000050000080005000407000000030801
10876330667777324540345282866080308070275474552725837044308070708620738070426080281
10000030000000000030000000707050404020008000000020006000503040600070000020006060001
10835046532260454085357830307080407078402047808040355530274078234030226726404084701
10007050000040002000000050500050303000508000808000400040005000000050600060003080001
16804057268037408838803040523580402060705340603074808064202034543860702030337040831
10002000008020004000703000400000502040500000408000703000807000000020002050700070001
10702445403050637050343058403475404320473464307645808250703076623027225250506084201
10702000400080000070007000700000002000700000305000007030004030005070000000605000601
10738080803577764843306767342852234065706060373028484025664870604050634567405835501
10000050200050000000500000000070000080005020008000008030000000200020300000007000001
14336520344030687460502444834070402220256766202228406022547442478570807526426066531
10000030607000400000200080003020600030600000500000604000000000000000500000200050001
10276620208538405637573080647070753440404485468350708685226422544867535760503633601
10000000600000002000000080000030000000300000000000200000000000000000000000500000001
11111111111111111111111111111111111111111111111111111111111111111111111111111111111
