11111111111111111111111111111111111111111111111111111111111111111111111111111111111
10000020000000003000005000004000000000000000000000400030000000002000008000000000001
12607077848880407050742080307020844657604356858550208020708475706046304040882047201
10002050000000300020400080807040000060004000800040004000800000700070403070006000601
17324080457037722560505320502024754020544020402057536078688850705660802040807420601
10000070005000300000405020404060000080700070402000007000008000400080003080608000301
10652734802780706835505080607070436770705630683634505478604073555337562060804027301
10003000008000700000005000200020000080408050000040002000003000000070008040605030001
10606040557023658272655232202688666070703050365040586084666484843070302040608057781
10600080007000000000400000204000206030002020600040002000000000004020500050208000001
10335255324866686530306460477040504063854080203047507073205243808020202440305787301
10000000000030200000600070006030003000000030202080004000507000007000600060500000201
10674725227020308778645085403055407546555780204250473020803036583536838030234650201
10200000008020405000002030804000300000000030700070004060708050000070006030000030701
10504058605040403070404030308550352262676050733070607680444060775076504032532720301
10502000402000700050500070700070000000800020500060300060400050006000300040000070401
10707880804257662824784320402085276640406750305830655050305486706030888620473070401
10600070408000400000000030706030000030205000500020600080600030706030000000800020301
10546030703060304053333080504030703080543032632038504040556020704778808374405040801
10005050300060007000006080305000803000400030700070008020600060200000707000207030301
10207030468233558652206020503448337088308340408420656020802440707370842020208350801
10406060003000000060008000300000007000400080200060004030800000700060000070600000201
10504052503064705360805564327388705630505030408037605070487837333866835420478745701
10304000607000303000300000000070004000302000707000002020000000000000300000300000301
10208240807230375040788443625070645266425575708430754027874740705284502062303660501
10200020300060000060000000003070000000003000700080700050000020800040006050004000301
10758070603030468820332468607024456460804880403063303288852080355070704370404227701
10005000207040000080000060007000000060800050302000600000200030003050507000708000001
10604538876020333042666080204267762057824040408420736370604333403030454070806046681
10305000000060300060000020500000004000007000700070006060200050007080007020804000501
10406054608520704838573240574683502867606027347068602050486050638024306084805630401
10604000400080400000400000300000200070006000007000300070000030500060003000402000201
13504260432050277280503577306770505050445623256843746688833020485740823350502048801
10008000300050008000704000002000206040000000007000000000007050200060000000402000001
10535020702885204040702258683050708085655342804076433744802820508043688675387524201
10400080800000603070600000000060506000000050005000600000500040004000000000000000501
17802046632065307070508787454427407248284020504326506040536060462435463373723660731
10008080002040002070600000004000400000005070404000506040500050000000000000000080001
10877280502030632030873840623050358668885020532070304060708060733473246484772077501
10000080207060007020800060400030000000800040008070004070406020000000008000008050001
10225026802532306083606060505627354040505878404035574450608057804453482060488050381
10007070007000608080008020205000005080608000003000005000807000700020003060200070001
10502020483040207040304046603060205040664028224682305056308550478750605063702775201
10604020302080402000806000005070807070005000200000505000004060300000607000008000801
10807020202040406224723387873030402460606480885860703437727080706044204058323058601
10606080400040005000007000000050200070800060000000300040000030002000203000008000601
10508070706637777040705058334270507034622082566364484070254052542745503068377230401
10304000500000008060208000007050305000008030000000000060004000300080008030000040001
15504073343347465080508558304020702584608020834255358858208070704060405440604084331
10005000000000600030600000008000600020606000400000000000008020504080507000705000001
10824533882442308060772086532725272070704456405068403758635020405060887036385756501
10000000007000805060004000000070000070700060006000400000500060002050000080005000701
10665867305060406676307044745030402240205020206650646580608726378027584830507050601
10008000400080003000008000700070607000507000608000800000400000003000000000702070001
10208036704230843083674720506450564082804022706034668062466825402043464758275046571
10205000300030003000000080200050007000405000604070003000800040005000000000300080001
10504630342084407055456036632062202820807856503070504755206060378054862720705643401
10300050200020004070008040005000203000406000503070800000003070005000600000500000401
10783080234273252087204070404630607063733020788070463238564056607020707538645350301
10200050000000006000004000406030600060005030005000804000300020002020400000000030001
10806377724758207043653632306060876550204436708642604060802370883040702576342078251
10403000000000306080000000003040006000700000304000300040008000300040508000006030001
10508080805760206760548348432055307080757270705840706443857077604080705046244076801
10400040800040200000700000000080003060006000500060505000008000207080500040004000001
10655230545550305522707558205880882070602087485080302086607560508230347550306524801
10007000500000202000007000500080500040704040003080202000200000500040000000600000301
10508642307565426033626080685630403074703030803040832750356825675082806246763780701
10400000800000000040000080000070802080003000700080000020000040002000503000000080401
10587720626766743450684737262080305040855765336687656057204080708880838020662080371
10000040000000000050000000604030702080008000000050004000703060300020000020002050001
10775043587580626054367780305030504084504084608020286750252087638040448538408076701
10007040000040005000000030200070802000307000607000500040007000000050700070007030001
18602047753035704377707030547270508040404240206022308054603028887520403050686020341
10005000003030003000607000200000407060800000504000607000703000000040003050400060001
10703347304020654020857078502342502450563287305282404450203034526072773560605065701
10305000700020000040006000300000004000800000702000006080004070005020000000808000701
10588020303372885467808377275644374075802030354067435086744230603050365648504348801
10000070700020000000400000000080000060002060005000006070000000200080600000005000001
14552580874020838630603748447040208650462265305753708046535877564220307234588023261
10000020403000400000800020006060200080700000300000805000000000000000600000700040001
10726360403877607626328040628020532850407274643280303758745857222348725520702444801
10000000700000008000000080000040000000400000000000400000000000000000000000500000001
11111111111111111111111111111111111111111111111111111111111111111111111111111111111
