11111111111111111111111111111111111111111111111111111111111111111111111111111111111
10000030000000008000006000004000000000000000000000200060000000006000002000000000001
17204044357650603050724050404030377742507754435420306030205756404035405020874075301
10003070000000300050400070506040000020005000400020004000300000300050404080002000601
13528040852022482520403350305068257060564080303027322066636420303330607020706380601
10000040003000300000304080605060000030700080706000005000008000800020003080407000601
10233882607270306657407080204030327460705230847633303644204077535367636050508072701
10008000008000600000004000800040000040503060000040007000004000000030005070503080001
10805040637056386836755752502675285070507040425060483028785333467020806020407073341
10200060005000000000600000507000806030002070300030008000000000005060400070504000001
10643646376478652280503370857050703044282040703074808043808887803060807320408632201
10000000000020200000600040002040006000000070608050004000503000003000500060200000201
10535433478070403444235038305053504378753430505820387060204036356656884050558780401
10500000006020402000008060307000700000000020300070002040503040000050008070000060601
10408083804020608070208040803530328465247030527040708360672070788085803024843370501
10408000607000400060400030300040000000300080500050500060600060007000400020000040301
10508320302872823654277530805027657480704650704430668050208844203060878540543050501
10500060506000500000000030807030000020607000400070300080500040504040000000800040401
10837050403050403076374070803040707060533027368022804070783070306685607728508020201
10004050200020005000005050404000404000700070200050004070200050300000307000806030301
10306050338764677688604020303656365076608760307620552030303270606370768020203460801
10508020004000000030006000700000005000300020600040004030300000400080000070300000401
10308044406078406530302752878676208570305080202075704080275552255637468320462865501
10605000604000303000300000000030007000504000404000006040000000000000200000300000301
10702830506720657020252786345060268723722787703550844034627460504362304076402320301
10800030200080000060000000002030000000005000400080800080000020400020008070002000501
10335060708080275450625488808064284540706840305067205555843070268020502230205335501
10008000608040000060000040008000000060200080408000700000600020004050604000804000001
10202442843070527024862060808767788035845060405720282470405278402020654030307078651
10303000000080800060000020700000008000004000800060006020400050006060003030207000501
10407063607330803452255660485276306237808067743084807060546020552047407068707320301
10706000700020700000200000300000200040004000004000300060000060500020004000204000801
15206820825020832860806574503730308070782383473546884822522040552530744340606076601
10006000400080005000808000002000608050000000004000000000004050300040000000308000001
10836080205368808070702852776050803067546362704076228438505250205058247736855743801
10800050800000603040600000000040504000000060003000200000600050008000000000000000201
17707026245046705050704246432378602627825070307733202060838080228265778353862230631
10004030004040008080600000004000200000007060706000208040800040000000000000000060001
10834620505070683070755780442080243578453030567020307070307040886342422644426047801
10000060607070007040200060200030000000700040005030006070405020000000002000003060001
10732076304242207087604060404663625080707862308075748730603044704378573080825070751
10005070008000803030006040205000007080807000003000008000503000200060006050400030001
10303040543030808040202053507060303060287087546875803066207230335460802045405436801
10403040402040703000303000004050705050006000700000505000005020600000507000006000401
10307020404060604746872876733060502360207780775740408636275020303027507043484035601
10505080800080007000006000000060700070400070000000600070000080007000405000003000601
10402060703683524080307055427860404023573027676568238050858042564784502068872360701
10406000700000002070802000005080502000003050000000000060003000300020002050000040001
15506032288743545080506446602070303343308030576422344722403070404030602260805022581
10008000000000700070400000008000300020703000600000000000007080808020803000305000001
10266837646625702070336077345778524020402277302075608828847020202060887078353824301
10000000006000504030008000000030000040200020007000300000200030006070000030006000501
10383627702050602872604083667080602440508020508460383750507857675066522840202080401
10002000800020007000005000300060704000804000203000400000700000003000000000802040001
10405072705430822024787560606540647035508022407058266037757424506032643835838038781
10204000300020005000000020300050005000608000406050006000700070006000000000200050001
10306770586042803044476042868037707620302634204030802484607060752025228230707553501
10600070200030007030004040003000304000205000202030700000005030003000600000500000301
10865040775484383075703040206320807047224080653080437366744085803020402748735770501
10300020000000005000002000303070700060003020004000705000700070004060800000000020001
10404726752735604058242352305060834380802673506524702060504340624080203864728085451
10305000000000805060000000006020008000400000308000800080008000400060605000008050001
10802070607860502830383646786035604030366820806370407647542044504020503027584076701
10300070800040800000700000000040004040005000600030305000008000206020200020002000001
10475820538420703777303426507520268050402033863070408047408640304880283640402344201
10008000700000807000002000800080300030806060005030705000700000400060000000700000401
10602766807872452065277020387350203074208050403060382670584647766036703858832670401
10700000700000000040000060000070705060002000600050000020000070006000602000000060501
10284560573557884370778533528080307050277533645327353045304050803680625030535050351
10000070000000000020000000806060606020008000000080003000203080600070000080004070001
10375043253250823032586830404020306028402044506020866560736076855050636583604026701
10007080000020003000000080800020202000305000408000800050005000000070200020003020001
17208055354058405377404060433420707050302320203053505076807048634630602080747060751
10007000005060003000604000400000304050500000208000304000402000000060006030300040001
10405758404020377030567043502274803270278683605437406740607083858043527230708064201
10406000300050000060002000400000007000500000602000005040002030007050000000707000701
10755020404344662343802866663328548025705040285028555066228550203080322337703386801
10000060500030000000200000000070000080008030007000008070000000500080200000007000001
16438630545030588880708646545060404720757273504548606058773427784670205754355087361
10000060604000800000500030004050400080500000500000703000000000000000800000600030001
10665670402723603378744020464080348520604825648450204566653662542574572640802488601
10000000800000004000000080000030000000400000000000500000000000000000000000300000001
11111111111111111111111111111111111111111111111111111111111111111111111111111111111
