11111111111111111111111111111111111111111111111111111111111111111111111111111111111
10000020000000007000006000006000000000000000000000800030000000008000004000000000001
16204037633880503040772040802070448775404234864240507050704653606057805070668026601
10005020000000200050500080804050000070002000800080005000300000800020507020007000201
12234050452087828760306430806033673080453030805046738078476470506530504020302740601
10000050008000500000208030607040000070300020707000008000004000400080006030307000201
10722665505740306332305030805060383220307250237527207358404083634486356060807042501
10007000003000400000008000300020000060205050000080008000002000000080006060708080001
10302070848057272366734848602557648050807030258070884088728356764040405060807032581
10700030003000000000200000205000803030008070200080003000000000005040300030203000001
10724848237527573260605270387040508078456060307045804028308534308060205770804273201
10000000000020800000600020004020007000000080807020004000503000005000200060800000301
10645287572070708728488023507043503287555660305460674050203027578557436020677420301
10400000002020805000004020705000600000000050600020005050708070000030005060000020801
10808045203080708070502070205340657746666030733060604860536070682052302044334660201
10702000204000400050600050200070000000600080600020500020700030002000600050000020801
10707350308576842684737470704038563760507270208240464020206658204080534230562030401
10500040803000700000000030602040000050203000800050500050700020206050000000300060301
10835070402040403083762040203070704040256062382058505020247020608455204245408070201
10006080500080004000003070703000308000600020400080008050400020800000808000807080501
10604020442482532264204040202454284082603370503260874080507720808270274080308440801
10308030006000000020007000600000003000700080300030008060300000600040000070300000801
10504044805038203340402537438446506230706050607033602080623666862224688280783473701
10406000706000505000600000000020008000704000605000008040000000000000400000800000401
10304270507860884040668275688060264278522768307250348084583630703724708038306770801
10800050800060000050000000004080000000006000800070600070000020800080004030004000401
10638060503030885470765457402048265250408340805075403278247070267050304720204358301
10007000608040000080000070003000000060800050602000600000200060006030506000408000001
10407347477060642083654030308663733052532080704360445680307334203040358080504056421
10705000000080400060000080800000006000008000500020003060800030003020008040603000301
10202047205870504267376230467885307327302078652045302080235020776063802037703220401
10607000500050200000600000500000800080004000006000800070000020600070004000705000301
12504870665040653660208554404730404050652883344477567856543040682240385460407036401
10008000300040002000808000004000604030000000008000000000003030400060000000208000001
10386040806558605080402457663070608058322538608022456377404650808055423885387553501
10700020300000606080300000000080304000000050002000600000700050003000000000000000801
17504086322057507020404535435585403423545040807584408020526080646756442422322650781
10005050002070008060500000005000600000002020205000808030200040000000000000000070001
10665620403070743060868320365070355585378040248080404070408040442683484457235048201
10000020505030005020200020400020000000300050007040005030308060000000004000004060001
10268045405678308046503020702684287030804688803057584550503075507225265060383070471
10002030008000806040003040306000007080706000006000004000307000800080005060500020001
10808030455050607040704044405050405040778076236675803062305230786730705066803826501
10502030502070606000806000008040307030008000600000607000006030300000605000005000501
10602080704050502462228468552040508670308840667460506436624030806053303074264072701
10504040700060002000008000000080800070300070000000600050000040004000402000003000201
10704050802387522050708038272380803044584077842546428080442065328386804052878670301
10302000500000006060807000006070704000005040000000000060003000800050004040000080001
15405078336764754070406635305020502368702020464654454345302040307080202660606036331
10005000000000200040800000007000200070803000800000000000007060808020507000606000001
10225683384447406040473082737762868040708257704037208873332070204070768063283342501
10000000007000508020002000000060000040800050004000800000200080002040000080007000301
10432325207080302245705072268070307670407070506360853340402637772066366570605050801
10007000200030002000008000400080507000602000704000700000200000002000000000202040001
10208088506540226045648370503740478064807057704066554087455654202076367235735052441
10602000500060008000000030300050004000506000603050005000300040005000000000600040001
10206420526024207045846047623043402830303885505070205223203020624023557620303286801
10200070800080006030006020008000708000807000606070800000003050004000400000700000501
10632040754268782088303050303630208025873080832040555347887082708070507638323660701
10800060000000007000007000205020400060005070002000304000600080006080300000000020001
10307527565643606043325777502080286620807576204632807020503480567080706235853084261
10303000000000702020000000008030007000200000302000300080004000800060704000005070001
10808080505630202570646878822033202040333620705760803527784082303040405073483045701
10200040800050200000200000000020007040007000700060506000005000606060600050006000001
10252660672630204342603374508360633040605086757050805084403840204680753870704533401
10003000200000502000008000700080600050308030003030407000300000700080000000500000801
10207366307437847037388080624740206036302040702030442870346558675076505388268560801
10500000600000000050000060000040502070004000200050000060000050007000304000000020301
10523740238556648760355876775020506040278288766247627024703040207370525080452020231
10000070000000000020000000206080708020006000000020007000506060500060000020004080001
10444052636270437024433320507030606056402025705070336480236022367070343657807035601
10007030000040005000000070600050503000307000707000800040008000000050800020004050001
15703057254043203746506060873380706060503670703033702025506084868480602080864080631
10005000005070008000606000700000405070500000205000408000707000000070006030300080001
10704727606030685060626046603282203380537475704874704820204022744048666250803085601
10808000600040000020005000500000004000800000407000003070007080007050000000407000201
10245030307488875478405522885357357046704050783078256023423260308040555246802376501
10000040600050000000400000000070000080003020003000007050000000500060300000002000001
12247550423030322870507778355040302470845467507336705028888237427550602685334085541
10000030302000500000300020002040800030300000300000204000000000000000200000700030001
10288460302342803773473050342060674450402488483830705854742634846734445480807886301
10000000800000003000000020000060000000600000000000500000000000000000000000400000001
11111111111111111111111111111111111111111111111111111111111111111111111111111111111
