11111111111111111111111111111111111111111111111111111111111111111111111111111111111
10000080000000005000004000004000000000000000000000400060000000008000006000000000001
13306046284720306050356050807060573236507846768370203070304674402037707030438028801
10004030000000300050800020703050000040005000700030004000700000600040406070004000501
12458070736077563580606550504078235030662030703042763032575850504280208030603480601
10000040008000400000308030507050000070500040806000002000003000600020003060702000601
10476658208350704466204060205030672330504750624877204225202072728236526050407065501
10004000003000300000005000800030000070702070000060003000004000000080006020802040001
10303080774078823435646276508743485070602060776060538043778547277050802040205056771
10600060003000000000600000705000206020007080400020008000000000006080700040506000001
10623366625336637550604560346050607073443080603045705077507477207020706440405445201
10000000000020500000800040007030008000000050702040004000805000002000300060800000701
10544653847060702337238065705055807347334240308850242050705058278786353040274460301
10400000004040302000004030404000700000000070500050003080605040000070006050000080701
10405058602040603080405030503870458362472040723080508680448020635025707085558650401
10503000206000400060600020200070000000200020600020300070300070008000700020000070301
10808430408652465746284380506065784650808240803740252040503837307080283270554030601
10300040602000700000000070606060000070704000800070600040600030502040000000700040401
10874020208030202085357040708050405020235047457085705020583060302768506478805020801
10007020200050004000004040703000204000500060600030006040400020700000708000308060601
10205070358232823232706030503773775086703770307830226040708470707550662070202450801
10602020006000000080002000800000002000800030500050008060200000700080000050200000601
10403064305032505250702238284356604540707020806074704080252453856667567330688348401
10404000204000206000600000000020007000306000506000006080000000000000200000200000201
10406720405780736040535862885020248736734275208430688083244780504758407045205780601
10500040400050000050000000005070000000004000200040600070000030800080007060006000501
10525040705060886250862258308053533860805270202087706244345070755080402680307746801
10006000803040000060000020005000000020300020308000700000200070002070408000406000001
10508623284060372042386030303776237073764050308870847720702564404040532020404048421
10607000000070300040000020600000006000007000500060005050400070005070002050302000801
10608078803660203548874360656355504255608067875048605050657070637063608045302350501
10208000600080500000200000600000700020007000002000200050000020500020007000808000601
12206460362050548680705666602730802050533442767576244846246040264320534680802037801
10003000200080002000702000006000706080000000008000000000005070500060000000705000001
10682040806885405040307423758040402022687637406087582842405460703024722386688628501
10400040700000804080700000000020807000000040004000300000500030007000000000000000501
12407046563026705020305453484427605684533060507822204060487060533622263588576420321
10004050005030002030800000004000500000007030506000404020500020000000000000000020001
10427220804050384020384470764030354772255040836040506020408070737684825884278058401
10000050402070002050400040200030000000600080003070004080206050000000008000004070001
10788088207664605045703080706525274030707453605062467480307043802876223030456070431
10008050004000805040008060208000007060405000007000005000204000600030007020800060001
10202060288070502030208082405020408030372052868435302043503530286730503075202525801
10607020503070608000804000003040304080006000200000504000008020700000408000006000501
10206040504070606265876523424080703820302370422680605445348060302056208068246036301
10504020200030007000002000000030300030500080000000600040000030005000207000006000401
10405060205426757030307027644220307088562048422557464080378042884524403025723550201
10304000600000002020704000006050803000003040000000000020005000500060002050000050001
18508055486886723040705387604020303445804020252578258782507060303020703760406056231
10003000000000500040500000007000600020306000500000000000006060306080704000208000001
10332226464862404050483053454878548080607444702047207763422030303080532056888226301
10000000006000408080005000000080000070800020004000400000800070002020000040005000401
10866422408020505466205025464050203730606080208260554350802282737074667440602060701
10007000200020002000008000400080702000508000604000300000700000008000000000503040001
10608087204460755077627850306270733024402085308086572067652873403048754867225086421
10304000500050004000000040800070002000808000502060007000800070003000000000500030001
10607580223022707033523048274073402640406622608050504654706020328076586220402875701
10500020700070007040003040007000205000402000502050400000004050003000700000800000301
10645030346756435075407080206260506077275050535020625747366042403030408877526340401
10700060000000007000006000502060800030003050002000707000500040003030400000000050001
10504246547766305043885766707030725630402236506346703020205580638050504888887044241
10502000000000804080000000002050002000800000302000500050005000800040604000008070001
10705050702620705550826552526086204070873750308580704628673067405020604043336022701
10500040700070400000800000000030004070005000300020402000005000807040400080004000001
10666850232730506437608334708250723030303032343060604032406660305520625830705338301
10002000500000802000003000200020200040503020003020602000300000200060000000800000201
10302482203724665034722040864650203054503050503030886260224874572022207834767540201
10600000500000000070000020000020706080006000300070000060000080006000706000000050301
10857560553473875850623632764050207080623543553822788033503060505340422080278070261
10000040000000000030000000406060408060002000000080002000807080400050000070005060001
10882027342530678072844820708080803086506025806030688440334037523040477385704025701
10008080000070002000000020200060704000405000408000200050005000000030700020005060001
13505062263087604872706070533580508080405540704027603057305082754260508060843020331
10006000002020005000508000300000302050500000803000408000608000000050002020400030001
10703486405020867060864058804446603730322345803458207670704062262035584240504027501
10803000400050000020006000500000005000500000304000004020006060006030000000803000201
10623070203622245333202848366777823048207030877088748035484680304070625323203255401
10000070400020000000300000000070000070003020004000004040000000700040200000004000001
15338650383080846780506582477050505640568474706233206054383788365770407557727047821
10000030204000600000600060006030300030400000500000708000000000000000700000200040001
10565780205578407378684060786050584750605883588880203772642527643648286480403857701
10000000200000004000000070000050000000200000000000300000000000000000000000700000001
11111111111111111111111111111111111111111111111111111111111111111111111111111111111
