11111111111111111111111111111111111111111111111111111111111111111111111111111111111
10000050000000002000004000006000000000000000000000800080000000003000007000000000001
15608068336770503060566070208070636247303553382540605030505362507036207050522045201
10005040000000800080700020202070000030004000200070002000600000400020805030005000601
14226050322085425330507440703042556020248050508055762084228240304880503040205360301
10000050004000500000302060202020000050400020704000006000003000500050004020504000701
10452683207260707844202060805050834340608660578737303245808078536574386030704022701
10007000006000600000003000200040000030508040000080007000006000000020006040306080001
10402020866036722268878476405685566050406020658060885077223423764030804040607068321
10300080008000000000800000604000405070008080200020002000000000004080800020306000001
10327827764788637460807860236080708082638050502054703053408263702080604550505433401
10000000000080500000700030008020003000000070704070006000506000007000500020200000801
10865345455080205876362044608073602742665860807660654040507062256742823020785440401
10500000002070802000008020508000300000000040800020004080507050000060005070000020301
10203056504070508030803020805780482636572080625050708480832080325084508048375370501
10602000407000700060500060500020000000300060400040600040200080008000500070000060701
10506620304683673232244730705053354720305470805870358030303554305020642360823020701
10400080503000300000000060207050000030207000200060400040500030206020000000700040501
10453050406030507085363040508080804060228077344087308020534080602674707752506030701
10006040500050007000007040204000402000600050500080002020500030400000202000603070601
10308070542755825524503070504227265074302450604520635060706230305730566080305660601
10204050003000000020004000700000003000500020800080004030500000400030000020700000701
10606034803055704750507865475354606850806070308023207060533865563552343560823686401
10805000705000508000500000000020007000607000608000003050000000000000800000700000801
10402220708620552080876437553070277425652875702450538024257740708535802042502540201
10500040700050000030000000006050000000006000200020700050000050700050005050003000701
10345050704030523420782756404062263660507840206062506764886020768020302220807447301
10002000608080000020000080005000000070600060503000200000300030002030606000708000001
10208723777070288068847040505838638026567040308570462280504553307060837040604065781
10707000000050700080000030800000006000004000500070006050300080008070005050702000701
10304086204420704522344360737442205237803045857085306060388070246054204055803550701
10506000600030300000200000600000400020007000008000400040000040800050003000705000801
16804570362060847240706444507430205080338885634668642778443060552720228780407022201
10008000800080005000506000004000408030000000003000000000008060800050000000204000001
10246060404742202070204823277020603083662825802082664287704650706058524572333577201
10800040700000607070300000000040205000000070008000800000800060006000000000000000701
13702085263065407030803373784466405354472020804244403050635070766233776644423470261
10005040005030006070600000008000600000008050306000507080700050000000000000000050001
10278450204070285030488260846060222628842080528080206070703040377458248748845055201
10000070206040004040500070800080000000800050002040003060404030000000008000006050001
10635043502282402064503050208625255030308266406055873470305047207542427020225080281
10002080006000707060003040804000003030502000008000007000602000700050006020400070001
10805040568060303060802084802020707030526022723578302055404470664760307036606787601
10802060603030602000802000004030206070007000500000302000004060700000803000008000501
10304080305050608768256283437020406270205620237260206578628080407078204067332084601
10508040200080007000008000000030300050300080000000700070000050006000702000005000201
10707050506223527070803042872450305067666055462663358060285066364687203086622440801
10507000500000002070506000005040706000005050000000000020003000700060005020000060001
14202028557562226070508745608050708252406080328435423273204080304070204840205064461
10005000000000300080300000007000200050603000600000000000002050204020408000806000001
10684543828357304020286043277664878030404533208078506776488040603060343077624752201
10000000003000402050005000000060000050400070002000300000800070002070000070003000701
10562568508050206628604074246040705320206060806370388670208363672033536260203040701
10004000500030006000002000300020503000403000406000400000800000005000000000604070001
10307088604450524027547430407660572064508052702025787036785564807087856852266033851
10805000800050008000000050400040006000605000507060003000300040002000000000800080001
10304380443054703038343077363088308530205864705070306588207020728055663440202236401
10600030500070007070005060003000203000707000503080600000008020005000700000300000401
10433070867648285083208080803340503038584020863080358263762058402030603344424440601
10600050000000002000008000606020800050007020002000405000200030008070800000000030001
10704778723825303057384228802080454520405258304836502060803640674080306433374032681
10707000000000203020000000008050003000600000705000500070003000400030806000004030001
10706070402580806870257535435032303050578440204450703538643025506070704067744078701
10600060500060200000800000000060002070007000300030703000003000405050600030004000001
10784620822420405483602478202260543070807034736040502022604740406630782430207733501
10008000800000603000002000800030500050603040008020303000400000200020000000500000401
10303745806385866067364080225560605074303050605060565520235623876023203485357240401
10500000500000000030000080000050704070005000300050000020000040007000507000000030401
10782550756832388530774288436030505040345643737462744055302060608730234020754050451
10000070000000000040000000305080408040006000000030008000804060300040000050003050001
10286036353660387055246470304080508052207045708030282840565033285040442863307056501
10003030000060008000000030500030703000402000305000800060002000000020300020007080001
16806032855034602862703020547770405040503280406082704072507067763820205020774070651
10002000002080007000208000800000804040400000505000502000508000000080007060200050001
10608675403020435040748084806553306250573327808246404320705025742068662870402025401
10506000300070000030004000500000005000300000403000003040003060006080000000302000201
10338030404326776346505643767385446032702070864033257057875330506060688372508358301
10000050500030000000800000000050000040002040002000005050000000800050200000003000001
15873640332030687480308726756050608550878858402378603047778336466630807652772076471
10000030505000800000400040005070200070500000700000206000000000000000500000400060001
10877480804842303778458030682050472560603357824750203346287863534474634550802842701
10000000800000003000000060000040000000200000000000600000000000000000000000300000001
11111111111111111111111111111111111111111111111111111111111111111111111111111111111
