11111111111111111111111111111111111111111111111111111111111111111111111111111111111
10000060000000008000006000008000000000000000000000300060000000004000005000000000001
17204066645880505050633020602050238678603724273670802060206352705086503050277086801
10005040000000300050400030503070000050007000200040008000600000200020403030003000701
15283040777065538340704330703063656070883080308083466047575670303650306030607550501
10000070002000300000302030306060000020400080407000007000002000600080006030206000501
10736652707270205627504030602060248270405730467255503468607056625735883080706083201
10004000008000300000005000200070000060503030000060003000003000000040008070405020001
10507080523064372552555247802875248040508070672030352055565285584040403060205025461
10800060008000000000500000205000808070007060300080006000000000003050400040705000001
10587638563686644820808470347030505074478060403047708023207634805060704480506378301
10000000000060800000300030004080006000000070305070008000806000002000300040600000201
10576754345050308242325056503072606524285370202450824060805037477278274080277620201
10300000005040708000008070402000500000000050600030006040404030000020002080000070701
10808056703080602030202060205360622252522020235080202380257030555078408053862870301
10403000503000300050200050600080000000700050200020700080500040005000300070000070801
10302260204484686472736280407086764450408670508370255060503253608050754420763040401
10500040405000200000000080206050000030205000400040800030500040802050000000600080501
10253030508050708036772040507030704070736076335082206060532060808223304342406070801
10003020200020002000005050204000406000700030500060007050400050800000805000605040201
10702040225238626768607060803264678037605580303530582030807740805760273070807670601
10203030005000000020008000200000007000700070200040002080600000300080000070800000701
10502034402026507330204686462587704580405020704055803070345646442555684270266663201
10605000202000706000400000000060008000202000206000002080000000000000200000300000801
10607820507620432050648727778030874474386462602740873062253450407365804064604520801
10400070600080000030000000008040000000002000500050500020000050400030008080008000201
10655040604040778280625747605077368320506650302052508775648080728030606240704677201
10007000708030000030000040008000000040400050303000400000600030005040205000402000001
10405576638050746062264070803466363045673020607580425740303262305070563060605078751
10403000000080200030000040300000005000005000800040002040200050005050003030505000601
10805063705470507343538260827674306638303072827065408070366060774022602085603460401
10307000200030200000500000800000400050007000007000400060000060700030006000708000601
17406380487050883530505765803480603020428565443437537826352050868720877350307025201
10006000700020004000304000006000604050000000004000000000002070800070000000506000001
10663040405523806040706823254030405038767655604028825634507880408033358257374448501
10200020500000207030400000000020403000000020004000500000600070006000000000000000601
15202082335035208040303322777578803643667070805444405050768020762557585238433380631
10005020002080004050300000003000600000006020803000306080300020000000000000000080001
10335740304060632050645650248030726433478030443080307050507040243275223774684035701
10000040804040003070400040800020000000500020007060005020205050000000007000007050001
10453056408265702026406020504476484080302624404073523660706066503432373020234080551
10007080006000307080006020504000002070704000008000008000703000300080008020400040001
10602030838020803020203063705080304040584036284334305072405460388360705042802844501
10703080702080303000204000004030205070006000200000306000006060700000804000005000801
10502060302040806864577253438020403540705640888260406632677080704027602077322052801
10703050700020002000002000000080700080500030000000500060000020002000806000003000401
10206060307224755040704047834220307086236064273828688050643063483444208046534250301
10305000700000005080808000007020605000006030000000000060002000800040007060000040001
17803067237542757020702734508070308274803060684863558238502040605020704440302062261
10007000000000800070800000007000200060707000700000000000006030202060403000806000001
10826522276245508020734057433446473070706342303077403786847070205050848075333634701
10000000007000207020003000000030000070500080002000600000200050002040000070007000701
10534767604080608263708084382070406870805070802630326260206728482054645460508050401
10008000800060005000002000700030507000203000606000300000600000005000000000607060001
10305048802260323088473570207620886067207047708042337087267544202062378867585077421
10806000300080006000000030400050005000807000705080007000300030003000000000400030001
10804240382042605086866045282046707530405656805030602544804060656042355460306264201
10700060400030008060002070008000505000602000607040400000002070002000200000500000301
10633080576657777036802060603370607026586030475040255725867065408070608633455530701
10300060000000006000005000303050200040002020004000203000700060005030500000000020001
10502826554234407088647726307050738240305487202372204050306370532060805768855034551
10507000000000603040000000003020003000500000208000200080007000500040408000005060001
10602060405230307430558284334073508040432560405630205868642036503080606068227026801
10400060500040200000700000000030007060003000500030702000006000407030500030004000001
10868720347550306243204676408680456040505043675030505024405220406570232880403258701
10006000300000608000002000600060400050405050003030503000800000800050000000500000201
10607822305258738067484080666860403054802060604040673640438868624072604646855570401
10700000200000000030000050000040504070005000400070000080000060007000403000000080301
10378530788752754750754346525020403070348885736884385063506050702850658030875050371
10000060000000000030000000602040203030008000000050008000504060200040000030003070001
10765082233840586067444430806080202062808044605070346870854056732070732242605072501
10004080000030004000000060500030507000204000308000700050005000000080200080002080001
17306082646078604226305050666260603080805750704052202045805035375470406080768070371
10005000008050008000703000200000206040300000206000406000804000000080004070500030001
10708838503040746050885066303755402880242535406736407520708045228046845430306038301
10607000400080000080002000600000008000800000804000002040002050003060000000807000601
10423050605453255324306764766623835053207060545085738064843880302080624873305438601
10000070200050000000200000000060000040008050002000004020000000600030700000003000001
14655230486060855830208742872060808460365867403647802053355742673580504846327085821
10000050606000400000800020007030600050800000300000804000000000000000300000200070001
10222740403774306375233060352080273380307847837270404577356727538848584660204587401
10000000400000002000000050000080000000400000000000200000000000000000000000300000001
11111111111111111111111111111111111111111111111111111111111111111111111111111111111
