11111111111111111111111111111111111111111111111111111111111111111111111111111111111
10000040000000002000006000007000000000000000000000800040000000007000006000000000001
18507042448440203060844020805060574663403636887280303060502754406057704020532028801
10002080000000500040600060605020000040003000400040005000700000400060203050008000601
16644040262075356820205650303068348070863070202045575022667680202240308030505460701
10000030004000700000708030704070000030800050507000008000007000700060003030306000301
10434825605840207845608040306030444220408560277275502443404085355765538060302087601
10007000002000200000008000400050000020706030000070004000002000000080005070402060001
10202070832063884836276244603382844050805030542060372037755667657030207030407037461
10400060007000000000700000203000602050005050200060008000000000005080700070708000001
10274264268732328320608370767030303036827050304055504025707387502050602670305674801
10000000000050700000800070007080007000000080408060003000607000003000800020400000501
10334528362020307374768087507042805734222740203680363030302035632267534030568570601
10800000007040605000007040803000500000000060400020007080804040000070002020000080201
10405082404060708030705040202770843847433020526020705520342050264034406022582540501
10202000404000300050300060800050000000800050200020600060200050006000500060000070401
10808620607587768627662380806046682250308880703780272060603384705020235550338030301
10800020605000500000000060303020000030805000400030200020500080805030000000700050201
10625030403040602068723050606060408020543024767025505040552040304426405747603020301
10005080600040003000008050803000704000800070400070007050400080300000803000204080301
10808070858287842835805070804224588077507470602560635080803830707460583050402750401
10704050006000000030007000500000003000400040200030007020600000800060000050200000401
10406026403078603330407753757872808250506080202036302060772248658642626830883582301
10707000605000407000300000000060007000505000604000006070000000000000700000600000401
10306250604680522030866725445070446488243744607320768062344220603734404074502630501
10500030200040000070000000002030000000006000800070200080000060700040007040007000401
10772030702070272540526232405084653750306220402068705387558020256080802440608385601
10005000307050000040000080007000000070500050204000400000800060003060404000804000001
10205622347020746073637060203775287037785080506350327250804855306080364030404037351
10203000000080400040000070400000003000005000500080006020800040008030006070704000401
10802087703780805442677660667837803728408056656064603030464050243083806032607280701
10304000200060500000500000400000700080005000005000200020000060400070005000706000701
12202680477080748620605256505380803060828834266636548445643050844360746850706044701
10003000700020002000705000005000707060000000007000000000004060300050000000206000001
10377080303642602070304536722060508038264572402032586835607780603038465338257557401
10400060800000602050500000000030605000000060008000600000600030002000000000000000501
12704023764025407020808456538364504625383050306637702060373060357554433758475620421
10006060003020005070500000006000700000003050706000208020200050000000000000000060001
10666450308060286060534580227050752553554040768070304020204040234346852775847034301
10000080602030006020600040400060000000400040002070008060306040000000003000006020001
10667077407268503078304020502364236050205243207047853370706023208475758050822060821
10008060006000502050004040607000004030408000007000006000603000300040006020500040001
10506070535050205080802075506070605040248022382322204034406440655450608066306865401
10205070503080806000504000004020407030003000500000402000002030500000707000005000401
10207030605030204372323434433080604730704460346330207845453020508054308022435085401
10803040700060003000008000000060800070800040000000600070000070007000207000006000201
10403060206475736070608088648820407072753024884253725050533038684452405053724480801
10808000600000006040702000006030605000005040000000000040007000800080008050000080001
13504062842657548040608748406040505845702040544243566648805060205020802320602063831
10003000000000500020400000006000800080605000700000000000002070607060203000803000001
10288653288777508080276037874833348060504737302022502353255060308060357052678734801
10000000003000606070006000000060000060300070006000600000500070005040000020003000501
10374323605040707277205074647020806660605030406380454360508422286053482830807040201
10006000300040007000005000800080606000802000608000200000400000004000000000207040001
10206077405840558044865450604650573032806087708058852062355426207062535264452088781
10608000300060008000000030400060006000806000502060003000400050006000000000600070001
10507650564025305034373053257056406750808744602060406375606050256024877260405733601
10400060200060006060004040005000504000403000607050500000002020004000800000700000201
10243020578576747027807020307650606036335070575070344237446073702030603888785670701
10600030000000008000006000203020300020003040008000508000800040005060200000000050001
10402575367367308044653885607040647540805734807368606040502560373080806677463062341
10808000000000604030000000008030008000500000308000200060007000500060707000003050001
10602050202230802620823455322038703050563230505570503737557065506080706084866067701
10500060300060300000400000000060005080006000700080205000002000207070500050003000001
10523360854680706224402223406770585020502068878070808073706580502680735770803565801
10008000300000208000008000600040300040802050003060208000500000700060000000300000501
10303633503225837078448080253540402083307070207080826340237884654087306756853360401
10300000800000000060000070000030705030005000600020000060000030002000308000000040401
10265740646838882560647527386050202080465658465434832023605070507560243080453070851
10000060000000000040000000608060703050008000000060006000802020500080000040004030001
10634074486420648023537880206060306047302075506080238730786028325050484575806087501
10004050000050004000000040300070302000404000502000700080004000000070400050006080001
13602046737088802228307070673880503030205880702026307045604048854870507030768040451
10003000003060005000305000200000605080800000707000407000508000000060002040600070001
10504627502070323080277034305642302530276852705776703340803058666073652730205058801
10703000200050000050006000400000007000300000803000006020003050003080000000602000801
10837030504885628782305847535338532067404080782084836076372430206050866378306375501
10000030200060000000800000000050000030006020007000005080000000300080800000005000001
13527550747050774320403728644060807650477867808338207036544777866540602528684038431
10000050402000400000600070005020600040200000800000508000000000000000300000700070001
10882440304746205238738080577030325840504364622840203488586668578466885840504474401
10000000700000002000000040000060000000400000000000700000000000000000000000400000001
11111111111111111111111111111111111111111111111111111111111111111111111111111111111
