11111111111111111111111111111111111111111111111111111111111111111111111111111111111
10000020000000004000004000006000000000000000000000400040000000005000004000000000001
13407044887670805070485060602060257748808573364850503070805238603052303040624057501
10004030000000700050600070303080000020006000800070005000200000800030703060007000801
18763040628063426750302220407047877030762030504047645027478860707280305060507850201
10000020005000400000704040808070000030400060803000002000007000800030004060508000801
10548643606430805535603040507040552440802260554538502422403047778366554040302036701
10004000002000300000006000800060000020504080000020005000008000000040004070708050001
10505020864087247426463388407534828080503080227020376062454725624020802020406062221
10300060002000000000500000707000704030002070800070004000000000002070300070707000001
10383724334362868260207580657040706088275060407075704057603446308060602680505638601
10000000000050400000400050003040003000000020404070002000702000004000700030400000501
10688226237060705474682052807066607358746520502680564070208085574773776070235260801
10500000008020804000005050504000400000000080800040003040406050000030006030000080801
10403074204030306070308040604530572336726080784080703350385060655086302036762460601
10202000602000500020200030600040000000500060200040400030200060006000600060000070701
10408450306523724427738860706053838770807320604380832050403535808050778520448060501
10600060702000400000000020206040000060207000400050400040300050303080000000500080601
10542050803030305026753030504050502040786065645047804060855020204436407626707050601
10006020500030002000002060207000206000800030300020006040700060400000606000207030701
10507070484543288422508060204767234087206270304240334020203330202480337020805350801
10508040007000000060005000300000008000300080800070002050600000200050000020300000501
10602025603027607820505765478574708730304060502077302020487524536737654370647875501
10507000407000503000200000000080008000402000504000005020000000000000300000700000801
10608270404780335070488876526030325224837565707430653085826620607387608026703730701
10200060400020000040000000008030000000007000500020300060000070600050008060008000301
10587030304070686640658543608028687670808830307064505332765040482020507650503665701
10005000404050000050000080005000000020400080207000500000400040007080206000204000001
10307848286020426064252030503553835033377040504350853580205344706020773050508062581
10708000000060300070000040800000007000007000200050007060600080007060006050705000701
10505023802620802542235660253228303722308023748077207050383070276067603086807420401
10304000800070700000200000300000300070007000007000600080000020400050008000205000601
15505620387030234750607587302430706070482583432664254387454080728480473360702088301
10006000400030005000208000004000304050000000008000000000003060500020000000806000001
10233080308428607070508367583080804066627864703087623465602630802057854672378685401
10300020400000403030700000000050306000000070008000300000400030003000000000000000401
16707083537064508060706547457354207447247040404876505020268020743644364763445870261
10006020006030002060700000003000700000007060803000302020800050000000000000000070001
10724470504020544060554460382070436765323080568030703060206020484675433848265033301
10000040206060005020500060400030000000600020006030006080404020000000003000006050001
10874022504687306076603070306552266030502365808087655560705034307277432050224070541
10004070003000505070004020802000007050706000006000002000404000200050003030600030001
10302070823050402030603066206050703070735087835322405034703750778750703057606224501
10302050405020502000805000008050707030007000200000708000002020200000803000005000201
10302070203020204555666623856060506640803570748220607465762020303048402026568082801
10607030500080002000002000000030300070400020000000500080000020008000604000005000401
10303080606856837020307033835230804025364068538227582070362022542737505077374440201
10408000300000005020405000002030303000002070000000000060007000800040006080000020001
18608075857868478030407625802030607852702080466262373278707070205050208430203074621
10004000000000600030400000008000200080802000600000000000002030403080503000604000001
10545373872844608060756064776347742020403733208075403483737040408080468033353627201
10000000002000407080003000000050000020400070008000800000400080003080000060004000601
10238337705020608586308068845080705870204070302860755730408242663054248550607030401
10002000700040002000003000800080608000402000806000800000600000003000000000504030001
10504057508580338035488660507220648086505086806065835066865465407024358664886066241
10602000500080003000000030500060002000505000402080002000400040002000000000800080001
10307630855076807032847043465026804520406845406040504575302050255054452350502353201
10200030600060003050006070003000406000702000203040700000003050003000700000500000501
10563030744635253034604020208230406054375060854020237652384052206030708534828230301
10700060000000005000002000403070500070007050003000802000600030007030400000000040001
10408575445545202042853856802040277270508866404764503080608730667060307542765022241
10307000000000304080000000006020005000600000707000600020007000200020708000005020001
10507030702870305340782246685062502040567450703820503577754086207050302052676082201
10800020500040500000400000000040008030002000200070502000006000804060400060007000001
10845780724760505523204823607380236060704085863070805074506330406820232480408574401
10004000200000805000003000300080800070405030005040206000600000200050000000200000701
10503673605783675086654050458430302078306070706070224740466256458078802657387340801
10600000400000000040000030000040407030007000700040000080000030004000207000000020201
10355560244648443850337443678040502030757428363672657054805050705660228070468050631
10000030000000000070000000608070608070006000000060008000204040300020000040004070001
10553088585550443046265530404020406026507024404020276460737023487070483328607085701
10003070000020008000000060400040803000203000806000800060002000000050800060006070001
15308088422036804855706020522770306070408630704072506088503044782340407020543040321
10002000005030006000705000300000203030700000405000308000805000000040007070800040001
10503263308070334050772064607375403240226788603768304320308087877064487480406064501
10806000700060000030004000400000006000600000704000003080005030005030000000408000601
10648080808288527633305576253725853073304040286052454083373640604080783527303638301
10000030700080000000700000000030000050005070008000002040000000800070800000007000001
18654870365020728350702256724080308250732375203336607063225364867670608776458076351
10000020404000600000700080005030800060600000200000803000000000000000300000800060001
10746240202888802828783040448020236660402733822840508672854632382423464680607825201
10000000700000003000000070000060000000500000000000800000000000000000000000300000001
11111111111111111111111111111111111111111111111111111111111111111111111111111111111
