11111111111111111111111111111111111111111111111111111111111111111111111111111111111
10000050000000007000005000008000000000000000000000400080000000006000003000000000001
15503033246440208080236050407050432252705282764650408040405862705067202050322035401
10003040000000500040300030503080000050004000500040002000700000700070502050003000801
13226040238074762280404640807073744070732040507053436074864650604760705070503330401
10000040006000800000203060507050000080200070602000004000003000400030008040406000601
10868237705620503373308020302050647360402650636524608537802047474348225020803046201
10002000004000700000006000200040000080507070000070008000005000000040004070508020001
10704030274063242482287587304384764070504080282080576034338866623050704080407086781
10600080008000000000700000705000807050004080200060004000000000006060800080508000001
10728375623446683520502240665030602034862020304066505072302328208020308570305468301
10000000000050600000300070007040008000000080506080007000403000008000300020600000401
10874556585060608847757057703085407772786270203370387070506085858284454070475850401
10600000007060202000008070506000600000000020600020008070208080000050003030000060501
10205048304030608060606050208650773382633070482080506830847030355052503038788880301
10504000503000500050800030600020000000500020500070300020300040004000400080000080301
10304730405674623824654470202066352560505570508580477040207362506030284360774020501
10400050207000600000000070403030000050503000700060800070500050704020000000800050401
10542050503070707026533030402080804060822025387036306030533080702264705478303040301
10008080200030002000003080505000503000600050700040004060200040800000306000404040501
10603040225528587256802040206382576052202780607370454060302850702650365080204730301
10702050007000000080005000300000005000600060300060005020400000400080000050500000601
10408045702085205780602254244676708230607070503053202040753734573844626860773588701
10202000805000605000700000000060006000606000802000005050000000000000400000600000601
10504270306320444020788837236070473547566287607650346022828640702373505085406850201
10300070200070000070000000005080000000008000200050400060000060500040006020008000801
10773070708020578370438435607048285670802250606055406257263030742060503260606586701
10004000207060000060000030006000000030200030806000600000700040008060203000308000001
10807278654040785032772060507554622033722030303530224820308377808070565080704042281
10405000000040700080000050800000004000004000800050006050300050004020003050807000201
10808073705770402328658560826827704445802057855023504040534030374038205032507240801
10503000600030600000300000600000300050008000003000200050000080300040005000706000801
17506260763080757480503832207240502060463876673768756234427050534630862430802067701
10003000300050006000808000003000406080000000006000000000007030600070000000408000001
10725030502572505050706237242030702064734488704057837823304530303043535244327658801
10300050600000502040700000000070604000000020008000300000700070004000000000000000501
18605073754077603080204776242885406275472060606736708040647020436674835648436680571
10004070005050002070400000008000800000008050605000607060800040000000000000000040001
10683680703070784030572430585070854327242030266030506070608030727628528833534086801
10000020407040003020300030300020000000500040007030004040506080000000004000007040001
10672068407823208043206080803884368060308476604075484830407083803244785060755080581
10002070004000802050002040303000007060507000004000007000302000700020005030800020001
10303030846070304050506064303080404080484046874686804054202320834730606084208286401
10208080405030204000602000003050508070005000400000402000002040200000705000003000201
10608020804030703348422536285070705880603770584450708422464070705056806052488065601
10305080200060008000007000000060800050500060000000200080000040006000305000005000401
10205040702346268060507058736740306022333047767338327070476023466255703086575240201
10405000700000003070305000006040507000008060000000000040006000200080007060000040001
18307077773376247040306544607060207752807070486346257836404050802050205470302067631
10006000000000300050800000007000700050506000700000000000006030408070702000305000001
10543875258488407030878022847522635050208543805052602437747030306040834047345883501
10000000005000803040003000000080000020400040003000300000500020002060000020002000401
10556472707050703748302054674080305840608040502880736630803544767067523840506030701
10004000800020007000004000700080806000607000702000700000200000003000000000502030001
10304067703880636023555330702340277048802087504042738023268845402066745226385075821
10608000400030006000000030700080005000404000202050007000600030006000000000400060001
10505480823086202053872054773076603460405232208020808332402060535054786230307725301
10800060200040002050006020006000805000702000205030800000006040002000200000600000301
10843080235462232043405030408860206043826050768080873822455055504020703726632230301
10600040000000007000003000702020800040003050004000704000600080005030400000000030001
10706882862766703066376838305080245660507222607787206070507230486040708222776048321
10606000000000808030000000003070008000600000807000200070003000300070708000006050001
10504030308440705230584565428077407030245220204730205334572026403050603083442042601
10200060200050200000500000000040002080003000800080602000003000306050700020002000001
10737270334720306553402527504260573030505034824080705048604520704580665270505525301
10004000200000803000005000200040700030807070006030702000700000800040000000200000601
10405638703244554054527060236270704047803030602050475760255438636037204728634540401
10500000300000000020000060000080204070006000500030000040000070005000407000000030801
10557820473658632770576386567030402070287533252743355066602020405760666020885060461
10000040000000000070000000203060204060002000000050005000602060500020000030007060001
10733058784620472032328720804060506043807038805080748480877025774050446378506076501
10007050000040004000000020200020202000704000408000500020005000000050800040002040001
14707046367082206858306040823330304030505540207053504054205075835520403060632060471
10006000006060007000503000700000205020600000406000202000306000000050004040300040001
10708768805070327070246066508462307620426786505667507630403084868082733840802088501
10706000400060000080008000800000008000600000607000002030008030004050000000307000801
10453020602265467246603233782656534037204030667037537063645360307080524634505336701
10000040700040000000200000000040000080004030002000005060000000200020300000004000001
17758560367020472740207342885070304880735272204872508043764288743650505686554078251
10000030705000400000300060007060400020200000400000606000000000000000400000400050001
10466320308537406577473050243030642630705523553750308783578324574275864550205348801
10000000700000006000000080000030000000300000000000200000000000000000000000400000001
11111111111111111111111111111111111111111111111111111111111111111111111111111111111
