11111111111111111111111111111111111111111111111111111111111111111111111111111111111
10000060000000006000005000008000000000000000000000300020000000006000004000000000001
12304072474350405080673030507020432488705724883520302040502454303064604040683084501
10005070000000200070200080707020000040002000200060002000400000600030506040002000201
18564030853024545480402370408085875050245070607046272064533830402280607020504760801
10000030008000300000804080503080000030200040605000007000007000200050002030304000201
10366465505620504687302040704030442260204220672554308568406047632263547020507078801
10006000006000500000005000300080000050205020000080008000003000000030004080806080001
10608020378022465475443868503764283070305020665070846037455346734030204060808026271
10400050006000000000500000604000307060005080300070002000000000008070800030606000001
10877823368567466520405580856020308078375040205082206062303866206020403440806275701
10000000000020200000700070008050005000000050608050007000606000004000400050700000601
10766775624060503588364028508086703822327630606470427050603063542422358050387680401
10400000005040404000003060506000800000000060200070006020806080000040005070000020701
10507057303080304020603040604650648323856060228050602270675060747083608075876430601
10605000804000500070700020500040000000300080500060700020200030008000600080000080601
10303380503634865223542620605032533520305770806420774080808278306080227850764020601
10400020708000700000000070804080000020708000400050300020700020705050000000500050701
10352070702060308087876060806020208030474075538073702030434080507634208263607080301
10002020200080006000006050705000704000400080400020005050500080600000202000304060201
10606040568466538556703040305862266046305860702420323050504420402880445080502870401
10202080002000000020002000600000006000700080600030008050300000200040000050200000701
10605046806075504740606585784377207550807020405065404040444863424624345780442567601
10807000606000802000300000000070008000608000403000007040000000000000400000800000701
10806240806340523040752423647060733828588888604570533067564270408267704085508860601
10600030300060000060000000002080000000006000300040200030000020800060006080002000601
10563040308030536330457435208068575460202450203068304463227040448030807430203864701
10003000403080000070000070002000000020400030407000500000300080003030705000307000001
10202645275070466064732020507766353045877030707340766840606287404060863030706086321
10508000000080700020000020300000005000002000800020007030500070008030002070306000501
10207048303320607883636580642473604282306033322032802020866060274056708052703850601
10506000300030600000800000700000200030004000002000500050000030300070002000706000601
13505340756050573540707678305370203020557652865267627444882080676780747740403048501
10006000400040005000606000006000204060000000004000000000005070800030000000305000001
10358040408868302040207236374030803082662488206067674726603620505062535227853386801
10600040800000508020200000000030508000000080003000200000600060007000000000000000801
13307086262087503020406787782846406666564060302582205060348080668742322866247560721
10002050006020004030800000003000200000003060806000203070800020000000000000000030001
10554280602070634080473530477050886436568040528040802050304030237644533766658022601
10000020208050007060200080800060000000500060006050002060207060000000006000003050001
10855028608332706086703080407728575070203823204067528540407026805822623060575080521
10004050004000806040008030207000008050804000005000004000302000500080002060800050001
10402040878060304070605024607040203060452037674255808058707560787770302052705282401
10206050406080508000203000007040705020006000300000702000004060800000206000002000501
10202020603030503457865463822040808760202460683360702228325060603054705034636085801
10508030700030007000002000000050200040700020000000600050000030003000205000007000301
10405020802648336050804057785260303023443082837788733050784065372257607045487630501
10503000500000002070605000004050606000008080000000000020003000400030005080000070001
15604072837664833050806846505070707553303030223624843427302040703060308330302026241
10003000000000400020600000002000800060402000300000000000002030706040504000302000001
10655652786846305080424086368723864060202644506025506356265020607030378025326522401
10000000007000306020003000000060000080700080003000700000600050008040000020003000501
10848657705050304847803073287050608360308060708380236750304786828042552830404030201
10002000500060008000003000500030802000303000507000600000700000005000000000705030001
10803066504540434036848830602220276086805064503075834072872887608025457882648023831
10608000700060005000000030700080008000603000704020003000300030004000000000200050001
10802340846052508044433077436077306780503747202070508475408020726043248760307837401
10700060500030006050007040002000608000607000407080700000006070002000400000700000501
10433050588226638054705040506460307078354050283060737577225026705050704876268660701
10200030000000003000004000205050500050004030007000804000200080003080800000000030001
10208784888572704082452344303030763220408432203837707070805220447070203455855033241
10507000000000308020000000008020007000700000408000600040007000800080704000003080001
10608040702250504320446776887082804030283560502630407564742022603040307023533066201
10500070800080400000300000000050007020005000600050403000005000402070600040005000001
10642270753270803754406624506730886020405053444070204057508280502760586640303342701
10002000400000802000004000500030800080604020008070704000600000200040000000800000601
10808477707822522065784060632660208077204030703050343620678684586084206544723620701
10400000800000000030000050000020304050004000300030000070000030002000605000000070501
10627270564252854260842447857040303070626877344863548086804060406740675060454070831
10000070000000000080000000405050705060008000000030006000406080600040000060007040001
10552063364470387037526740608070404075508052404040475560458087457050428385404073401
10005050000040003000000080500020805000508000208000700070005000000050800070005050001
13804078636075502773808030743520504070504360407022306076404022378760808030348050381
10007000004050004000405000400000805080200000205000202000803000000030006080700030001
10805344803060745050677068807844707550362543804788408540404062872023856280307044201
10505000300060000060007000400000007000300000808000003060005060004080000000503000201
10268020304432862838604873786237823064304040453088784028338740602080276456602487801
10000060200050000000600000000060000020006070004000003070000000800070800000005000001
12767450855080254780303277333070503470365787807268606077664868242450404524468062851
10000040503000400000800070008040200070600000500000803000000000000000300000800060001
10868560806722307668843060253060762730403388528420406544763786552847636820303526701
10000000600000005000000040000030000000400000000000400000000000000000000000600000001
11111111111111111111111111111111111111111111111111111111111111111111111111111111111
