11111111111111111111111111111111111111111111111111111111111111111111111111111111111
10000050000000005000003000003000000000000000000000400060000000004000005000000000001
17203042536640303020662030208020466667306862587240802050505635702025406030533032401
10007020000000800080800030202060000030007000500020002000800000200030505050008000501
13355040372024474850308760303025428070586040402066225028462670805320402020208770401
10000080005000200000306040607070000070300020706000007000005000200070004020506000701
10623375708460803365502080204060473460605380388728406285504032732287654080306086201
10006000003000500000007000400050000080303080000060007000003000000040004060202040001
10704070578073472425285345706634542060803040768040666058766772732050702080303085321
10400020006000000000800000206000203020006040200060006000000000006030800030604000001
10585234283563635860707660744050305088856020307086308088402725406020608650606347701
10000000000060500000300020006040003000000050205020003000704000002000200030700000301
10786252623020407863575078802062607456652440803670382040505084662636764070242330501
10200000008070302000006080802000700000000030600020005070807070000050002060000060601
10702083503060708040703050407880285246542030263040603660646020748026504034773850201
10307000804000200080600040600030000000400060200060500070500030008000600030000060601
10508530708248423756874270402076266780406630403730887060605246203070448520778050801
10300060807000200000000030703050000030607000500080400030800060702070000000700050801
10787030406080606052834070203080603060378055628063205080454050207485202554603040701
10008080600020003000003080608000702000600070500080005060400070400000803000608070301
10203080522367786735203040205224874084704370504570867020207680307630738080406240501
10405060006000000080005000300000006000500080700030006050700000200080000080700000701
10703064207063506530603783437788504430303060404044805050734534458452447380243626701
10405000502000808000700000000030008000405000805000006080000000000000600000500000201
10306320305520755060357553763080585243264877708880442022875840408473506068805750801
10400080800080000020000000002040000000004000500040200050000040600060006080006000301
10728080507020286660788383502064656750408460504073308337873060748060206350605468601
10007000605070000020000050006000000060600060308000700000300050007040504000303000001
10808532457040466065438080807325887052348030704380568440808655206030367030602042781
10607000000060300030000020500000006000002000500020005080600040006050007040308000701
10205073508660806227324260382372808658706056766086502060483070683046702058604720301
10807000400060300000200000700000200020007000008000200040000030400050006000407000701
18703740373050374520604585207850307040464632256564736385388070448740454480805062701
10004000300080008000205000006000807080000000006000000000008050400070000000603000001
10763060503325708070205334253060806086885782303074442833302440306026328556623463201
10500040700000608060800000000040806000000040005000400000800080003000000000000000201
13508074552077302070403852756364803662846080608634207060262040383472223453775550541
10005020007060006060800000004000500000005040306000707080400080000000000000000060001
10474430705020625040763520464080687527552030828030402060506080566733887346388072301
10000080705050008070200060400070000000200050003050002050806020000000003000007030001
10722054806744308026608030207838587040608343408078756450706088705535467040246030341
10003040002000304020005060504000008030502000007000004000502000400030002080400080001
10605020472060507030303062205020804030872036733253507043803350853680603053806278401
10202070504030605000602000002080405060003000600000408000005030200000506000002000401
10702020505050605572882353875040804760308780822420203757835070507066504033284024701
10703070600020007000003000000020300070500060000000200050000020008000602000004000601
10306060503585728030303023344370203066873024582355646060554048878525602067254220401
10307000800000006030308000004050405000003040000000000080004000200050007020000050001
15408057542846432070505442206030706325803040444283584678706030503040607480706075671
10007000000000400070700000006000800040806000500000000000007020703030303000507000001
10664454868424802040456052624664765020507246502068205434246080403060547083726782501
10000000008000508050002000000050000080500030006000400000700020008020000080007000401
10227425303020506267602074662040402360704050405760547820402732875026744650804030801
10006000500070004000003000600070705000207000608000300000800000007000000000407020001
10706063204660677056435240607250737078607026403064462033768456604088874576334025381
10606000300070006000000070300040004000507000206080006000500020007000000000300040001
10204630764078203072668082484076808820204536502070404853402060344032546270707522401
10500030300060007030003050004000307000603000707080500000007040008000600000600000401
10883070286457766077305030208640308075228030863060536335784065302080808228527380201
10400080000000004000006000608020200060007060005000302000500060007060400000000070001
10203456486726406046255862708020273530804386707462503030307530755060506873555068671
10307000000000302060000000006030003000700000508000800030008000400040203000008070001
10505080502820606360566284246083608020867670608550408334738082802020708022222072801
10200060600060600000300000000020007070007000400020408000003000808050700080002000001
10666380755240402538707485407730835050704064342070604082202830704860362230606877601
10002000400000202000007000800030600060602050005060506000700000500020000000300000601
10406328802644346046478050357420206056306050202070788240268855336026506774768560201
10400000700000000080000080000060606040006000800070000030000050003000303000000030301
10847670738745746650282376337030605080753568327342882024502040708380444020342080621
10000080000000000050000000706030604030006000000070007000304040700040000080006020001
10826057532670566024878860503040307068407065303020486570587033475040873484203036801
10007020000030004000000060600070608000206000803000800060004000000020200060005080001
16705064636085806338403040877380202020208380802078505055804067877430303070362060851
10004000003080004000307000600000707060400000202000204000705000000030003040800020001
10203847703070588080535084704767203660524385706668804220807023362047745470707027201
10208000200080000070005000500000003000700000605000006060008030004040000000804000301
10366020402726782268406742723234623023506070233045858045667350508040323755403233801
10000050700050000000700000000040000040004040004000007050000000200020700000008000001
15557680576050865570508445342040307460876323202283204085786448746780205757486078571
10000050606000200000400080005030200060400000700000207000000000000000300000600060001
10768540203744403653557070752060384580408353724350406774228563723285774350808482401
10000000600000004000000060000080000000500000000000400000000000000000000000800000001
11111111111111111111111111111111111111111111111111111111111111111111111111111111111
