11111111111111111111111111111111111111111111111111111111111111111111111111111111111
10000030000000006000003000005000000000000000000000400040000000003000008000000000001
12307078222450205050344060503070486622206874386280204020604665406047207080827047801
10006060000000300030300030607020000040002000500040007000600000700030502070005000801
13353050666067624860205750502048752070576050506072336065265360504340508030203850601
10000050003000400000303070202050000060400080606000003000008000200060004060705000701
10845524605260406287306030402060288480205250338745308847305043464774568050607077401
10002000006000400000006000500040000080808020000070008000006000000050004060203080001
10408030844028247776624478405264326070406020445020534022634266725040207020605044871
10800050002000000000500000508000804020004020500030002000000000006070700050207000001
10637386343684646550706550737050204058632060304037603082607283502070806640703435701
10000000000080200000200070003070005000000060205030008000505000005000500050200000801
10826873235040307483242066808068205338723620703670838080208076564884824060245680501
10200000006060406000006040608000400000000020500080003020607080000030004030000040201
10407036703080507070304030206640555787573050684070606530772030626087608088748880201
10306000203000200060600050300080000000200020300020800020800040002000500060000050401
10507430302264778872674620507038277270605530307520462080405635304030852250445020301
10200070302000300000000060203060000060805000700060300020800060608070000000800020601
10456060404050303026833050407040704030782025274054504080368080306676305284303040401
10004070500040005000003020405000404000300080500080007030700070700000705000803080701
10207030543552747743306070508642284048405870507640627040603820604880557040407670801
10502070006000000070008000500000006000800020300050002030300000600030000020200000701
10703058602062205370702724224666405780604050805024408030666825263738857870642767201
10806000806000607000300000000040006000306000806000003070000000000000800000300000601
10604420807530327040785667474040434375238675307820645045446580503225302034202650401
10600070300020000080000000008080000000007000700070300070000080600080007080004000801
10262070506040775640224384805053338850204360802022204572473030445040603230508254601
10002000505050000080000050006000000080700040202000800000200070003060402000806000001
10406648486020685044725030308883427037856080608850357250402238408050477080505074671
10202000000040200050000080800000008000005000400020008030800040002080002080208000701
10204033204650706365247360554658802736608063677044705020742060662067405084506820201
10806000800070300000700000800000600040002000005000400020000060500080006000208000401
14508540582020864680506738207280608050323262822644887523643050263680767540702046801
10006000500050004000306000004000308070000000008000000000007050200050000000605000001
10453050608348402050808476527070507052783464307076837763704520405064282847435853601
10500030300000708060600000000030805000000080006000200000200030008000000000000000801
18608027882085608050802444788282204264474070206456406050247050628448847245342350851
10008020004040005070800000002000300000004030408000805060700080000000000000000060001
10734530307070477040835620537060426726633020678020604080602070632248347362237027201
10000070303020004030800060200080000000400040002040007050504060000000005000007080001
10766023702558304053302050706823824020703854306028475220307027503878566040823060561
10006060007000404070006080203000006050504000005000008000305000300050002050500060001
10608080826080502060302034707020203020655082453388208083607220768680704055805726801
10407060203070605000707000003080303040008000500000402000006080700000703000006000501
10304060802020405754337827365050404360403720533270707884432030602064507033536032301
10706050300050006000007000000040400070700060000000300080000080007000602000003000701
10606030704868367060402026236670803064746058436522553020427025436767804045576260401
10306000500000003080704000008070208000004070000000000040003000600050005070000060001
14702042458675546050302223504050505584504070653243525476606080707050406350402046441
10005000000000400080600000004000500050703000600000000000007030605020802000604000001
10784837858845702080677037633462285080604434206023202285638070808050548046486438201
10000000002000603050007000000070000020400060008000700000400040008050000070006000601
10382235302030306273704035345060503440605030602760778480506885783054752850206080701
10003000600020008000007000400060305000204000808000800000400000004000000000507050001
10204043205740754038266620808430688068304026506038645084673644602044455866277053661
10704000400030004000000070200040006000705000807060004000800040002000000000800050001
10306820428025307078475022266043604820206676308060703646506040366058548680503747701
10400050700020005030007050004000506000803000206070300000006030003000400000700000501
10544040568633542073804080706730306043784060875070332425444088505080206228285570801
10700080000000008000008000705060600020002080008000808000700040003050200000000060001
10807235688427304086826735403060332660408738202838707050207570423080606387638046241
10806000000000405040000000004080004000800000707000200080003000200020507000004080001
10302040503340202820776344674033407030357460508830802273424037402040507087733053201
10200020500070400000700000000060004050003000400030805000008000808060500070008000001
10532840762320307426707278806450835050705057732070303025308460303420747780207522401
10008000400000707000006000200060400080405030004080208000400000800070000000700000601
10407223502684436052743030557680302033207070308040722870872358676037307653355760601
10700000200000000020000020000040407050002000800030000080000080007000602000000060201
10443560575486347520256468267040204080756275668826444076307080407580583040236020381
10000050000000000030000000308040307050007000000080002000707030800040000080007080001
10426075542530534046467770707050807057703038206040235660825046263020825354507068801
10005050000050002000000040400030507000304000506000300020006000000050400070007050001
13307032356058405246702060665440405060606780608032403027505052247430206020464020231
10002000007070003000604000800000606020200000704000605000303000000080005020400060001
10707852305070665030585086403582805660863425205388604430505034736086875370508028501
10504000200050000050003000400000004000500000306000006030004030007060000000805000701
10378040203825866687203838747444536066504040567047445088785870804020254783804223201
10000040800060000000200000000050000070007070005000002080000000500020200000005000001
15427730544020458620307286575070203820375645206672208084447462658650704558286064741
10000060705000400000700020002080500080400000400000606000000000000000300000600060001
10826660505685603675676020266060455270204868426360804886283434388538756420303643701
10000000600000002000000080000040000000400000000000800000000000000000000000600000001
11111111111111111111111111111111111111111111111111111111111111111111111111111111111
