11111111111111111111111111111111111111111111111111111111111111111111111111111111111
10000030000000006000008000002000000000000000000000300030000000003000005000000000001
12606066856220303050223080503030352345408775265280603030602828207052607040476062701
10005030000000600070600080504070000070008000400050006000300000400070603020005000201
14882080462077364450306820806084834020774060606028285065343580703580305030705880401
10000040004000800000205030308060000070700040604000005000002000700020005030706000301
10845247805230406447508030705060852770605350352388606252206044368465233080503024601
10005000007000700000007000300050000050702040000020007000008000000060005030508050001
10303050488036862575888742304788875050503020736080454044466877438050304060404043331
10800050006000000000800000702000605030002080400060006000000000004050400050405000001
10772757822624584420702460288040206087765060308053803042507834703020305520205543701
10000000000070800000600080004080007000000060708080006000802000003000200050500000501
10837476677050304336354055308086204222832270807660283040802034784724464050255740701
10300000004020406000006070704000700000000070800040007040207020000080005060000050301
10405052807050604020307030406370636868764040346020707460546030277072705088647340201
10803000306000600020200030700070000000800080300020200030500080006000400030000080601
10508340708748852466283880508026562730503730706270363060204847206030467550782070201
10200020808000600000000020205020000040707000700040400080700040205040000000400080301
10388020308070408073765070308020308060757037578063202050276030406788502355607070701
10007020800030004000002020304000607000800020500060008060800040300000206000505020201
10804020745627735366807030305487235062207360605340332030208770406250338050602380401
10804040006000000080003000200000007000800060600060008070700000700050000040200000201
10606026702087706770204865732666306480807040304054502060836572583443522280466563801
10208000408000308000300000000070003000606000808000002080000000000000300000600000601
10405730402350846080368337825040575876238878508340373058827240707876202046805580701
10300070700080000060000000003020000000006000800050800050000080500060003020005000601
10826080203020538580727536604043283520403480308024704323382060323020808480402363201
10006000508060000070000080004000000080400020408000500000200070005050707000804000001
10705826557070544084377050603482652078832020207460772230606237404040383080706052861
10808000000030600020000050200000002000007000600020006020400020005070002040207000601
10302033505670505785337640586746405624504022338073808030475040332034702078505720701
10402000700050300000500000800000300040003000008000200070000050500050006000603000301
12503770744070437850503225802380704080248844658826523367842070747740234250407037601
10006000400060004000802000005000304040000000002000000000008040200070000000403000001
10853080607247308060204564557050402083523784706063552883707520302076462252877828201
10600060700000402030700000000070305000000050003000200000500080006000000000000000301
18603044434024502030503526424475207368325060602365602080736020266275626273522560221
10002080002050005030400000007000500000002080505000406040200040000000000000000050001
10746320403070737030557780745050326358735080886020207080505070485874864444672043201
10000060205080006030600020300070000000800040008080007030704020000000002000005050001
10645087603486308062507020404722848020504568305068754650808074707333444050638030361
10004080007000602070005060803000007050503000003000005000305000700050005070600080001
10208040877060808070205077707070806030583047257724307024803620828880304082206836601
10207050806020403000507000007080703070003000200000306000006050700000208000004000801
10604060604070207556373274383070502780407720852520807577624060402042306087247066601
10704060300060005000007000000050800050500070000000600080000080008000706000005000701
10605030204445338050506038565440406033555052443325654060838056627752807058265630501
10508000500000006020307000007020705000002060000000000050007000600060007020000040001
17403075766438878060607486304050702652208060433246284574408070205060603650808063621
10006000000000200040200000006000700020807000700000000000003040706040606000403000001
10372847453238703080428036428843627040507882308077503337622070408020473032728865301
10000000002000808030004000000070000030200070008000500000300070008030000030002000301
10252827602050705535703066732070402860307020708350775620505265872033287580705040701
10007000700020002000003000800080706000208000507000600000800000004000000000708040001
10707077703280862087724280303450675042705068606022476023784257205082756648654068451
10603000500080006000000060200020002000406000603020006000300020002000000000300060001
10803450343022206044782037586086805470606286806080602338805080336052665470702234701
10200020800050002020005080004000308000607000608050300000003020005000200000500000201
10678030822834424062803020808840607027578050345020568482367027808050704383765760701
10300080000000002000004000205060800050005070004000306000600050002030700000000060001
10507686348437505044577836702060355650403766602628705040306370687050403282764033351
10505000000000608060000000006060008000200000806000700020005000300040307000003040001
10703020606240705830575573344056606060556360608520204377374027607040503044724052801
10200020800080800000500000000060008060005000300070403000002000605040400030006000001
10668880325860403574203336502640673020205036243030508033405220805520488340407375701
10002000600000506000002000300020500030806030002050705000300000400020000000300000501
10203638804582543077833060834370708022405040408070332380484662833088206232534820301
10400000700000000050000070000020304060004000400030000070000070002000407000000060801
10566650483485832280542756863030308050835263358787382072706020405560884060854060671
10000080000000000030000000707020202050007000000020006000208080600030000060005020001
10276052538340782058357330608040206037204078206030855730482043337060778844508033701
10003050000030005000000060500060303000808000605000600060003000000020300050005050001
14506082672052805637303050364240303070403330502032204078806037564650205060548060471
10007000002080007000404000800000808060600000607000805000806000000050003080800020001
10206377703060754030856062203637402850568273506267807480307057857026242330703085301
10807000700080000060007000300000006000300000604000008050002030008060000000503000601
10673020503836733622405257243536834043803020364074763065758360705050483558706875401
10000040400050000000800000000030000040005020002000005080000000300020200000002000001
18435850768030446240305358676070502740326543508658206033756323347850506745635077431
10000060402000500000300040008040300050700000400000608000000000000000300000700020001
10683530407788306783448050824030733750202426783480508644353323373448287360406274301
10000000500000007000000040000070000000300000000000700000000000000000000000600000001
11111111111111111111111111111111111111111111111111111111111111111111111111111111111
