11111111111111111111111111111111111111111111111111111111111111111111111111111111111
10000020000000007000008000003000000000000000000000200030000000003000003000000000001
13804056735660705030857050603050864686207842434320406060708457407074603050553084501
10008050000000400060700030306050000060005000500070002000400000200050806060004000801
12653030535028876770607740406055426060485020402026755054473630802460503030705470701
10000060002000700000607020302040000060800070204000003000002000700060005080603000501
10276782708370503446608080604070688460303780887478508738508087853322666040705065401
10006000005000500000008000400060000030502050000050008000002000000040006070604070001
10503040822054748342753478702552453050606070653080258082846235272050203040705054721
10700020002000000000700000807000805040005060500060007000000000005030600080502000001
10354846377528343330208570432030307032587060602057407062602387306060504380504448301
10000000000050300000600030008020003000000040307060004000207000003000300050600000601
10366343522080303656553034605025506374573620406240788020204087872754545020268350301
10700000003050507000003020306000500000000050400080007080604060000080006030000020201
10406032703060408020602060708870475478465030827080502630676020465024404048857660601
10204000306000500060700040500020000000300050300020700020700080004000300080000080701
10203370605887548674262430407026243380703430704720764080708648607060335830746030601
10200060805000700000000070203030000050303000400070500050600020406040000000200020501
10687050405030305058833040703040708060752076465073603050733040803433504748806050301
10004030800040003000003060602000203000600060400020005070700030400000303000603080201
10502040546885646724803020404388882084605220702360826020303660703260237030706640801
10304070008000000080005000300000003000600060600030003030500000200030000060600000201
10707035808067503270308563763464608660807040503075402050235452372547444640522336601
10702000604000503000400000000070003000805000306000002020000000000000200000700000501
10408820806630832050255454467030553324223383607820777036356770408645404035508520501
10400070600030000060000000003080000000004000800020400030000060600050007030004000501
10455050608080454660375547408038388370308370402028705455542030433030203530602442601
10007000304070000040000020006000000060400030204000300000400070004040502000508000001
10404376766080345073387060807425253032264050804350723450707775802080562030608028731
10506000000020300080000020800000005000002000300080005050800060007030002040807000501
10606032606770506845583770527245804257502065742083308060886080258055703087503820601
10205000500060600000800000400000700020007000003000500040000050600070006000606000401
12502660387080538280506268306540403060873886733852574287468080533760287460604083801
10002000200040002000205000003000408020000000002000000000004020300020000000402000001
10877020207652303030407728456040204083787436506025874727507550607022474333847627501
10200020600000303070500000000030802000000080004000500000800070007000000000000000201
15606047532037705050402874264846405667464030802383808060785060334427844854734240241
10003070002060005080500000002000300000006080204000207060700020000000000000000050001
10783370708030675020376660632070326782472040763030605060302030588284323738447043401
10000080704070005020800060500050000000400080002020006080208070000000008000003080001
10288073802847608088405070604282222040606573706075645880308046708374377050572020321
10003020005000804050002050203000002080602000006000002000408000300030003080300070001
10205020337040404080604077807030703040864084756552408043703230745720408076307368501
10705030706040603000505000002040407040003000400000602000003020200000607000003000701
10402050405060207675538835842050508240207720367550402356432020706025205047234066701
10808020400040006000007000000020300030400070000000300080000040005000506000008000201
10207070303222363060307043468270306022322057483822568020487026852855204023867850801
10207000300000007070607000006070302000002080000000000030004000800040003020000060001
18306083883378542070203876706040308623403040487625282787406070205020506370705073761
10008000000000600060200000008000700060603000500000000000003060402050502000505000001
10835743645237802080247035445553636070602748307064502876538020402020357045635888201
10000000008000503070007000000040000030400020004000400000600030002050000080002000401
10243385603070602355306032232050304740308050707470344420806567848078444460802020801
10006000200070002000006000400030702000802000708000200000800000008000000000502040001
10806048408240656073787570303380252068708043703024827064324466404037836735528052821
10705000800030008000000080400070007000203000706080003000200060003000000000300070001
10605630654043303075873074288062704870404758505080605236507040624025442430702442701
10600080200060008080008020003000706000708000707050200000006020006000400000500000701
10228070682333645073806070702720504075285060376020623645467033603040604635877850601
10400040000000008000008000402040800050007080003000504000800040004060400000000030001
10604852452454202048532543207040622580704528606322202070503880486080702382638045351
10204000000000307060000000008020006000800000503000500050007000200080306000005050001
10802070502540204250456878735046708070568840708250307263426066406080304073325077701
10600030500080800000800000000080006080002000400080702000008000708040700050007000001
10432720688580705522504466406330755020508028657070208044306530307650544560703874201
10002000500000708000002000300060800050402020008070506000300000600030000000200000701
10408652504644844072434050638850604025204070504080727850772283267064508386677230701
10300000400000000050000030000060303020002000300020000060000040004000207000000020801
10577370246565233260244636526070608020348634384727682057308060206480843040536020861
10000050000000000020000000807080806080002000000060003000708020400030000060006060001
10435035256380726078857530203050702058402025307070765760482055876070445538202065601
10003020000050005000000030600050504000705000404000200050003000000050200070005030001
16303052464083804258502080883840404070208280502033408043505045667860206030778040671
10004000007080005000706000600000302070400000304000304000207000000030003050800020001
10306274508060656060872075703738704260455242603265607430707043888036852720607037201
10202000800050000030002000800000005000400000203000003050002040004060000000304000401
10364060402556826552606556555364237064502050383064546044334820306030743285507478801
10000040800020000000300000000040000040004020008000002070000000300080200000002000001
17685230386050447570603853688060706280745227208752302025877233688620208827758082431
10000020408000300000300020003050700080200000200000602000000000000000700000400050001
10356530606236306426664050882040864420207372267640704534558776638678687860507872301
10000000400000002000000050000050000000800000000000400000000000000000000000200000001
11111111111111111111111111111111111111111111111111111111111111111111111111111111111
