11111111111111111111111111111111111111111111111111111111111111111111111111111111111
10000020000000002000004000008000000000000000000000300060000000002000003000000000001
13206045858520405080377030203060827647507486568650804030207844407073506020738074601
10002060000000300020800070807020000020007000700080006000600000300020808050006000701
17343080887053767860608870502036634030375030608086746053682780202720807060604830301
10000080008000600000603080608060000050200030607000005000008000200040007050808000601
10225722804280402677508030805080437670502860858853506476704046567723627080507042401
10005000003000200000004000500040000050804070000050003000006000000080003020507030001
10504030727043823644285476303765634050405080576060368024652577344020502060308085361
10300080005000000000200000507000503040005050700030006000000000007070700050305000001
10477345846587325830704580425050306043745080502076207085408847703040707540205323701
10000000000030700000300030002030003000000060704080002000605000008000500070800000801
10284888385040204752783028402085207243473320402480632020702038783754433080426830801
10300000007070306000006060705000600000000080700030002020203060000080006040000050701
10203084408050708070706040703620472222368070453020803870727050767037404087422420801
10306000304000800050800060500080000000800020700070800050300060006000800080000040801
10303460604777572643376470308072728420805230303270233050203835803050823840333060201
10500040804000200000000060605030000060704000300050300070200050606070000000400030801
10532030602050707038734040303030203040426055786066503020332060806255207338802040401
10004060200030005000007070605000603000600070600050006040200020800000208000504040301
10806030754242383273206080702457473085502680708750885020604250404430434050806670401
10407070003000000030002000500000008000200030300020008070200000200060000050300000501
10704028803038503360205274443573307430703050607068207030858437558243467830578688301
10505000308000804000300000000040005000406000603000002050000000000000700000400000201
10706360706680578080377843463040658588565376602780283047586680204266408043803440501
10800040400060000080000000003050000000004000700060800070000060200040007040006000501
10482040804040228370534445803068468240305240807036207256366080536020204680703262701
10002000303030000040000080002000000050600040702000800000600030003050804000703000001
10206865274040265046463040203837687083667070407870527880603577607040636070302052231
10308000000050800050000040200000007000005000600030007040400080004050004080304000801
10608033704650407426427360563477305766503026347054707060837070457027707075603720801
10403000700040400000600000600000200080002000002000300070000040400040003000604000601
15402720756020462650405774706480505020277488243386762735246050866770762880404024801
10004000400040008000304000006000202020000000005000000000005020800070000000705000001
10243070404244406030807868673080504064248677303077565537207860204058276485857852701
10500020700000402030800000000040206000000080006000400000200030006000000000000000301
18807087358023604030606658366578303446872020304278408070642060677352525626636250861
10006050006040003030600000007000500000002070202000805070200060000000000000000050001
10457720707020785060565330672060622588877080428060206060404030573286533433877022201
10000080303080008040500020200020000000800030008080007050405050000000004000006050001
10844087802737604022803050807377387040504563304065423450807024703538466040644030681
10008070005000208070008030207000002080802000007000007000304000300050002020200030001
10407030674020203060206056307070206040562078374238705073403550753270505057202638501
10807050207040406000706000004040404070005000200000806000004020400000302000003000301
10307040804080304425674874526070405620405530684740404724256060604037605074453057201
10202050200030004000006000000050500070800060000000700060000080008000707000006000701
10705070206755335060405044465470603025258037263646483030462078624536608025557250701
10608000200000008060305000008050704000006030000000000030002000700040008050000050001
18303028245378468080805336702060503567808040668877347386308030807030802270408067751
10004000000000700020400000002000800040706000600000000000007020803070204000502000001
10463825543534807080367036486285633020704376202078404634545030504040344038347375801
10000000007000608060005000000080000050200070004000300000500050007030000070008000301
10322485802070306867608078252050703580508080708830882780305477678028883340807080801
10005000700030003000004000500060402000406000302000800000800000002000000000805020001
10405066308380622025228480308660683042304075406056824086823557407087646525638026281
10303000200070005000000080800030003000806000406050007000500070004000000000600080001
10702730655046407048776058226024606680803468702040504865407050865062665870308856401
10400040500060008060002020006000504000402000806040700000003040002000700000300000801
10382070563237372063405060606360205037567030457070466365223087402050508485576650301
10600030000000006000005000708020200060002030006000406000700070004040600000000020001
10407422273368703023356384208020226630603274402278204060404540257020606686822052221
10603000000000604060000000006020008000400000203000700050006000700050305000004050001
10603070205450605670474763283078807080247220308270703245822062305080707028727076201
10800070800040300000300000000020006060005000500020405000005000207070600050005000001
10425250866380304685805264507780582040603042386030204046307620506330267360207637401
10008000700000504000007000400060200040608080008040506000500000600060000000200000501
10308746604688373085437050336750706026607070802060244560844234872055708862355760201
10800000800000000050000050000040807040008000800080000080000020002000405000000060801
10868650536725375360488642532040603020774837524246368037802030804850675020666070261
10000030000000000040000000307080304030003000000070002000206020600040000070003030001
10547084473230545077756720805080308026307048503050863520433065886060724285204062801
10006060000060002000000020600080204000506000508000400060007000000040300030003080001
18204026867064605353402080384560507030308640705087504035408086374580602070882020661
10003000008050006000208000600000603080800000505000707000208000000050004040300050001
10603587808040754030522035504665403670472728803257604570502068546028464230505033301
10806000400020000060007000400000003000200000307000008040003040008060000000607000701
10826060508788475375303577236363442062206040255057383087874540702070883553702823501
10000020600040000000800000000040000040007070002000007070000000300050200000008000001
12737340458070388230504735853080706740777238705755702077487686474360705265638028261
10000040404000400000500080007040800050200000200000702000000000000000600000400070001
10788230802244206436262070885040843750302363734320808778473827668387867840204328701
10000000700000007000000060000030000000400000000000600000000000000000000000600000001
11111111111111111111111111111111111111111111111111111111111111111111111111111111111
