11111111111111111111111111111111111111111111111111111111111111111111111111111111111
10000060000000002000007000002000000000000000000000600020000000008000004000000000001
13705087765440403020226030306080782568408243375750707060708668206075706060743046801
10004080000000600030300080607070000030002000400030008000400000700080602040006000501
17744040285067464870204230607053482040252080607055547082737440608870508070307830701
10000080002000300000805080304080000080400050808000008000005000300050007080702000501
10667628407260804623405020403020846870404560688682405827403063842827886030704042601
10007000005000700000007000300050000030404060000060002000005000000050007030608060001
10807030385022376842476754406245367070604080585050886035872265827050806070306072381
10500040002000000000600000605000802020008030700060004000000000004040500020506000001
10746446373323736240306720736020204027377040804043404086602886705030703540205283601
10000000000030800000400050002070007000000020303050007000606000008000300020300000801
10347568483080203367435082307065708538553470404820786050302072753566652050823870701
10400000005050203000006020403000200000000050800020007070703050000070008040000020601
10408058603040805040603060505660754648747040546040406570375050554085406033332450601
10807000202000600060300020500050000000200050300060700030800030004000600050000040501
10206730502833332263435830406032257860404250803520366040402633405040657850866050601
10700070303000700000000070606040000030307000800080200020300070403080000000600030801
10525070705080606042284060407040303050873036765047802020678060706765302666405030201
10005040500020005000004080506000502000700080700060003060300060200000305000807040401
10603030332424478364508020803258633078502760503560867050404460607370445050804420501
10204070004000000040002000600000008000200030400040003050800000500060000020400000201
10708052303025308660807242253756602870806050304023502020222634847527684360627345701
10508000306000403000300000000070005000707000808000004020000000000000400000300000201
10303840306830254020732362742020578582565487703370664032827680408647406045408820201
10400080600050000080000000004030000000007000300050700050000080700060002030002000401
10822040808050445660685258605058658820407340206043403458363060828080205480305268601
10003000406030000050000060008000000020200080602000600000500070005040503000603000001
10703282653020387058836080204877626042433060603830547620503622202070848030408065721
10506000000030400050000080300000007000006000800080007030800060005030003080605000501
10803023505280403437757260588265504753308064883088706040278080526055803082604740501
10507000500050700000600000600000500080007000005000800020000070500030004000605000801
16208530222040772730805553704880204020655774688753257428537080378750287280808023501
10004000400050004000306000008000506060000000002000000000006050200040000000302000001
10235020604375704050706763324080705078224338404084874677702550707054438742247258801
10400030800000407060300000000020603000000070002000800000700040007000000000000000301
16507028843068407070805523237567608337724080804545203080273050752344477235782730821
10007080004030006080400000006000400000006030607000603040600020000000000000000030001
10272850607070825040447880287020754867843060574050808080502040853388653476247044301
10000050503030005030800060300060000000500040007050006040308070000000007000005040001
10454043802486205068804070304345652050508763607066858570202048205726545020567070681
10005080006000804040006040702000004080503000008000008000407000500050008050400050001
10704020726050707030205024502020805040268026425464503057202780553780703052308273201
10707070403060207000304000004070305030008000300000605000004070800000508000007000501
10606020407060303734533358562070504560704650865870304322582020802025807025367033601
10306030800070007000006000000020300080300030000000800050000080008000707000003000501
10703070806365567050504054743360605076648036863255366070668077438244803066587850301
10802000700000004040306000008040205000007040000000000080004000500020006030000070001
13205076483584786080207424206070706476807060283263874677303060608040503540403074551
10007000000000400030700000006000700080606000500000000000002040403030306000703000001
10257672448846803050742027862232776060405527704027503875423050204050884082878322301
10000000005000505060002000000020000020800070006000700000200050005050000080003000201
10445746603060203223307067583060407440708040507340474550403446672052786270703070701
10003000800080002000004000400080408000705000507000300000500000007000000000403070001
10707065606580736087254840402440827035303043403022436034484456808038465678432028361
10604000200030007000000040800050004000403000702070006000700060005000000000200030001
10602820582028804022824026824076304230806832207030706384205040644042833560806577801
10300020700020006040008070008000704000506000706020200000003030003000200000300000801
10287040736435486026505080805520406022645050556080662534242065306060403322483850201
10400050000000002000008000708040500040005070003000508000200020008060600000000030001
10706348783657706087422834707030783320608252707656405040703540536030207583225075461
10802000000000604020000000007080008000200000404000400050008000600080302000007020001
10205050503380204660875656262065202060827630408360403352847033604050207034587026501
10400040800070500000700000000020003020003000700050603000005000406030700080006000001
10633860865550408726202365307420724070604055436050305087307370405570762640704545301
10002000800000502000002000200070400040807070007040504000600000500070000000500000301
10605548708842457037426020375320603087408030606060228770886832534086307766646680501
10400000500000000030000030000050604040002000400040000030000020003000305000000050401
10752460385258822660734867787060708020784663342365472072702040302360655030834030351
10000070000000000080000000808040208030003000000040007000605030700080000070004030001
10424062438650852028864420207030404027207038803060432840886052385070662477803052801
10002060000070002000000020300040302000806000304000500080004000000020700070003030001
18708057674047307253805020358530706030504350504056307055603053466620202040866050481
10002000006030007000403000600000304050400000605000308000707000000050006020400050001
10207586803040842040554078206334703450828378202863304870707078367077248830803044401
10806000700050000030003000400000002000700000805000007020002030003070000000305000201
10536030508625267577605857278866833026207060388023834043365360404020822668803333401
10000020300030000000400000000060000030003070003000008050000000400040800000002000001
17673530634060334560603742872080804670364734305733708055237545636430303435774037281
10000050402000700000300050002060300050500000400000302000000000000000800000700030001
10523620707335502368482020435040388450808724763440708258623722548662668240304347401
10000000400000006000000020000050000000200000000000200000000000000000000000300000001
11111111111111111111111111111111111111111111111111111111111111111111111111111111111
