11111111111111111111111111111111111111111111111111111111111111111111111111111111111
10000060000000006000007000008000000000000000000000400020000000006000005000000000001
15303073628430503080754080604020352222202344845480506030204482404072302020822042301
10006080000000700060300070603040000040008000400030003000800000300030806060004000501
16335020783033358530506750808023328040866070704028726082564480604520705020606280201
10000060006000500000507070502040000030600040405000003000007000400050003040708000801
10647832604730703388803080708070338670306250828628804483403076258238422060708073501
10008000005000300000002000400050000030207070000070005000002000000030004040608070001
10508020656033324763663278608688876080504040882050626083387886625020303020503066371
10200030006000000000200000402000808040005070200040007000000000002080600060302000001
10755836428833468380804760445080607086765070807072703057702848506080606440207567701
10000000000070800000500030003060006000000040203070005000705000006000400080500000601
10336877732050205864274043407067205524727620404230835030603083442344556080827880601
10500000007070208000005040407000500000000050500060004070606030000080006050000070501
10804026207050505080802060804850247822375040663040508330272020837073306055584420301
10208000804000200070800030200030000000300020200070500030500070002000800020000040501
10508660406227348886473630708033785740404250407560756060202344603030675480772040201
10200070705000300000000040605030000030803000500030200060700080306080000000300030701
10828030505040204023468070407060307080887065382042208080755030605474506325407040301
10006070700020008000006030803000203000400030600030004060700030800000703000406050401
10508030873435648742605070808847785084704580702560678070308870408620883060803260701
10302020007000000060003000500000002000700020200070006020600000400030000040500000601
10704036207038506340705433862654202250705020706057804070566776486834224520577835801
10707000706000507000700000000020004000307000206000006050000000000000300000600000701
10305280305330426020485372346060243757257524506870226073844720606326506077404770801
10200060300020000080000000004030000000007000500050300040000080500070007060004000301
10732020306080278540425863203024324760607380706075807365564030335040403260804262501
10003000402050000040000050007000000040500060707000400000800070008060702000508000001
10703235766080226054464080803568853062432020602830373250405524208030487040808033751
10505000000070800070000030600000007000008000400040006040800070004070008050807000201
10503066608640408322564260438352705372807032542086308070273070576035304058308650401
10403000700030400000700000500000200080002000005000200080000040600080003000305000801
16708740667030687740603466502470208020354775578786522775826060728740724420807077801
10003000300050002000802000002000208080000000006000000000006020700030000000408000001
10237060603436704070205728372070706057364754603025774542204240207075628635432677401
10200030300000403030400000000050206000000030002000500000200080006000000000000000801
12302043582037202050704636734676803434227040505475202080776030578242664286435430231
10003060003050006080200000008000200000006060304000204060800070000000000000000080001
10478560508070543030628360586040377345644070876020804070207060272777437544875024201
10000070705080003060200070500020000000800030003070004060506030000000002000003040001
10328055507878304044206030704834734040202832603083826850505022808725577020333020341
10004020006000803080006050705000005020506000003000008000208000800020005020500050001
10206040757050302060706025704070302080884035788262807036204530633740607056505478601
10307050407070404000506000008060206070002000200000708000005030700000703000008000401
10304050406060505677865543463050603780702280625480706387524050602046405088488063501
10608030200060008000006000000030800020700080000000800070000060006000303000004000501
10502070606348853040205038382840707082776087737486326030258084246842407072337680501
10807000400000008050704000005070406000008020000000000030002000700020006070000070001
16607064453565872040805563208050304878606040557562754732203020708080204460706042641
10005000000000300040300000007000200030802000600000000000008030204040507000702000001
10376435642538205030434052254447848030603434805072302288764030507020462042335327201
10000000005000208070002000000060000080600080008000800000800030005030000050002000601
10735472403060407586206056443050203570405020203220342760608226224052544380206050401
10006000600050007000007000800070303000804000203000200000300000008000000000308060001
10502026408630242072852760406760633044706032304074436055776276402067482727262038631
10804000400030007000000030200040008000708000707060005000300040006000000000200050001
10503430356045704066563083453082302660805876306060802653508070753078634820304367201
10400060400020006070005040002000703000407000408020800000008020006000800000500000701
10782070582634782085705030608560204032726080633020872222786022502080606486684470301
10200070000000005000007000207050300020003030008000807000500050006080800000000040001
10607352665278506086362247404040732520603743402375508020707780528030707264852077681
10305000000000608060000000007030006000500000807000800050005000800070208000003060001
10606050205250502260888247534074702060537330505680403476667077304020205062242074401
10700060500060200000200000000030007050005000500070305000006000706070300070002000001
10245350652780203862202832303660627040402028655050208056505380402220838630606725501
10003000600000807000008000300020300060504020003080808000700000500070000000800000601
10806423808464763084845060773740402085402030208020225540263322842068302828834450401
10300000400000000040000070000040203080003000700030000020000080004000705000000020401
10348370667572535340367245247020508080668822875446245058505040408630874040243040271
10000060000000000080000000205060507080008000000020004000607020700030000030002060001
10488027853250745036464470707050404036207058507070828570454077835030435788405026501
10006040000080008000000080400070303000504000305000400070003000000020300050004050001
12707055487088302348706030472860205050402440506034702073702053458560604080742030551
10004000008060003000303000500000506080600000803000202000705000000050005030500080001
10703323807020243080632065508686802640433523202827405460702076447036243760207033401
10304000800040000070006000600000008000200000708000003050007020005030000000207000301
10377080607783477243603244282478538088405070637082234058235770504030455274607847701
10000040200060000000400000000050000080008020003000005030000000300070600000008000001
17272420458060638660407227765040607670342568602754408068622527722440802253727027561
10000030807000400000700020004080800070700000400000502000000000000000500000300050001
10486270208524307568774070334020855250205726555670306366837446228543822220505778301
10000000300000003000000020000060000000200000000000600000000000000000000000300000001
11111111111111111111111111111111111111111111111111111111111111111111111111111111111
