11111111111111111111111111111111111111111111111111111111111111111111111111111111111
10000070000000003000006000007000000000000000000000800060000000003000004000000000001
14402088636280208080222030707070342446306236846250506030804848302077508050586032201
10004060000000400060200080404040000070005000400030008000700000200040703020005000701
18825050783035252720608230407037637060225040507052878085387670605520603050606250601
10000060006000800000606020403080000070500030602000007000002000400060005070304000601
10774353506580403264804060507050377660703880667674704872305025534247673030803023801
10007000006000700000008000700040000050407050000040005000004000000020005050606060001
10506030834046772382536466205258743040605050672060558053687233556060207080302044821
10300060008000000000800000504000808050007040400070002000000000006060500020605000001
10546235322753547560203570863080504086356080403045607072702444402020204630205344801
10000000000020500000700060008080007000000040206060006000203000002000700060700000601
10438228585020306562824026204084702528248560508340857080403084682453887080452460401
10200000006050602000005030606000800000000040600040007040405060000060006030000030501
10203055706080203050204060805750582422854030372080708270776080656055507086348360401
10206000408000300050600020500040000000300020500020400020500050003000500080000030201
10204750505452582234528550208032532360705260403370362020208676407020736270775080701
10400040504000200000000060404080000020408000300030700080300030503020000000300020801
10252080503070504057773030303040203040867085765036706080428070808788704728708030501
10003080200040007000007030705000603000700050500070005040800030200000805000603050201
10308080373777376636202030807258644033605330505260476050805220607760374070602280801
10506060007000000050002000800000004000600060700060008020300000800080000070700000801
10803077204028406830702537636348202750403050407083704060486752364524567270545752301
10204000804000707000200000000020006000806000402000008040000000000000700000200000201
10206820704440747020487256846070642647456532502430356064376460502844405087704620401
10200040700080000020000000008030000000005000400020700020000020700050008020008000201
10645040602050742450368577807034386350703570306065803686847020527030402470808583301
10002000605070000050000050006000000040300070303000400000400030002080205000703000001
10702463633020276026287050606654774085833020604660236870408563602060267060408043551
10404000000050300040000050800000005000005000300040003060300050007040002050306000201
10303063603750206744532330744336207355807032426087302050337020384023803022806360201
10504000700080200000700000200000300040002000002000600050000060600040004000802000301
13406660224040656420705365405220503080874752876536378776685080446850682750302088201
10008000200030003000504000003000205080000000003000000000005040800070000000203000001
10825030807344807060606522372050707037558852806065574836808750302047786786258368601
10200040300000202030500000000020307000000040002000400000500060003000000000000000201
14808083888084605080308377664263804227433080707868604050683030567464762425554760361
10007070005050006020800000006000800000006050506000308080800050000000000000000040001
10837670802080376080533470285030348427355040422080203040808050742223528836484062301
10000050802050007060300040700080000000600040008070003030802040000000004000008070001
10568075604474302085308070305462433030804548708037747720508088608536724040664040361
10006030002000808050008020307000006080602000002000006000605000400070008060400060001
10505020373020308040802037705020402030747033888856402066608750734370305067305382201
10704060203030205000303000008050206030003000500000705000007060500000803000008000401
10803080208060806672868778624070205850302250485670608765233040504043608075768076801
10607040700080006000007000000050200020400030000000500060000030008000806000003000401
10402080403475658070404032286760804083754088273335752060252047676838204063476840201
10605000300000002080603000008070605000003030000000000060007000600020005070000060001
14608088443787383060705843402040504228403050344658558473307040502060205870403054651
10002000000000200050600000005000200060605000300000000000006080208020408000402000001
10433774563345803040425027564558728030704872503068407683857020707080378053686533601
10000000007000805020004000000060000040600070005000600000300050008080000050003000201
10522637804030208453506065365020208860803020803360778460805654437035836560204050201
10006000200040005000008000600050704000207000404000600000700000003000000000202030001
10507085306620523068378770804650237076505074206086658023237724208052647375484043621
10302000200060003000000060700070002000208000203030008000600030002000000000800060001
10607630647076203038557043252058208760207532507030803625706020865075662820204847201
10400040700080006020008050004000208000207000806080500000006050006000800000500000501
10533040684637366085306030205680206048387060854030324823288083508030207275585720401
10200040000000008000006000606050400060007060006000505000800020003020400000000040001
10208635685343202028325854502030746750508624707336807030204680537030502728243026731
10204000000000803070000000005040008000200000604000200020008000700060503000008080001
10804060207520802640358636864086808080762750603630804287486046503080607057576064801
10600040400060800000200000000060005040005000700030703000007000607060600050007000001
10673380325470804382502353208840783050306038535060703026805640603760222570806586501
10007000400000705000008000300030200080303040006080206000800000600040000000200000601
10208244402478288042545080878350708045302020808020842880726583447075704642576340801
10600000400000000070000080000070403050005000300060000060000080003000707000000030401
10585830378868487440837682424040608040326256278832276028808040307860283040454080431
10000080000000000060000000808040705050006000000070007000305030300060000030006020001
10662074443420484023472430204080208078307038208080287650384082656060345448306075701
10005030000020003000000050500070204000204000202000300070007000000060300030002030001
18603052675084603226404060675540803050808420604023207037808083482840804060525050841
10003000008020005000202000700000605020200000707000202000508000000020007020500060001
10703464405030758080456054704575605530666752502486303830206077884038845580202047301
10606000300040000080002000300000005000700000803000005050005050006020000000606000701
10743030306323466582604437782364357086408040256078857037474540204040546455606834601
10000030200080000000200000000050000080006020004000006030000000400030400000005000001
14672740462030784780605222334050405350274774307243303033364887767250708877546022371
10000080705000800000300040007050600070300000400000808000000000000000300000200070001
10732770203452705428883020252060563750608254368620502255367253643472754860503336801
10000000800000002000000030000040000000800000000000500000000000000000000000800000001
11111111111111111111111111111111111111111111111111111111111111111111111111111111111
