11111111111111111111111111111111111111111111111111111111111111111111111111111111111
10000020000000006000008000006000000000000000000000500060000000004000002000000000001
15806037824450504030486080503080538674307468846860302040808675306048308020263048501
10006020000000500040800050802070000040004000200030007000800000500050708080002000301
13646070444062544770603460207058364050342020703056377062723450407220307080605730701
10000080005000500000703030706060000060500040403000002000007000700050008040505000701
10688232308550504652605070502060674760206760562757303424402057352527584060806074601
10008000004000800000006000400030000080603040000050008000008000000080002080702020001
10803070542038535656453428406758748070406030482040364045334852552020605050408084831
10300020007000000000200000407000706050005070300060002000000000008060800030206000001
10845888285756632780807450385040505085846070807056404088802732405080207750405558201
10000000000040500000800070004020005000000020802040006000806000002000200020600000401
10735675442070808344667044206073808635425230602260288080703023824584443070357480801
10400000004050506000008040605000400000000030800080005020205080000060002020000070401
10205062702020807060304040306650666638888070262080803740378080876063803074788520801
10205000505000300080800020700070000000200070500050500060500070005000400040000050401
10706260806436757258573370203052866660203850204650582050703833407070826270856030201
10800020606000700000000060205030000070205000300020200070600070408020000000700020601
10422070806050608074558030406030605030457077467025206060552040604663704254607030501
10006050300080008000005060704000205000200030800030002070500050300000706000405040501
10503060628885852272505030202883377023704360506650564070606320306460247070507360401
10804060007000000030007000400000004000700080500070005060300000400040000070600000401
10505065802034708770407284242652304650503080804026304060348865478265625740646623801
10504000402000408000800000000050008000502000704000007060000000000000300000600000701
10505520507550728070544773764040583324725378207340348082764350402385504084405280701
10400050700030000040000000004040000000008000200060400070000060300040006060002000501
10374020203070343850733756405076853440707380507078306278868030384070805580807753401
10006000304040000050000030002000000060700050204000600000400020005060704000408000001
10807685752060385084326040403686672086723050206750377570805358504080834080203055761
10208000000020800030000080400000006000008000400040007050200050003070007060207000401
10805068802770705773274770668675603773404043528075805060836050583086402033403650201
10607000300030800000700000600000300030005000008000300040000050200030005000306000701
13407760882040357840606663602240703070653465386287838636254040432260635360302078301
10003000400040003000802000003000708020000000002000000000006040800050000000205000001
10562060406432304060403468477080207042782727402042448885304870702037584673653372601
10800030200000703080600000000020402000000050002000200000300040005000000000000000501
18806075538058703020206776333782503664324080507674203020535030564767663757547630631
10003020003020008020700000005000200000002020505000804080400060000000000000000040001
10645370504040252070652440345060728853745030836040207050205050335468246845646074601
10000020306080005050600040600070000000300070002060004080502050000000007000005040001
10472057404865506062207040305328273060503446608082443260402025407886444080842030241
10006080004000203060003060702000004040504000008000007000304000500080005020200070001
10802020273080204080207022808050803040666082453485407057803270677430306034405345801
10603040402020307000404000006030602040005000700000505000002040700000803000005000601
10202050804030504372565776677040406230503320388470706583577040605064808075273034301
10706050400040008000006000000040400040400060000000700020000060007000306000007000701
10802050508348227020807082374240206076872053522786762050333084244858307047225250401
10508000700000002030606000004050507000003050000000000080003000600080007020000040001
13604047627547676070608634505060306477707060634242265572402030405070406240606075231
10004000000000600050800000004000500030202000300000000000006030803030306000603000001
10365733874285503070237028355433365050204558605055507836487070603060754063647885401
10000000002000803060005000000020000040400060002000600000300030005030000020004000201
10235744807070707562603083763030803370507020405720567640803846466038424840402020601
10005000300050003000003000500060505000807000706000500000700000007000000000606050001
10705026803660666065574730705540736028303083806047355052735558405078536766788057831
10604000300060008000000060600020002000507000703020008000500060003000000000400070001
10307380768057204022277072843082303840505228408050802855605070588037644580204887601
10300050500020008040006030008000808000203000702080500000006020006000700000300000801
10423020226367887082602030808530803048728050628050276635374082408060604484726620401
10700030000000002000004000408050200050002030008000807000400060006080800000000080001
10302488666277703038828763706080844340703655802767404070502560462020204348538024651
10702000000000606080000000002050003000500000802000800080003000400050306000005040001
10505050605550703460673475723024608070226840305840407775258058506080206026423076601
10200050600070800000600000000080006070008000600030303000004000208030300020008000001
10756870462640704872602386502740468020303034728020505074203850408580668340302484701
10005000600000404000003000500020500080602030005060703000700000300080000000700000801
10608643204238578082673070768650303032305070705040547350887576766022507534265650401
10700000400000000050000020000080604050008000600070000050000020004000405000000050701
10284340725632637820862556458070206050525582558633736036806070802480266050538060861
10000030000000000070000000703080702040004000000050004000705030600060000070004080001
10333058388660462034863640207020804065508046203080547520534058874060624352308082401
10003080000080002000000080600030602000805000202000800020006000000020300020002060001
17307045375043808732404020883630305040502660707034405086306068288450202050766070451
10006000008070002000306000600000307030800000508000305000402000000040003060600060001
10204322805050287020866045405724505330556337205654702620207038278034485660204034301
10802000600070000040004000500000004000600000403000002030008060002030000000307000501
10536080403332653672207533577458567027408040562076477072457420804080582748306342301
10000050300080000000600000000080000020003040006000006070000000800040800000007000001
15845460643030546320505423243050803780582562703856203045837543224770605737643088731
10000020404000400000500020008060300020300000700000507000000000000000500000600060001
10334350806238304684758040624070426440303865874450505263627237877848582380204787801
10000000400000003000000080000080000000200000000000800000000000000000000000200000001
11111111111111111111111111111111111111111111111111111111111111111111111111111111111
