11111111111111111111111111111111111111111111111111111111111111111111111111111111111
10000040000000007000002000004000000000000000000000400070000000006000006000000000001
15703066343620704040225070706040284576406486276370408070603276807032703020285072201
10002020000000700020300020406050000030005000600070002000500000600060602080004000201
18276060653025746230303580207052222020457030207046247057646670202650706070602680701
10000070008000600000504080204080000050600070606000005000004000400080005060804000301
10557427406370205643504060208030356740805480252424305735705057542562274070705075601
10005000002000600000004000600050000080604030000020003000008000000080005020802040001
10406080853078785363772655204573423070408040583060736057452756723020206060306043241
10600060007000000000400000506000806070003060300060002000000000007020500040705000001
10363622787256527850704460436020306032347080205078706044605888803040408430306667401
10000000000060200000300050007030008000000040606040007000206000008000600080200000701
10652572778030203727287066703032207874558430607250647070805052462886562070433220301
10500000004080302000002060608000600000000080700060005070702060000070005080000020601
10608062807040506050805020603370772823338070276020304740233050263083704034468820201
10408000605000600070500050500020000000300030800070500060700050006000800040000070201
10703820202867828558555440703035345680203230808740636050602226508060352580272040201
10600060607000400000000080702070000050607000700060400060800080707020000000500080701
10276070202040408065863080405030802040742022367026407050644030605743803486503070701
10006030700040004000008070706000806000200060600040002040700040700000803000502020601
10608040485662245383505070808867848067306380405240563040205730805620653060207850701
10502080008000000040004000600000003000500060300020005020300000700070000070700000601
10707066307035705420406236428365707620706080306024707040267434662826778580366677201
10408000704000608000400000000060007000204000507000007080000000000000600000700000401
10607360802530763080575864442070435758847723305780446045823740502843503045403850501
10800080600040000060000000007070000000005000500040300070000040300070003040002000701
10277040706050662440384836402083423880504530707042704535782030277060705220405675501
10002000502020000020000020006000000030500060708000300000600040005050303000505000001
10305277765070723025384080505232624025388080203570824740504733804050722040203072771
10202000000030200030000060200000002000006000800050002030400060003040005020504000401
10404078205530302733636550477283406268205024448036308050833030283027206053703770601
10702000700030600000600000600000200030006000005000600060000060300030006000403000301
16403360734040253840305662706440707080376452562562283367456080244330547360302083401
10006000800040002000208000002000605070000000008000000000004040800020000000305000001
10852060208886605080408687524080607086362548203044355565804460706074564848324467401
10300080500000306060300000000040602000000040002000700000200020002000000000000000401
12304045788043507030502735837878205476445080206545404050485050766235677777723770421
10006020008060008050500000008000500000003020702000503070300080000000000000000030001
10582880208070364020248620232060764582462060676040707070507060444852678775322023701
10000060502050006050700050300050000000200050002050002070608050000000008000008030001
10754075304873407053706050602536322050305585304067457720603047502788287060283040421
10006060004000706030006080806000002070308000008000003000502000400040007050700020001
10202050886080708030702043705070203070254027525758608025703550337480205023202462501
10607070805070205000503000004060306040006000200000707000005030800000505000004000601
10807040506080507656875558387030507820308720722250808422825080402072808076623025601
10207060600050004000006000000030400020700070000000500040000030003000406000003000401
10808020607648678050408066352850708034573087757844646080685028526667604056783460501
10506000600000006040808000008070808000007070000000000060007000500020003060000060001
17302063853542838060805556607070308788205030388767286357305040603070502580702087331
10004000000000200060400000006000700060607000700000000000006050407040702000405000001
10758486443273804070454033342667623080508755403074204323326070208040545065242337201
10000000008000507050005000000060000030500060008000600000800060005030000040002000801
10865323203080408244305072685020804250406050203850487450708686586022422780806060801
10008000800020002000002000700050407000204000502000300000500000004000000000502080001
10605074705380785073422680605670437064603054805054265043378454204082278838555034581
10304000600060002000000070300040005000807000504030004000800020004000000000800020001
10205830337034304022558034557054506420706785302080603845502050733074722360802542201
10200050700060003050008030004000202000508000502040500000008070006000700000600000501
10542040584436252026303050405670504087654070455060343638878065203040406452663630801
10300080000000004000002000802050700080004040006000404000200080002050600000000050001
10605545876446404027374582504080478770605623407244608040608670536070704445863053751
10705000000000405050000000004080003000600000205000200070004000500070502000007050001
10505080502770208680348638528055607050572780807870305367683053403070803063528044201
10600080600040300000500000000040005080007000600050807000007000504060200070005000001
10228650535240308432304222306880385060608032643080304058707740607470755270205362201
10004000700000507000006000400080800080405050002070202000200000400030000000700000801
10803475207742423058446030588220605023606020406070284450562882444087403822486370401
10600000700000000080000020000020708070007000300020000020000080007000507000000050501
10685870862387478440353852458030402070568247223553528084702040506370777030836080451
10000030000000000060000000307030808050004000000020005000708070200060000020006030001
10227067488250838054663630304080706023305075806040378840735038354040646334703036201
10005080000060003000000070400050502000607000607000600050005000000020400050002080001
14702042868026405224207050835760204050705870405022204055403065846760804020646060741
10006000008060005000702000200000807080400000207000502000208000000030002020300050001
10802467607070423030233063306742407860224473603658607250306056787074848750706067301
10302000300020000070004000400000002000700000508000005040008070006030000000507000301
10735030402834584466805834332766734083204070787056362028825270802020287442504727501
10000050700030000000600000000060000070002060004000004050000000300060300000007000001
17485620662020828740602663824030808730362667407822404025642643283540306583633084721
10000060304000400000300080002020200050300000300000605000000000000000500000800020001
10842380706264803464656040266070487620307322753480703375465438663443778870203754301
10000000600000008000000030000040000000400000000000500000000000000000000000500000001
11111111111111111111111111111111111111111111111111111111111111111111111111111111111
