11111111111111111111111111111111111111111111111111111111111111111111111111111111111
10000000004000000000000000008000000000300000000000000000000000007000000000000020001
16607067302076687268602420324037408040406025248066457332772578504060885420878050701
10208020003000000000700070000080002070306000006000700000000000307040500070004030301
10206260282548445220804070245740258850802236206060507046555450203070202077704420201
10600050000000000000808030003000800000400050003050005040007050300060808000200080201
10228060208425487753838070702023805623526880456030234240708030654637807040303020401
10600020603000000000400070507000708000006000700080400000400070600000504070202000801
10502320234084288740304060208730533060603067305588404047726060208850408380807374201
10300070006020000000405060203080000050600050500000006070006050802000308000200000701
10673080507060383844204040703062438550286830805074337072708040607064304064668830301
10000060300020002000005040400050005000800000403000005000004050607000007030004000201
10477380505372432020425050553554808068504683504024604663305020207067427080503550801
10004000500000600070300060000000003000607000703000200000703040004000008000200030201
12502045253443304333804037678882266020307580208840427850205053333350603523336050401
10004070000000503020004000700000005080002000300080000070803000000040300000800080601
10646060578450202050506420204554203383606062706083303050367477577058676560804854801
10600050300020503000408070800050005000708000507000407060200000500020004000600020001
10207020204030304067603070246040722060585360643620407040208460304040504052326020631
10205040505020005000800020004040007080000080006000503040500020606020300040002050001
10703030403088438352207372308020202685765024403043507050455030807020847750303068301
10502040004030002000504000300060500000003040600070002040408020008060000000704000701
10803524582040203020704020333040426738803050703530448070502078543723466042652660701
10700000007000307020300080003030005000606080500050700070008000000060006060007070501
10737442872275606020536470205683804040307050233020303843444674227060608420807070201
10000000700000007040700040800040002050200080007080400050000040000050708000503080301
16433020404358564050303040737060648070484347803040404050483060702730802054506050501
10007020400000003030002020607080000030000000803080604030700080700060706000703000301
14608740408562405080557060504050865075884740307060205060504520883430307420705640701
10002000208000400060005050506070005000000060006020203000808000800050800050600030501
10205042768060342227808050406050806424263784687230374576205025207040804020648074301
10806000000050005000002050008030306000300000000000300070002080007000208080004000001
10803828366878305033634060826065407080306038664584407070855060636844356060506067521
10700000600070002070000030200070005060007000003000807000608040007000002070306000001
10557227605050482030508430202670243064863348304060402525204047307033205073608082301
10600030008000300070800020803050800050000000203040600000002000503000804000003000401
10207030207645805870204220504040404283372870436030202767468020306230304544228080501
10004000206000005000504000408000802000000020000070200040006050508000600050005020501
10345084306035344035723047206436605040423025452470863050504070208040455025407080201
10004000307000400070004030006000500070005030000000300050403050308070005000605060301
18504753804070208276708040785040565553402080808283503688206040507050608650507550701
10007000307040400000207030000030300000208000700000200000004030200050402000200050301
10565030306020853560207057588420853770684578466450325077608040682478808060206070301
10400050002070000040003000000070600030700060000020002000508040704000205040607000301
10403848884020487072528740222070602030704020455060808460773030702020366040364782601
10600000800050004000000050600060003000202040600080400080600030002030000040008080001
10802630208577403344422040507822364558743020802857756026204037278022305524302050361
10805000203080007000004030600000006000006050400000000030006000007000800000200050001
10334060606050704080388030322757807048806046402243826770306476852820605540607267401
10600030303000706050800030008000708080004000603000000000208000008000604000803000701
10706638807673778040502320502040402050866680333032477337456073806076376034807030801
10700000700040000050700070400020800020700000200020000020006000700050003050506030001
10823560736020205064873030473030404730505048404060526080205060403270206070502050321
10000080006000208060000050003070406080004030007030007000307030700080600040006050001
17538066603752503060485527606480707076544880504023604727602380754070857255327072301
10003030006000002070003000802000700060006000504000200000502000500070400000006030501
10805040434636648032502350405084633640708054557587706230602040507540804847202020401
10403030200000005000500000302000000060802000200000200020200050200050203000305080501
10468050775737606740808865304323505020804040603230287450722247864020504065802030801
10008040005000005020800000400000308000804060500050000000300000005030002030007030001
10707036404064627050234682837720733483205070438045464663478536402077748050758085201
10507000506050000050000000000070000030008040004080000000000000606000000030008000501
10702870207020404383885365436050563050623733478050737324628750304525387482502530821
10400080800060800000000000400070400050000000700040300000006000300000000000600050001
10586080664270848840836580802478403078744240708350204557707055436785605450868083301
10002000600050000040000040300000803040000030200000403000403080000000500050000030001
10408536704050572065766050227030707050804070732043503050305035402830806032872850541
10706000006050002000002070004050708030403080004040002040806000300050207000000080001
10607077765047462042406457603680705630862056205480833036805020677360708222852056201
10600030700050002000808000706000700000200080606000500070008020000050400020007050601
10364570308630505842702030258080768486605880705040504860377070536040502050778060601
10200000300000500050003070000020007000003000800060300070505070006060708000600080701
12203064452373452050254030867650362077543060864540602050507050247020502382502720801
10006000000030002060700060000070700080000030200000508000200080500060807000500000601
10507468443066604060703038237030608750504520204366735753656070702270607070702257501
10200000002000003030203000300080200000307000600070000000005020500000507060200060501
10368683777023222080407842305846475234302067555670508432206080263868348030723050401
10000000003000500040007000004000600040008060006000602000002050800030400020002000601
10335345407653502083568026867580303080354050802082507082473060408080707663704765201
10002000800070008040003000000040602060400070306000808000300040004000600060007000201
10403080565050707080504255763040808420607660306730456840658624542358578080348020701
10700030005000608000700000007000600000500000500030000040000000000000000080000020001
11111111111111111111111111111111111111111111111111111111111111111111111111111111111
