11111111111111111111111111111111111111111111111111111111111111111111111111111111111
10000000006000000000000000007000000000600000000000000000000000002000000000000060001
14708062706087834772707380235035807080504037783037827556478752507070776480786070201
10303020004000000000600070000060004020406000008000200000000000404020500070003060801
10504280286424667840505060282540822830704773406050608086535230604050505065504860501
10600030000000000000804030007000800000800080005070007020003060500020203000800080801
10778040702256536487868030804025308454774730587080526350608020444376706030204070801
10600060805000000000800080404000703000003000500020700000600080500000207020808000201
10307720646043544740202040202340446050506063808678405055867060408750702230407732401
10600020006050000000505070807080000080600030500000005050002020403000303000300000601
10225080408020862744404050808026563450283560804083586062604080206043406028284460501
10000030700020004000007070500060008000500000505000004000005050407000006020002000801
10435350207358585080455040883575203065602787803067605733708040207023826050307620501
10004000300000400030400050000000002000606000205000700000306020005000002000500080201
17707042534333503822306072746487834080702380505840366640307026482470606372253030601
10002070000000406020003000300000008050002000500080000050502000000060500000200040401
10873070344860407080702820806854803883804052405027203080275843848056478240608276701
10300050600030208000206050700030002000302000403000705040800000500030007000300070001
10508070303050803058204060558070848070433750425730305030807680608050505067468080771
10307020402030007000600080005080002050000040005000402050800080403060800030003040001
10207070402052825743608867205020202366782064203063605040826020207050754530602032801
10607020002040004000804000400080300000008060700030008040608050002050000000707000301
10206458658080603080802040548030555757506060508420682070803074453446468077242270401
10400000006000207070700050008050002000808030400020400030008000000050007050002060501
10885834452222207080248650506327205070208080424020504724542367723070705420802050201
10000000400000005030300070300020003020700080008080400060000040000020408000606060301
12875080702265552040706050432020736060286635706030708080846050602670606068704050401
10004020200000007050006070504020000020000000506080808060800030500070808000207000401
16406860505735606030378040204030456056287640406020205050606550267720204770805280701
10003000506000600080006060403060005000000030006060403000404000300030700080800030501
10605084657040435447205080304050702634578754842630453733608053802030802050583087501
10805000000070006000007080008060408000800000000000200040006020004000804030008000001
10207233658568203032442070454024604050203024337884704070244030837674542080606057761
10700000200030006050000040300040008070008000003000603000408070007000007060705000001
10626574805060227070204270807370463076853473205060702273306057806023303087605068201
10700070002000700030200060405050400040000000302020800000007000604000403000007000601
10704040306355203650504880707070603746487220567040605665656030206850707865276050401
10004000202000007000305000204000708000000080000020600060008070407000800080005030301
10576076508064774048554056302563206070742086365440764040205020304050323084507070301
10005000507000200050007050003000400040007070000000400050802060803070006000505020201
17606737802030506578206060774030755883508020407528402756506080805070208870708440401
10005000508080400000803070000030500000708000300000500000002030300070804000500080201
10344050607050284520306054375560653280632682227220863027604020246753805070304040701
10200060004050000030003000000060200070800060000080008000307070405000308030704000801
10806334685030357062466420287060402030406070326070408550642060607020235040327672401
10300000500040007000000030400060003000505080600060400030700060006070000020003040001
10608270508628603347746050707552886253532060208236224056808087475068406872405060241
10507000603040006000002080800000002000006030800000000030005000007000400000500040001
10663030405060802050385030267663705083503084406227323850208474434360307750202382701
10500060405000206060700040005000206070006000303000000000507000008000207000205000401
10504772404462286040606260407040702030378880372082455656728035402064373044407030601
10500000400040000080300080600080800060500000500030000020005000400080006040406050001
10227370828030208062846030257080205260403032504040233070405080203380605030805040631
10000020006000208060000030005040408030005050005020004000704020700050200030003080001
13343042207763202070333882608580806065224340604056408627305520348030628645424072701
10005070008000006040005000607000300040003000202000800000404000700040300000002030201
10702020774377443077305360204062358470408055524338405560503040708870706864308030201
10608070600000008000600000808000000020306000800000200060800060400040204000506060401
10427020487726303340406262203636806040803050503760683720766882322050608072304040501
10006050003000006030300000600000208000607040200050000000200000008060008080006040001
10804075408026665070874735773640535378804040662042377327284856607088827060763085801
10603000806030000080000000000020000070006040008040000000000000508000000080004000401
10204420404020502675326258537030663080326666826080336527425580208563755583303450881
10800050400080300000000000500020800050000000800070500000003000800000000000600020001
10325060885630382740244770406774403048727440404270505448703076568434802440337065801
10006000700070000040000020200000806060000030200000807000707060000000200070000080001
10507232405040776078633020484080708070802020553058406050202046308670406078432270481
10503000004060006000004050007080605070506020007070007070705000200030608000000030001
10702042848053262067506852506360808560277027305340638078607030247550707755477043701
10300040600030005000806000404000400000700080206000600030004020000060700050003080401
10582740806770607853802020558070477446204230305040302470544070352020303030264030301
10600000800000300020005050000080006000002000200020200070302050006020806000300080301
14206025354336646020555040657730622027687040847750303060806050488050204478604340601
10002000000060002080300030000060300070000040300000808000300040200050203000400000601
10805662573054203060503052836020205240807240208373425267585050704530507050805835801
10800000003000006020807000600060600000204000300080000000008020600000806050500030201
10336233383066884060707368408465658466403024466380304434208050253736478080853070501
10000000002000200030007000002000400020003050004000506000003020600030200070006000701
10347555603266208037437072355340704020566080803044307085848060802060408255508343701
10006000600070003030003000000050502060500020306000504000400050004000200070006000801
10505030526040604040808823347020802550508470606250234270868268533633854060836050701
10700020008000504000800000005000800000200000800040000080000000000000000050000020001
11111111111111111111111111111111111111111111111111111111111111111111111111111111111
