11111111111111111111111111111111111111111111111111111111111111111111111111111111111
10000000000000000030000000002000000000000000000000200000000000000000000070000000401
16464073202075745060478274407070467354384357782420302428787024728330683050608370201
10004030004000003000300000205030004000000000000040008000005000000050005000700080001
10503340644066307356507050304026365030378446687043538464604734334068502578556450371
10800070006000700000703050800070000020003000003000000060003000008000803000000070001
10365082807080466430703030766350406338703027206673452050786027355268805057583073801
10004000406050002080007070000000406000800060700070004000200070000000006080000070001
15606050205785404022678050727858504050355230345060606673605060278832478360404280301
10006040407000303000000070700000600070700000200070400000006080000000000000600030501
10603220508070204033704460608020742750605283407760228370758080524745566232567040501
10708000704060002000700050506050000030200020700000500020600030000000000000007040401
10768048405066468030453460803078884020676060806045403072207034364433825444527060501
10200030006000006020007000203050006020000050708070207000004000000000000080000070201
10503750802283806774704082804042804065335870402060502484527027552630504020383550821
10703000800000600040008000207050007060000020808000700060005000000050603080800030001
10707050466880875050375770502070706080202040203765824042303267826080473070502026601
10504040000050502080600070406000806000703000700000008000408050008080800020504000001
10274030358080203088307070607075206238403728767360208670405080206028607370603855651
10300060007020006000208060803000205000300000800030600050004000600020002000600000001
10304086608056646730684020604070503020343423504060266050666420647530704044582374401
10006000508000000060800070505070500040000060006030400070000040200080805000000070001
10863380404682537660605450503030482880582080755065508027652050502060368683482040471
10004000300000008000800020008070000020700020700080007000007060802050500030000080001
14407086664786305083806073278078647040802532408730677444586027707050506030423373501
10008080000060002000508030004050000020500000600080006000008040008000604000800000601
10286040746060275860438075404080235570624550834030302048202670205678804364503020201
10300030400050007070004000306080400030007000600020403040006000800040005000003030301
10402450304775308050208780404050466053606033802050804480205087343860506082672080601
10300000300000700030500080800060005000705000206020707000208000300000705000003060001
10745762473350308760733060563027402660203020303520708020605050802063435280507064681
10000000004000600070500020002080500040008070004000300020402040208000300030606070001
14443557206080843760408634806080507024428720665074726330305330606525505067207082801
10000070005060006000500000305080304040000050500080000070305000700060008000004000001
10843023545055507080366840302080535020406034804830546050608060777080435087636676701
10503000000020008020500020604060003000504000306000502080705020407050008000000000201
10406068822587463080203020307033308052806570606023502033206020302060508373786030501
10007000004000000050007070008000003000806000507000008000503040004080200070005040501
10428463804040424753646030435644553660306070406848838280542046887028258040705320351
10500000302060002000400030007080003000402040600000000070000080000040004000300060001
10503220435035705050707074608060608785205060466725232070743720765380704833847083401
10204000600050003030002000602050200000002080007000400080600000600000408000003080001
10502072305842844020752556602070862534462065202070508330405376407336405046705023771
10604020002000004040008000200030000000800020003050800070500000400000806020002000001
10406050257063403047606070435527735040703470538040404050827740587240608070753325501
10302000400080007060007060000080007050500070400080505040000060000000600020200000401
17703632367560623060266026843030504670838050406020442077536336462877566520307645501
10002000000020000040400020005000500000700080008080008000005000000000000020300000501
10333632765082407780705240802425834462203554667072403070404050526540724070544780601
10000030004000604000400080200000000080004000503070008030400070300050300070000030001
10534080708520204058378060502346624660865060704080836023666425203026605746825036781
10002000500020505000004000407000800000200080507050006000200000004040003000400080001
15306460384040802823208738642030502246406670602060705030502778702020827080803250301
10300080007000300030002000000050300000306000500040206040700000508050000070300000801
10483035426588227020426028406460633380405072735070707070454430707052368470288423301
10000020000000003020002000500040003000302000006080503040007000605000000080000000201
14786320608840407020506440704068282030675646507040804426406087358064663040206430801
10000000200030400040400000405040000020600000007040600000405000002000500050500020701
10522365356058288750266278382060377868303037753720727870808864804034508550707020201
10000000002040000060000000300020000000006070000040207000700030005040004000802040401
10202868803060635070825367508033752358567080443040602058336020288280263067223040801
10207000002060600050000080008000000000006050700080002050200030000060007000008030601
10855034543070603686705040742640236743846030402765887080305826384038807035208060401
10007000300070203000402050700050000050000070200000000020002000800060008020006050701
10208260432720606740704050463050352360828730534465774644623030806832262460865380201
10300080000060200060608030000050205000500070004000000000600040400000400000700070601
10487060433023285040547060227470608053475028804030372560505650583230604784564080501
10005050004000000020000050003000706000006000404020003000400020800000800000005030801
13282030408463344364726377305063603063802740708020207033274050402088837674807040601
10000070203000005000006000004040002000200000600050206000003040008000000000200020601
10345756807024727040507332842050423580708374623653308828406060852086567280636220201
10000000607000008050404000000040700000500000005000600000400040005030005000204000701
10242580207822207058203082328640808768655754308020705750307565604870404055803073801
10600030303000700070008000000000608000300000804040706000200050800020805000004030001
10203050427070836660736477354573603048404680508020836050428020787040706052777020821
10007080000040000000700000700020007030004000505040000080305000800020208030000070001
10756033466744474485307050604070442060653037785023438860708066705748207470302246201
10508070000000000000702060008060000030700060003000300070003000300000508000800000501
10704070308744866880203077325065356630204520802870603022324882207440702078545820201
10802000500000000060006000300060003000705000800000708000004000300040005000400060301
10305468647777453855255550308384402035252050342433206674202060655774542845208025501
10008000000000000000000000700000005000000020000000300000700020000000000000007000001
11111111111111111111111111111111111111111111111111111111111111111111111111111111111
