11111111111111111111111111111111111111111111111111111111111111111111111111111111111
10000000000000000080000000004000000000000000000000600000000000000000000070000000201
15546054806064684050852252305050633367267865658360603544576085352570737080405320301
10002020007000002000700000608060007000000000000070003000005000000040008000800060001
10407320378057306355404030706026887080332657826082473237806556442083205682658360621
10600050008000600000402050600020000040008000007000000050002000008000604000000020001
10363042305050435680807050824450207356205072307255437080484082275624204044883023401
10002000407020004080005050000000406000400070800070003000400020000000002030000080001
13806030802754605067387070375664403040583770766020606625208050826548267280402380201
10004030505000602000000070500000300020400000800060200000004060000000000000400040301
10402730202060508082204830306030455650502742707520772380522080528668763827525050301
10602000405070002000800070706070000040800070300000300030800020000000000000006060701
10336063806058776060356530203057358020837040306073806077404022455552446577557050501
10300060008000008040002000606050005080000060205050704000002000000000000060000070401
10607520308757504775205072403053608027245280304050602645225024647420803040224760431
10405000800000300070002000307040004070000050203000600020004000000080603030500080001
10605040872450257060775880308060307040804030204285342087207386447040835060403078601
10303070000040707040300080308000202000504000800000006000705070008050600050502000001
10238040542040506047705060206056504362506672476360705750504020602057405430603364281
10600050005060007000805070704000306000700000400040500020007000500080008000600000001
10308047805034353760452030508040603040885362606050443040833760832780206047347468601
10007000505000000050300040802070400080000060002030800060000080700080604000000070001
10577880306357542470704660304030563650687070382062508067834060608030284257724020351
10003000800000008000200040005070000070800070300060007000007040706060500020000050001
12408085865832808045204063233078877060306745805860463764467055404070205020358836301
10004060000030002000706080005020000020300000300070003000002020008000508000500000801
10778070547030873350273046304080656880673750333040506032608350702262806682603060701
10500030600070008080006000505060200040002000500060507050002000200050006000003030201
10808770604353707030602630304030524047806047503050503650308022468550204035422070501
10700000800000700070800070500060003000502000604050206000603000700000807000004030001
10776234466280307230466030752077406580606020504620303080505080605067383570607085721
10000000007000200070800080007070400020008030004000600030603080705000600080203070001
16455555206040582250502754503070208026747620357045426450205580805477305056306045301
10000030002040003000600000506040308040000070400060000030502000700050005000002000001
10656065683058606070744570507050278020502072807350783040402030867070232035838622601
10207000000080005030300030604050002000503000403000702080508030304060004000000000601
10604063384358648040304020502066303048208530507067807035808050707040507556563060701
10008000005000000030008030004000008000708000705000005000603080008070200030002040201
10582543308080758363486070853682885870408040608628778270433042328038276040305370881
10700000802070006000500070004030008000303070600000000070000040000040003000700040001
10707630346053706080208082403030804344708070572886774020824670325730807765674073301
10507000500070008030004000702020400000005050004000800060600000400000207000002060001
10807068306343252020823224403030627657883074607030708670405425704876707044704088741
10205020006000004080006000400060000000800060006050600030200000800000403070002000001
10607030638025206078306070642648722070205550428080604080226220384520404060823584501
10603000600020008060007070000020004030400070500060807060000060000000300060800000201
18504583672320772030368052857070806480566030304050763028387247463443834360608384801
10003000000070000080800080006000700000700040007020004000008000000000000040800000301
10264824447027207850303240303226738338503484227024602020707030364230465030368680201
10000030007000506000500070700000000040002000406020006020800060700080200050000060001
10674040503650803033338070804687746840578080502060527044524338308046708226662026631
10005000400050206000004000207000200000200040205060002000600000008030005000600030001
12703620764060803384203625622060405776305330204060808060608286206070272040706550501
10300020003000300030003000000020800000603000800020804040600000805060000040300000301
10564058623586557070656065508750764670204042552020703020285570803046786670738644201
10000040000000008040005000700080007000404000004070403020007000406000000080000000301
16748380703540502060308280408038326040886766602040204228702064836077583030504550401
10000000800050800020200000504040000040700000003080500000506000008000700050200030601
10575326843037633580745448422080272456702025368360576570805353807028302620802020501
10000000007060000040000000300040000000008020000060802000600020005080004000203070401
10308487804030637030656423808048584322262070775080704043522020263820482078634040701
10607000004020500070000080006000000000008060800030006030200030000020004000004060601
10287037486050703467806030745560547732582030204637477080505356745072207084208030801
10008000800050203000706080400050000020000040700000000020006000300080007050004020401
10707830426340505520308070828030877840527750365747847483845060504742327530658580301
10800020000070600080604080000050202000300030007000000000800020300000300000300080701
10253050544026578020786040428450402053327088305070332640707460252850202825478030201
10003050002000000070000040003000504000008000803050004000800020200000800000002040801
13782080405542328878547828805064602077603350206030804052734030407084377243505080301
10000050704000002000008000004020005000800000200070404000005020007000000000700050501
10826363404038834040207456825050736660306577858534304885506020473025888820424760801
10000000205000002020504000000060400000500000004000800000600020005020006000607000201
10445730506653203052605035648460504253558323807080508350702767404720205022204072601
10600070305000600080004000000000207000600000804040207000200050400020206000005060001
10207030886020446260673285247385402084702230508050377050272050344060603056576060251
10005020000030000000500000700050002080007000602080000030707000500020503070000050001
10783034845478582366303020703030523050474023622034627640503032304277706320506462201
10805020000000000000207050004030000070800050003000600040002000700000404000300000801
10408080205454774260708058425083734720204880307480306042325874605480706037343670701
10203000500000000070003000700040002000704000600000307000004000500050007000400080801
10403575873624778474884780607583608066768020354846608223307030888835824556605084301
10004000000000000000000000200000005000000050000000300000600050000000000000005000001
11111111111111111111111111111111111111111111111111111111111111111111111111111111111
