11111111111111111111111111111111111111111111111111111111111111111111111111111111111
10000000000000000070000000006000000000000000000000800000000000000000000050000000801
13234045608045825070826824205040752626644262744640205282677078585560573020506880801
10003050002000002000400000308030006000000000000040004000003000000050008000200020001
10306320553053707664808070203052236080455838843074827536307745287047602384763240831
10500050005000700000604040600070000080006000002000000040005000006000203000000020001
10263044608060284350306070628540404724507086705288623060744064377775808077843026501
10005000208050004020004020000000605000700020800070006000600080000000002080000040001
17603040303463806046732080736325604080585630268080505657205060467778355620208380701
10002030203000307000000020300000200080800000300070700000002040000000000000600040201
10807520507020307036806670408020424520707788308860783750538040354624557367742030501
10607000203020005000200050807080000060400040700000700080300030000000000000003060801
10582065606083446070735380702073783070267020305056706084608028476757645874558040501
10800050003000008020008000606080008050000030803020602000002000000000000060000060501
10807230303683407343205082306037802046366350305080807347848047472520506030267240351
10203000200000500030008000702070003070000080803000500020002000000030203020200060001
10203080838720625040468540603030207080606030602868536062608453533080367070408077701
10603050000030406040800070504000607000703000400000006000504020002020800030204000001
10424030455040608052308020207022302434402674784880504540307020208072504440203568421
10300040003020008000407030608000407000200000200040400060002000200080002000500000001
10505088408046343570347050706030304040667528502060223080246680736740808062884767701
10006000804000000050800040203030400020000040005080600030000040300050308000000070001
10755320605443586550808670806020825760786080754047803087862080708030553833274070251
10004000400000004000500040008080000030500040800080002000007060205030600060000070001
12304026838656704086303044773077546060707244405870363377434076703080506060358844401
10006070000020005000408050003070000050600000300070003000007020002000803000200000601
10362080448060338720247078808020368720825540546070806046206560806375408328706030201
10500080700070003050008000204050800060007000500060808020004000600070004000005030501
10604820804765803050404330206060845044805045602060608620703048846480706023668070501
10400000600000600080400040800070006000808000802030603000707000300000804000007030001
10767748277470202680746040387056403660708040204680505070708050502065273830503048761
10000000002000800070700050006070700040007040003000200070206060702000800070803020001
14427382602050483830805765602040704068443230787025358370602860303383503064604073401
10000070006050008000700000702060605030000080600040000050507000400020006000005000001
10486025364044706050668540702060364070808058305240583020807070864050268035288544401
10303000000030002040500070205080008000606000203000405040807040604070007000000000601
10702043586744427020707060607043807043507580704055805067407060607030506823742020801
10006000006000000040007070003000002000205000807000003000202070006060500050004050401
10484256804070686676662080554225347360507040202265855630264036258036227040603680521
10800000407050004000300030007060008000303080500000000070000070000060003000600020001
10204750434047505060502047603030507523407050253445726040446570238240702642564078601
10608000700020002080008000208070300000006040002000500070600000200000508000006060001
10405078404282735080252656706040827568728064708030508760203673502524403036507046351
10808060008000007080005000800070000000500060004080300030300000400000706070007000001
10707040542065608022803050378655552030302330622040208030585470766280806050678255501
10407000600070005040003080000030003050800080600030203070000070000000600050700000801
13706435278760383070463043262080405620845030707070286072866263245263734620608635801
10007000000030000060300020002000800000800050003030003000005000000000000030300000501
10576322434052306450704870306472747632305773773073506060507030838570428070535280601
10000050003000404000300080400000000040006000208080005020400030200020800070000050001
10375020506830306027738030604246333370378020606060442064788776603076806223623056581
10004000400060206000002000305000500000300020207070008000400000002040007000300050001
15306340572060505576705866227030707722503630602060207060702828706080824040305750601
10200070008000300030004000000020800000403000600080402040600000308040000060400000701
10355042756832267030765022206880378820404023872050805020543730204053643270757538301
10000040000000007060006000700050005000307000002040804060004000608000000020000000301
12746280308250804060605370705066735040242378702020205857402052668054233030806670701
10000000500060400020400000503050000030800000008040800000508000006000800030600070401
10822588468037626480536822673070677264302088353220323340207385803082402850404070601
10000000008030000070000000400020000000002050000050807000600050008060003000403060601
10203787403080638050756537605047547657264040358050806056445050226850244028456030601
10404000007080500080000040004000000000005050300050005020500040000060005000003020701
10866043367040306282207080823280854722558030406578346070706763748022508084207020501
10008000700080807000306030600060000070000070300000000050002000200020005030005050501
10507480863260304550205040622030474820866850452483833877268070604256347340666830301
10600020000050800080504050000070204000800050006000000000800070300000700000700040201
10733050486067444070348030633720502056665057605030642840506540345480305632534080401
10007040004000000050000050004000402000005000306020004000500080600000300000004060701
14375020407672232626572234305052602027608320606060308066253080508025372727205020701
10000020607000004000005000006020004000600000700030802000003020006000000000200020801
10285736603032627070202284485050543340604736334755606682706060447043242620325530501
10000000808000002020804000000080200000600000003000400000700020002080003000507000801
10368820806455603054702075527820603667366238506070703840407232202420202046406056201
10200070603000500020003000000000207000600000306020602000700070200070208000004050001
10205070477020425480227878625674305088607840306070543030468050683040802038745050341
10005060000080000000400000400070006070003000606030000030603000600040706080000050001
10537024846825384564403040407060833030543048524046867420407035408233305420707457501
10203080000000000000406020003020000020700060003000500040004000700000507000300000701
10804020805382222520602062882082828640307320604350506037768743804270808055445720701
10205000400000000020006000200060007000206000300000607000002000300070003000500030801
10703627747272587682267230606587504064827020856344503365302070667356458266208085501
10005000000000000000000000600000004000000050000000600000700020000000000000004000001
11111111111111111111111111111111111111111111111111111111111111111111111111111111111
