11111111111111111111111111111111111111111111111111111111111111111111111111111111111
10000000000000000050000000002000000000000000000000200000000000000000000080000000801
12747075303044322060877737503040423327648845224780603525283047784430256020408830801
10007040003000002000300000307050008000000000000050007000005000000020008000600030001
10603480576048804224803060305028478050457587477044662323706262552046708554872560251
10400030007000700000306040300030000030005000006000000040006000003000302000000050001
10265054203070585260302040285760203727407034302372633070444046564372303058874076501
10007000706080005060007080000000802000400070800020003000300040000000005020000080001
17303050605545804063446020256227204040548530637080506683404080678264424260404630601
10007020504000406000000020700000400060500000600070600000006020000000000000400020601
10503840203070806057708260304080723270304328505640664820372030866237783768426030701
10705000403040004000400020207060000050600040300000600080600070000000000000005060801
10745035208047428040328450607053687070857020602053307022507056855866778837425020601
10200070006000003050008000705070005040000080307040608000006000000000000020000080201
10207430206256305275808075602037305065587650407070505628275077523460604050786250371
10503000800000400060006000202070002070000070408000300030002000000030708040500030001
10806070575750773020733680507020208070808040608336254086403254834030465080505062401
10804080000020206050400080708000402000508000800000003000304070002030500080406000001
10525030778060608078807050204075706483704775765850806440606050307023505630702287621
10300080006030007000807030708000603000200000400080300070005000800080006000800000001
10805053503067385480764050203050506040658773503050844050442660828580805034522627701
10005000304000000020200040204020600060000050008030500070000040600080205000000020001
10846740606234584330508370804020588640682080835046304034527030405080833887722030381
10005000300000003000500050006050000060500070500080005000008030305050500070000040001
15303045336662402076504025834063822020604824707460374668752033305030205020873745801
10007080000070005000705050007070000050600000700070007000003020008000204000500000501
10236020428080746560744088208040633670565720273080505075505370202775502628705040701
10700020300050008030007000202070200030004000700040705030007000700080007000002080201
10507740306333302020503660507060648066705088303040502640602045228870202064378050301
10300000500000500020600060700040005000306000603030402000705000500000704000008040001
10373767842320704440585030657034604420505030508830306060504060302076528850806085241
10000000006000800070800040004080200080004080003000800030204040306000800030505060001
16726445708060276680607826204060702073472340656052247630302730203557806024502045201
10000050005060005000300000203080207060000050300040000080503000800080004000008000001
10273044644077604060628360703080367050204057502250734070704050637050287032755532401
10308000000080006070300050407060008000805000504000205040307060402060008000000000501
10803058857573252070805080703077207062707370707072707064408080208050703677875020701
10008000008000000050005040006000004000305000604000003000503080004030500030006060701
10277777705070287472823070253456685880203040502428333470734025673033486050606480881
10700000507060005000200030008050007000603070600000000060000050000030005000500050001
10602550744028803020805086203080607274504030472723734070255360675880202523655087801
10503000600070008070005000306060600000005050008000300050600000500000806000006060001
10404078302648858050668763207080352644525024202080304480705677806866508088806068541
10406060007000004040006000700070000000200080006080700040500000700000404040006000001
10305020357026302082605060846427543040302350654020604050347270853330506050887436301
10808000800050004070003020000070007020700070500020804040000030000000800070500000401
18506755344880686050843045754070707280364020305080342084442356648858566840804274201
10004000000080000050300050005000600000400020006080005000005000000000000070200000501
10523322766028502360504760704742486385505427243038205080406070345270473080763470501
10000020003000702000700070200000000080006000506080007030400050600060400060000070001
10776050302280604036667040403444875580265070503050836062883752303057707276234028571
10008000700040706000006000308000200000300060808040002000600000008030006000600050001
18303530783070808467805533758050608855504860706080302020404563206020477040808540801
10800050008000700050004000000030200000402000400070506060500000205020000060300000301
10865077366764583060777064808470454770805054452040407080556860508046674330282263601
10000050000000005070003000200030007000804000005030307080008000806000000040000000801
13765480408540606070704630606072726070528845206040505643605078785027244030607560501
10000000800040400080500000303040000060500000002020600000504000005000200040700080201
10852444373045722840352288364030535482707028387340444640502837407032808370602040601
10000000007070000050000000300040000000004020000050608000700080008050007000406070301
10406528802050766030884543707066285882723080374020804063572030284560457033837050701
10406000008030800030000050004000000000008030700030006050500060000050006000007050701
10664066877040708486504070722640443437243040508676883060607573828072202052306070201
10007000700060605000404070400060000020000060800000000040006000200030003080003060501
10208440435320207230607040573040524430286220467646372722756060307475836350723740401
10200030000030800040402030000070208000200060004000000000500040500000400000200040201
10557080676072767080335020485440704048468025807070654430606620334250507736843040301
10008040008000000070000050008000806000006000508030005000200070800000700000002040601
12883020807752482376643666202054405054406860407020503042634060202072477628404020401
10000040605000003000007000007030003000600000300080805000006070006000000000300020501
10522778308067222060807766663030444780705366835788806764304040458046874550847550701
10000000206000008020202000000060800000300000004000300000700060002020006000802000501
10438480308325702035805088433530505225878528405020405240503586302720708068604076301
10200070303000200050004000000000602000500000705040607000200070600030304000007070001
10402030426070642340855484448478608065408230204040553030335020548030603085352080621
10003030000080000000400000600020003020007000604060000030808000700020203070000070001
10624026268854675622203020305030784080286072723034857550604066502454306820503454301
10703030000000000000203070007080000040600080004000700040005000600000307000800000701
10505070605754676740303054755065465470408640208640803033876664807260202026334470701
10603000400000000070008000500080006000408000800000205000002000300060004000700040401
10608257438875627547538280502833405067545050562638306265804070784735672358703054601
10007000000000000000000000800000002000000040000000300000600040000000000000008000001
11111111111111111111111111111111111111111111111111111111111111111111111111111111111
