11111111111111111111111111111111111111111111111111111111111111111111111111111111111
10000000000000000030000000006000000000000000000000600000000000000000000020000000501
13736032305063573060577287303060756685475784638540307775737072756820386080506550501
10007040007000008000700000503060003000000000000040004000008000000030006000800040001
10403750775085703564405040808063836060234664628072652564704457465023502488252660451
10300080008000500000807050600040000040002000007000000050003000006000704000000060001
10727073204020442630403070336670202488808068407768464050543053757458703042665063701
10007000805040004070006040000000404000800050600050008000400060000000006020000040001
12303070207733203036368030868544706040748520267040702446802070743578262320204230601
10006080507000407000000050300000200060400000700080200000007060000000000000300020401
10202650807060407052407660505070856840504753403860662870768050664436243752574030601
10403000203070005000700060805040000030800030500000600030300030000000000000003070201
10345067303025753030582580508034458030282040407086202025403086225737458776537040201
10800050008000004020008000608060003030000020604030405000005000000000000080000060701
10708730705555306354202057502038502085353260507020208656386022344850805030753820581
10704000400000200040004000207040008060000080808000800050008000000050603030400070001
10308040853680555080373760306020504030507070602355646068508326577050256040205024801
10307030000050704070500030706000804000303000300000003000207070008060700060505000001
10375030388050502027605040708087802882405448783650607660705020606047703770304688761
10300080002080008000404050702000502000400000300030600030005000200050008000200000001
10404066507042266840744070207050402060847258606080857020655620768330204058225553301
10008000302000000030300070204080800040000020006030600030000050200060508000000050001
10377550608235586780702860404030644470822040436033808022358050708060367667657080351
10003000400000006000500030004050000050800040600070007000006070403040700080000060001
12608024326283806025808033864073456060708378306370585584837054408040707020873435601
10002080000080007000806050006080000050800000300070002000006030003000402000400000701
10488030323060588660875066503020674770423880834050208046602760705765808726508070601
10800080800020005020006000203060400080005000200020805020007000500050007000004040301
10605230702242402040807380603040683053606068305060308770707068464250503067332030401
10200000700000700030700070300050007000305000503080306000803000600000502000003060001
10522626256330605720445060263086402440802050508820508030303080304078864730204085881
10000000003000600040500060002040700030002020005000500060406020506000600040505080001
15375874608060257340702673504080206036683740288023534530204480803362507066704075401
10000050004030003000600000502030204070000060800060000070207000300030006000004000001
10438078447067404050672720202080628020503054605680544070807080535070872063884636601
10704000000070005030600040602040007000203000202000402030602040507060006000000000701
10408088387285364040602080308062706077607780406024204086207050407030408276887060201
10008000003000000040007030002000003000703000503000008000307050006080400020003030701
10438322703040846674638040288735628820302020202526776850234042225048387070606530471
10800000502060002000800060004080007000707030700000000050000030000050005000800050001
10402420486028802040208036308080304378607060777782665050647870885720202273854085601
10507000700020008070003000603040500000008060006000300070400000500000706000007030001
10303064303886368030783347508070284682525026207020503360607655704862806085503056281
10307050008000002040003000200070000000700080008030300070700000300000707030002000001
10505080657067604084404080632677683060706370262080704030567350577660602080645546501
10503000800060006060002080000040002080200020600020303020000070000000800040400000301
14607422868770872070642087836020607420544070302060747028285878458782446640808258601
10004000000080000020800080002000200000800040004080008000007000000000000070500000601
10252357362082707450304460202528672336407536382047506040603070235570822050377320701
10000040003000703000300030500000000060006000305060002020700030200040400060000080001
10853040205280302055865060704334677580347020804020756076355368405028208658272045241
10006000300060405000005000306000300000300050207060005000600000008020005000700070001
14803250583040602745807567655040805473605880207080405030303826207060784020804750701
10700060006000300040007000000020300000405000500020806050700000508020000070600000701
10763034846566576070867032406330555850804035263030708040778360402024883750666847801
10000070000000006040004000800040002000504000004070602050007000406000000060000000201
18553840802580205060207380508064726070526382708070802536505048437078875080604240701
10000000300060200070400000607070000070400000003040800000704000008000200030700080201
10334725764033422440788852643030854774203037265850226240203636705085505660307040401
10000000008070000080000000800030000000004030000030405000400040007040005000207040201
10202763506030474030525456608033557278388040482060303088463060362430246038382060701
10708000008050700060000060004000000000005040300030005050400040000060005000006070201
10336037474080307477605020585850575264462060805642646060805755746035504084208080201
10004000700020702000806030200040000050000070500000000080006000200060006050004060801
10802670678660406540306070254050725540486560466243456557835040605776747740553320301
10800040000020600030503050000060807000200020004000000000300030500000800000300070701
10267030363032863050727080467740506073477068406060234260704850577440502822842030601
10006030002000000070000030008000808000004000805040006000400020300000200000007050401
13677030307563467737862644303077602077708720404050405048686030805054336677804030301
10000070307000008000005000003030004000800000300070508000004020004000000000400020801
10482828606032258040707327238080538780306824773237802248503040562032824320275460201
10000000807000004070606000000030300000300000003000600000400020007070008000508000801
10366360207236808084506034887350707362748773503050207480307856304670205023507057701
10500050402000800080007000000000608000700000803070403000300040600070406000005070001
10704040667020234250835627287558304068807420807080437080853040778020706036235030551
10006080000060000000400000500050004030006000408060000060504000800070402030000060001
10273046742664684722803070804080643050548022746083575650608048704462805480303338701
10806040000000000000803030003020000060600060008000700070003000800000203000400000801
10303020305733433640405048285065266440707670402420403066624333604350503068877480201
10808000700000000050006000800040004000205000500000502000007000800020004000800070601
10705838454466443846733720503343307075364020548725804442805030227783357333306078801
10002000000000000000000000400000006000000050000000200000400040000000000000005000001
11111111111111111111111111111111111111111111111111111111111111111111111111111111111
