11111111111111111111111111111111111111111111111111111111111111111111111111111111111
10000000000000000040000000005000000000000000000000600000000000000000000030000000201
16666067503082767080868653507050788388657432736720708878676072242620452070302620201
10005070003000002000800000506040008000000000000040005000008000000080002000300070001
10408730733047203526802080508085278080774374573082843538704238564077407482563660621
10700080003000800000704020200040000080008000005000000060004000006000706000000020001
10232065508030727470404020325680505833208058802664574080855082556363404048747038301
10002000503050007030007080000000508000600020200050006000800040000000002040000070001
15703020504286602028826030384683702040373780235020807743708070643338225720703870201
10003060602000308000000020400000300050700000400070800000002070000000000000400070501
10208380502030204057502860408030465780807448803520765320628040734387683432653030601
10306000205080004000200020703020000080400020600000400050200050000000000000004030501
10577063303033826050782320802036457040746080508043805083707023382523875866855030401
10400050007000007080004000202030005020000030602080408000005000000000000050000050801
10306270802246705856508064706028704043733860508030303344664023626270604020342330761
10208000500000500080003000707040002070000060708000600050003000000050802020800030001
10603020622270328040522320706060202070505060308632434057705323347040446060303087701
10502070000040202070400030206000305000505000700000005000806060002040200070405000001
10267070354060704054807080603033403287604878553650306660608040604062708280403634761
10700070007050003000507070503000205000200000400060500080006000800070003000600000001
10707025203078653370562060806030804030633688506030466060465620776320407065438528701
10002000804000000050400060606050200050000080007040600070000050300060608000000080001
10467820508424263230305570602070535340733030267023508082887040405040884623545080221
10008000700000003000600070008020000080700070600050004000005060705040600060000050001
13507055735753407036306058486077544050307844405680453257826027206070204040863343601
10008080000050002000508060008070000020700000600020002000003030002000406000400000601
10447030836030855840477075207060528280244620323060703074405240802456406872704080501
10800050400040006030008000603020300060008000600060607040006000500070003000004080401
10308250205485403060804560806020634032506047208020305850203067743330307087547080201
10400000600000800050300080600080006000203000808030805000406000700000305000003020001
10383554645680507720647020455065506740805040406860205030406060608053843650604025561
10000000008000400080700030002040700080004040008000600020303080802000400050304050001
17546748606080526250802664808040205065534630577054742820708470606547703062508036701
10000040004050004000200000207050602020000030300080000060608000500080005000008000001
10383064587047307070784860703040873070802062304420456030208020586020333036247648201
10502000000050007060700060706050002000703000707000704020406020806060006000000000401
10304076464623867060608070204036303076602860807072505074504040703080406278678080501
10005000005000000040004020006000007000505000508000006000306030008060700050002050401
10753824402070642283533050256682755580502030606583562430628086762082455080707570381
10800000705050007000600080005080003000408030700000000040000050000080006000700070001
10805870783063808060607048402070704885803050838862542060887240584470804834648025601
10808000600070003020006000507030800000007040004000600060300000700000402000003080001
10507027706867882050664386207030457234527057405020708260608843407675707087607023721
10506080007000007060008000500030000000200070008050800080800000700000403040007000001
10502060265034703073603060256735863060602580854070803020342480662640406070636353701
10308000200060006070004050000070002030200040800050707070000080000000300050400000401
15202877783450232060474065372050606560885020702070353037546457246468778720805775501
10002000000060000050700040002000700000300070004040006000006000000000000040300000201
10458346423055806230404770505234653643202826475076303050804020422720873030448320301
10000040002000506000300070600000000030004000802030003060600030500020200080000060001
10737070805740702048422050302577672380788060607060762058443486207072802284876065281
10005000300080502000004000707000700000400030703050005000400000008040002000400050001
17702630287020304427608354465020804754204360506030807040707824606030225070603860301
10300060004000300080002000000030400000508000800030206060800000203030000070500000501
10882046224758682080488037705860754240807035466080203020456520307046283280238335401
10000060000000002070004000700040002000306000003040206020008000404000000060000000601
16524770704670507070806450506056823060562334804040707485406075755032445020202450701
10000000500050700060500000203020000080700000008070800000504000004000800030700020801
10227782623076383770478743746080473547506047668330876330507275604067308240605080301
10000000006060000050000000700040000000006030000050405000600080006020005000205050701
10205767706060636080555572703056444323637020683060808056888060556670434082885060801
10605000002040400070000060007000000000008020200070005070600040000060006000004030201
10348036274080405827403060443820764768284080807853374060208434842088303057308040601
10003000600040505000302020600030000070000040500000000050002000200040006020002060701
10404840552740302630202060434070843420433530578845472634385030608643384760347530601
10500030000020800020203030000040704000200070008000000000200030500000400000700060301
10483080353064643020267070878860202075767023803080258780608280533850606785232040801
10004050008000000040000050003000807000008000708040008000400080700000200000007070701
18552020604736583424236567405083705065202380607020805024688070506054577783607020601
10000020507000006000002000005020004000800000300020502000005050005000000000300020201
10544677704076824070704343725050425270707887567224606334504080523068862320233780301
10000000603000003040805000000030500000500000003000200000500050006060004000403000701
10245630305883603067405068272430305536373633608070704740805577502420307044803028301
10300040605000800060003000000000703000700000807070602000400060600080705000002050001
10403070355060763770238373823838805085602620703070743080772040452020606057273080261
10005080000070000000800000800080007020005000508020000030607000600020704050000020001
10782083242834463587307060808020366080388022328074883730604026507372805860208554401
10503080000000000000202030007040000060300050007000500020005000400000206000200000301
10306060207435646530804074683047865460806660702230403034878745307530404083833850201
10402000400000000030003000400060007000808000600000507000008000200050003000700050801
10707887755367386236525560604286607045377020276472402658305030464884657545702023301
10006000000000000000000000300000008000000070000000300000300070000000000000006000001
11111111111111111111111111111111111111111111111111111111111111111111111111111111111
