11111111111111111111111111111111111111111111111111111111111111111111111111111111111
10000000000000000030000000004000000000000000000000700000000000000000000060000000601
15438028304034365030645382703080232888838863558760703866445027647670474050805370501
10005040002000003000400000507040003000000000000020006000008000000070005000800020001
10505780864036407754703040502044784080546822228075482354508245778027803562357830271
10600060005000400000707060700060000020008000005000000020008000004000808000000020001
10545046205030467570504050254840208655708058204482674040648063254473604044245043501
10006000205080005030006080000000807000200030600080003000300080000000005080000040001
15706080407865304027423050335564707070656380238040807448505040533885653270407640601
10002040407000608000000060700000300070700000400070400000002080000000000000800030401
10202580307080707033403240208050623560308628504650723650575070683588673624428080201
10402000302070006000800040804050000030300020400000800070700080000000000000007030601
10543028407063524020848680502035768070766040603088804087806054345482475684574020301
10800040008000003070008000207030006040000030402030504000007000000000000050000070401
10308570302658807556708034407085805062387840208080505477536035344340208040423470381
10206000300000700060007000607080004080000060405000300030003000000060405060200020001
10502030425660865040428370308060605020703030508675682037207555824040465040807064401
10408070000080606040600080503000402000602000300000004000403070003020500020807000001
10775060375030808087804020508045406583806745258820807340507050207026208540804362651
10700050003030008000807070404000806000600000500080700060006000400030005000800000001
10604022408078562560723070403030403040852858807070258040672570753680408077526584701
10004000507000000050500080806020200080000030005030600080000080700030707000000030001
10777340502657577830206440408050227420337020483042502052566050508080355287845040341
10005000200000005000800060004070000080400040300020007000003040407030300020000020001
15307083852642304042406086352066426050804433204360632445778062707030402070774272201
10002070000080005000306030007070000020200000400030006000006020005000708000500000801
10285060476070578240523032503030643680732230727050307024602760702434306467505030701
10400030500080005020003000704020600070007000200060507080002000600060008000005060601
10208680805254806070503570204070826086205054606050306550604066633580304085557070801
10800000700000700030200080400020004000206000804020808000402000600000706000003020001
10334623356580707540782080285075502650308040302230305060203050208088877550504052331
10000000003000300030600070006020500040005070007000400080306020304000300050503030001
16782727603030587360707534505070507058332480555045763480503660302752303076205042301
10000060006040008000600000505060307070000030200020000020303000400070006000006000001
10665072665045803050237330305070346050707046802880858020805030734070255083685552601
10204000000070006050200070403060008000603000606000804080604020507040002000000000401
10708085742427387060808070702027307064304330306072207088604080307020202353287040301
10008000007000000030007050005000008000406000705000003000707080002040200020008030601
10522873204070288533777030333855246670506080205733547820367028242047837060206770571
10700000403080003000200060003080006000208050300000000030000020000040004000400030001
10405520882022205030604085803070302232507020336868485070756580445620606837336053601
10807000200020008060005000208080600000006030003000500040200000500000304000006050001
10202042703264558020888658302080644683626056604050202470708445506682802053206067781
10206060004000005060005000600070000000500060002070500040600000800000708050007000001
10302020224035707022708030358753248070505740638020705060783560622420408050322884401
10306000500080004080005060000050002050400050600080504070000050000000400040300000801
15502222388470688060878067827070803650473030603060286086338536655477286750807388601
10007000000050000070700080008000700000400040003020003000006000000000000050600000501
10836735766052804530205620208467242658603556865025506050508030722870632060774620801
10000060005000603000300060800000000060004000202040007060600080400030800070000020001
10376060402250506064253080203286434570253050704030837084787766303072202772763036681
10004000300060604000003000308000800000500070705020005000700000002060002000200060001
14408780632030306228205258524060405253502530705070702070208534403080264060307880601
10400060008000700020007000000070300000603000400060705070200000205060000060500000401
10878073642362825050624067207520277860808035835050206040524520304037643870552235601
10000020000000004030002000500020002000603000007040504060008000508000000050000000401
12462780307750508050608470202068227020882377503050406442508068646063468060607420401
10000000200040600030700000502030000050700000007080300000407000002000600070800020401
10833837642024554270744266437080873282708024634480234880303527704062405870306030801
10000000008070000080000000600050000000003050000070307000500020002050003000405060201
10703727708060373020867563606033378682643080322080508042565070627460352022344020401
10703000005030600050000020003000000000004040500040003040300030000070005000007030701
10562087545080702837805030223240586475828030407774823030304466528068403086704070401
10008000500070306000508050700040000040000060800000000040002000400030005060002080601
10806240683240404720503050724060783860867440336222474788768060204434377240325230801
10700060000020500030808080000030207000300050006000000000700030700000800000400030201
10386030747052836070463030568740802063336084507070382830702440748630407737462040201
10003050005000000040000050006000802000008000208080003000700060300000200000006040801
17774080305276762643877375807045608085803840207070702068422040406084467242406080401
10000060408000004000006000004070003000500000500060204000005080002000000000300030701
10443844204026386030306277588050765240602476647674304633807060864075225440274830401
10000000804000006040307000000060800000600000002000600000600060006050002000803000701
10438680402427703026506076854330602353873647704050307540305888506480604065407052201
10800060703000300030006000000000406000200000206080503000500080500080508000003040001
10306020368060277350768336422258706077303820605020765040678080238070607047726050741
10008070000020000000700000300030007020002000305080000080503000600040808080000060001
10742074353283327874202080704030757070637058786073433820604028305583608760706762501
10806080000000000000505030003020000050500020003000700040007000600000407000700000701
10804060304288323220306052857045336240402280508230804052656648308320703086436380301
10602000300000000060002000500080003000807000600000305000005000400050004000500070501
10706377575648663236228360406755803026824030776372305263205060666352232686303038701
10008000000000000000000000700000004000000040000000800000800020000000000000008000001
11111111111111111111111111111111111111111111111111111111111111111111111111111111111
