11111111111111111111111111111111111111111111111111111111111111111111111111111111111
10000000800000000000000000000000000000000000006000000040000000300000002000000000001
16802060803735502765353474863340304777208070824084258080504060582450402030426636701
10005030002000806000000000600050704000203050200060003070406060700000603020000000501
10633087335040533070826620567030507080656042306720708080708230506234208030822520801
10500050000050007030000050000030603070002000604000600030800040400000700030000030401
10636380203833802040665030838660302035804640807025458770502070466620302777584050701
10008000400000200030002070000040603060200080605000000000604080000000500040000070801
10703020376350826836374076845030502070603080804756264288508058726043454070622430701
10206050006000700000007000006070208000204000700030000000304000005000006020005000701
18707060508055708232504237304560473482252878367070256250467858502023804088534044801
10005060404000008000700000500070000000000000006050507000200000004000505020007060001
10752080504832676070628247256074388823878468202060208083504562304550302050302050461
10005030800000000030004000000060000000000000806050202000003000207000804050200030001
10402080465282674356802066465580506272208460603440707034722040234078503040363036801
10200050000000000000705000700000300000706020600000308000008050000050007030005070001
10235430547237455650806780602334307560508080546286803035802024585640732065205350601
10300050700000008000200040003000600080500030000000807000405000000050002030705000301
10226050328268604048737080434720307060648355882870403273804080786066362060202032571
10007060000000006000400050200080804040000000008080003000002030008000800020608000001
14807070827326677020508542602040408053874574204086742027674082505060604260408572501
10007030000000002080600000502040505000005000504060000040000070004050600080700000801
10638070436483406670886030704080607370202050604080253355886820557640672080507820701
10003030000000300030006070202070200080200060600040200000000060600000608000300080201
10807035365450303055407040505060802030476350557840308758588020507543504463256050201
10806030000000302050002030008000808070600040000070800000600050806000004000003020301
10806030284252876060648070346683603037402084643020887320605220305085647465405030401
10804050005000000020400050000000404000804070005080000070400030803020000000300020701
10704042788054573880304622785340508720302060607084704060275058304043882370772730201
10202030004000002000503000400000708000506000703000402050207000003030005000300000701
10603040504565703082204034504742506028502825208450658020304842668030408064303884201
10500030600000003050008000004000707000002000500070800040002000000020806000306060001
10848320275065564074734623838030208675684060428060405656534023827430303630408020281
10700050006070006000007000003040200000000030007080407000000020000000303000500030001
10402023307750703776506060508040702437866445402050807040388330803587407060585338601
10003000500060500000200030804070805000000000405040600070500000200000600080600000301
10333520588060654820573476607820404050238680306050432874603688233870702434602520401
10000050007000800070400000200020300020005000407020000000006000000040200060004000501
10532048408044807050804440343020336478307038708045506478757263263050662740704055201
10200030704040006080004070006050300000303050007000300070000000000080000000206020801
10608660303770374024375070207020346720705020638680867320487037348022275868406040601
10800000400060007000000020604070000050003030000020000040006000006000000000303020401
10287447528077404883538630803028426050768023534083262054608327405888484640804060701
10000070000060008040002000506000800040006040002000008000006000003000200000605000601
10877080854240688040404076603020407057806070202256403828854772564070725742506056801
10004070000000700030500070004080306000207000203000008000006000003060000040004070501
12402080322447203840205280805060307880803776407023382677508070502526806020225060701
10407040000000700000707000706030004000604000002000000000200020500000407000200020801
10207073804570344538548075806080862254205030248352303570456450847750303830203560701
10005000400050400020007000305030008000705030003000700030000020006000800070506000501
10727620605030703043202560304073874070703065234020226466236082723083835054306030601
10005000306030008000507000207000400070004000002040000000006000000030003000303040401
10384043342026372740807037874630205353603426205060578763407752665530204870203070601
10800070007000000040006040007000600000500030800080000000700000003000504060400030801
17308640807557852076336070607828366480806030245846343340246624506054308040244644601
10004000500000500080008020600000200000303020500000007040800000702000602040005000001
10463827478640808737602062255220607543704080207042206080302020805474703075307070361
10000000000060700000405000400070006000002000603000200020803030400000803000008040001
10424044765050502660306450405087856037362026704740266350308040707680708070772048801
10007050000070200070008000703020700020008030005000800060005060500070006050007030201
10205780643450525065544065787060306220707230505087872088322050807035477020747080501
10800050000000800050004000600020700000402000405000006000200070808000807030800040001
10353084662228204430805520603780808567604067862262405220587520242340605050506386471
10003000002000400000500060004000500000400060008000400070000040002000500060400000001
10702076504260867233437032475070428353326320703070225020572040306033648740625436501
10608000400050000000002000000080000060000000500060007070200060407000000030000000201
10204388722042626785204262322684227430405723505636503086302580306480576083774240201
10600000002000003000003000000000000000200000502000206000004000500070007040005000601
10642470207342302040246080782475572480722580803073602053544086885035303070502248801
10000080507000500080200080000000400060300050306000006000002070002000508070200000801
13246058602050833445607270788780626020505760506424868733853050206040477050558330401
10004000600020000000800070500040000050200000300000004000000080708060700020006000501
12702060604842838780554020647032778356764887228245803025285650707070708468546050801
10003020300000000070000050000080000000000000003070002060000000404060503000300060501
10234540206073528043854548555820555642606243202060585040807652503270885030506554601
10002000205000007080000060000020003000400080004000800020300000300030000070005000601
16805070705635408050654060384033553030558820236352208070725060744025303734365020701
10600060400050003000400080002060003020000070400000003070008020002000600000600040001
10227384277040485878406776306060404088563030702634705667803237207570674240704528781
10600000006030600000002000302020800080002080002000505000200040007030300000600000001
10807088704040607364242060604030477670606027627040867060423070735050573636633232501
10003000200020300000000080008020000000403000000050000080000080000060000000000000001
11111111111111111111111111111111111111111111111111111111111111111111111111111111111
