11111111111111111111111111111111111111111111111111111111111111111111111111111111111
10000000000000000040000000008000000000000000000000400000000000000000000040000000801
16843078506072383080538775502060323235752834257520504864478026273780656040503640501
10005070002000002000600000402040008000000000000020008000003000000060002000400020001
10608680646055205532708080208066242040854886272028484338503736724057805354833540561
10800070006000300000603070800030000080002000005000000080008000003000806000000070001
10647064702070335530808040642540607442303045208272727070324033524728808028825025201
10008000205050008080004040000000805000200040700060002000400060000000007070000040001
18404050507635505027343070283324702030658660867080402527804050434756476660704830401
10002050206000707000000020600000200040200000500030800000007030000000000000300050801
10503430807030704056404670806020352280408634506880285880747070442444688447743020201
10604000505040002000200020802050000030700080800000400080500040000000000000006050201
10765065307047368050683530406078462050687050208035607086703025553577358572578030601
10300040004000007070007000503060002050000080505020405000002000000000000070000020401
10305380806468805585306025608058207036264860403040507642725088225250507060854420861
10705000800000700070005000506060002020000070506000600080008000000040304080500030001
10608040453680523070884880506030708080507060706272277024404455644080327030203072701
10207070000040705030600040204000503000205000600000005000504030004040300060708000001
10363060724070207062207040705048204354207762226830708820505060506027505750803757441
10800050004030005000806060404000606000500000500070800070008000800080007000400000001
10407077303076838430478080502080705060625878408040746030567470833720505072255684301
10002000508000000060800050808030200030000050006060700080000030800080308000000070001
10556320207826677720502740404070244640858060577026704054255070206050234243384050321
10003000600000006000600080005070000050500080600060005000008020802050500030000070001
12204082222875703063507046853057484060205755503420526768572082408030405040367274201
10005030000080002000307070007080000050300000200080003000005030008000803000600000201
10466030537020362730378035604040855830738760465080405067402270605355308326802020701
10200020200050007070002000602020300030007000500030408040007000400050003000005070601
10503440706627606070406630705030438047802076603060704630502056365820804052424030301
10800000700000300080200030400080008000403000503060603000707000400000604000002020001
10732735224330204480273040276078707620302020507380702050805030305065527250408088851
10000000004000400030300030005050800080006050008000500030503060602000200060607040001
18878854506080585480703427308040608053683770835042873320502250702858407058206072201
10000030006050007000600000508020404030000030600070000080607000300070003000006000001
10528022867055307060877270805070864070705084402770673060403030784080327078742628701
10502000000070008020300080403040005000607000403000307030608040603020006000000000201
10607052873223825020608030506082203056505730502065404082503060608080504328533040601
10003000004000000060007020004000005000606000503000007000503030007080200050007070201
10638332404030822253265070527367858220504020407345437850244063283045543060606220671
10600000308040003000700020007060008000404030600000000070000060000050002000400050001
10806480225068306070806044605040506866305080362747583030443620232750604378478056301
10207000400080008020006000203060300000004070003000200070500000200000804000006040001
10503045706352686070388834704020853774233027506020202480208368602836702065708056731
10508020002000007030006000800030000000200020003060200030800000800000804040003000001
10805020335033802082405030252556767020302350765060202080382260436320308040783687401
10803000600080005050002070000040006030800050300050302070000070000000300070400000601
16206767626420232030474058452050702840436030305040336088558522423752848820208386701
10004000000030000070800060007000400000800070003040004000004000000000000060500000601
10857834337077208850203820306837764757303886226053602050807050458440666020432350801
10000070005000803000200040300000000070007000605070005080500030700050500040000020001
10865030803560205054887050608453345740474080307030735056488443306073807522476054881
10008000400080603000007000308000200000500080206070002000700000004020005000400050001
14204620826070508423303625272070704332307770702050202070403728608030252080405650401
10200080007000500050005000000060700000406000800060404040500000702030000080600000801
10852024276487873040627028603760343250808037386070607050763620702067243280586344501
10000030000000003050008000600040003000205000007050802050008000305000000050000000601
17848250203330504020408270604046537060664782604060605632702088658022667020408560701
10000000400020600060600000502030000040800000003020200000206000002000500060600060301
10754728532044753550342325686030436288404084452230767330305734802055702620707080601
10000000003060000050000000200060000000007070000040304000400020006050008000204020501
10502626305020843060536836803077466578235030664020503068847020777570862067478040801
10606000008030400050000070002000000000003030600040005050400020000070002000004050801
10837068678030505526808070632540652526448030605562777080302246863033707046502070601
10003000400070608000808050700030000040000060800000000080004000800030004050005020201
10803420665480603380505030534060276440852480777837353643437070506887466660444750501
10700070000080700050806070000070407000600060003000000000700050500000700000800060501
10578060828028636080787030764220508055278057704060286330602580787850308453327060801
10006030006000000020000020002000703000006000308020003000600020400000700000004020601
13862050606823558444775228506056402058206280703070608074663040608082684243404050301
10000040207000002000006000002030002000800000600040604000003050002000000000500060701
10632722208022287070202473252080422840604487338882605666207040724055243780277580801
10000000805000008030703000000080600000800000002000400000400050002040005000605000201
10585660306667207067708044586780703774282786205080507330603356808340203058603084401
10600020707000700070006000000000308000200000508040505000300040300070803000004050001
10605020477020463220466356284557306035406520804030752080562050465050805055266040771
10004040000080000000400000400060005040007000407070000040706000700050302060000080001
10843048538452572647403070708030458050833047263052855540304034702475402530705486601
10802050000000000000403020007080000040600040007000500030006000500000602000300000301
10404060208764756740604045883076282760606880402670707064743787508330303046546340801
10606000400000000080007000500080007000704000600000804000002000200070004000200020201
10705658787743573227375870606335406034482020462656503522606080867425725627808024601
10005000000000000000000000600000008000000020000000500000600060000000000000006000001
11111111111111111111111111111111111111111111111111111111111111111111111111111111111
