11111111111111111111111111111111111111111111111111111111111111111111111111111111111
10000000000000000070000000007000000000000000000000600000000000000000000030000000201
12388023403033786030524755305050743847336355345380705568687055342220625080703370601
10002060005000002000200000608020007000000000000080003000008000000070006000200080001
10402270474087206252202030302062777070853347368078584768607568462047805754874860471
10600060008000400000504060800070000030007000008000000080002000004000304000000060001
10723057703020424650807020446830702572705082606646474070325043532736607023277083601
10008000503050004070004050000000604000200070300070002000300070000000005050000030001
13703050502778803077283070285452808060366480546060602847607030865387758580302850701
10006070606000806000000030400000300030800000300050600000007060000000000000800060401
10305450407040208082806680506080588630306345406270672640434030278858473767834060401
10704000503060004000600070505070000020300080700000700050600080000000000000004030801
10664038406055637070488320804072335030436020808027406042605085682285473282456040201
10200040008000003060006000808060005050000020508030803000007000000000000080000030501
10203370808782403775805056403035702044565820306020402336664066827680802040432230651
10304000400000800050006000506050002050000080506000200060004000000080706040500030001
10405080533560284070232650704060707030408070603657346063608432767060437050506046201
10407070000080406060800030203000704000607000400000005000503070006050500020605000001
10645050323040502035605020305047703664604447434220504650206050208084305750408455221
10700030007030007000406050708000407000800000200050600070002000400040003000300000001
10402088402062465780742060202020702040883377702060377060487470523770508056688753301
10004000407000000020300040805030200050000060008080500030000040200050302000000040001
10374540207486452580207830402050878360785030858054805078472070704040756586225050851
10004000500000008000700030002080000080800070600060008000005020207050700060000070001
13807033273477508067802075846056467050402658207250356478464044307050608030582445301
10007030000020002000503020004060000070400000400030003000006060003000802000700000701
10658040663070277740257068806080428570373770656020803054408450305536803547305030601
10800060600050007020006000607040200070007000300070408020006000700080003000006080201
10806820404536307040505630604080876054308035706050206360504077448370508035628030601
10800000800000200080200030800030003000605000503050306000307000200000607000006040001
10686878876430505580537030326024304770202020302750302080403060208074835350202035561
10000000007000400080200070006070400080002040006000500080802070603000600050708020001
18787562407050843360708864804030704062264550374078786430203530305382504034802055701
10000020003050003000600000502020504060000060300030000080306000200080007000007000001
10722067765022806080863230203040264030304026208860363040704070435030533073534337701
10708000000030007050400020306050007000202000405000802050706020405080004000000000601
10307052547288532050605020706035607045502570205045508033603070804030704388237080701
10002000004000000020008020007000008000606000804000005000206020004020400050003070801
10254344304050725654533020576444576250503060506432585360338084465068235020308750281
10700000302030003000700030003060004000603070800000000050000030000020008000300020001
10202320468065208080605067606080405885407080623564365050846660358860205433222067801
10508000800030003060003000303040400000003070002000800030600000800000203000007020001
10308076205285528080746645702050478454853036606080603480806783503765704082805053881
10204080007000008020003000700020000000500020008060400060700000300000406050003000001
10304050852083607044304050842765534050802830435030708030228640654830604050587688601
10208000300040007080003070000050004080200050700070207060000040000000200070300000601
12404758252740877080226052284040602440322050808050354038867732232685437370507634501
10002000000040000060800080003000800000800020005070008000006000000000000020700000301
10258425242077603530708830604668547785307544743082807080708060864620583050232330301
10000020008000302000400050400000000050005000508030008040200040400040400020000080001
10267020205280503038857050702232653340238070607060245054863722702045702255868042461
10007000500060806000008000804000300000700080503060003000600000008070004000600050001
14604670568070203422604777674060802633205650204020304070404367402070566070408580201
10700070003000500050008000000080800000304000300020608080400000205040000020800000701
10832028585268283080475044408340827830306054246070708040368340607086772680567582801
10000020000000005040005000500050002000503000007040803040006000705000000080000000601
14332750806860404060204750202056355080225232204070706457507078432048265040607540501
10000000300080800060500000403040000020700000007070800000507000006000800040500060501
10842538243064376530828575786030656832407084625780646630406225502088803440503060601
10000000006020000050000000200050000000004050000060408000600050006070004000208070701
10303622804050483060585722605037632773763070386020402054736050727440847065768080701
10402000003080400020000050004000000000005050500080006060600050000070004000006050201
10886028733070608534502030245460232428252080203574437040504667825045603053402020701
10005000800040208000402030700070000040000020300000000040008000500060003030005040301
10708550436450808840304050647080662430886780576567358862545040706363657650333450501
10300020000050400030602080000040803000800020008000000000300020500000500000200030501
10366040442054358060345060267750508043223065802060887280404750534470704757473080801
10008030006000000040000060004000304000006000606040008000800040800000500000002070501
14557080302724327288644573508045305044708540702070804054848020206048765584506020201
10000070506000005000008000008040008000300000400060504000004060006000000000200030201
10526333208085772050807435525030282830407552488784506563305050876083574220622660801
10000000706000004040403000000080400000800000002000400000600040002040006000202000701
10653530207322502028408067682830304866854575602040204860708863504770205025207048701
10800040205000300070008000000000507000700000802020702000300030500080706000004080001
10706070358040842870547658683355202033802680603070568050347030736060403052224050851
10007070000040000000600000400040008070007000705080000070808000300070508070000040001
10283036688775376265405030805070283050454074453057272880405048605765607860702788501
10807020000000000000802080003060000060700060002000600060005000500000606000600000801
10807030808824384440608045365044888340506870603780508034623837403830702035374880201
10508000200000000080006000600050003000307000500000606000003000700020006000200080401
10803227267754464533583850508668202083388030352265606332707030327733838733604033301
10006000000000000000000000500000006000000030000000300000300040000000000000003000001
11111111111111111111111111111111111111111111111111111111111111111111111111111111111
