11111111111111111111111111111111111111111111111111111111111111111111111111111111111
10000000000000000080000000008000000000000000000000300000000000000000000050000000501
14542076808073767030473674203060585775384638522680207866445048564730235070802380501
10006040006000007000500000805050008000000000000060006000002000000080008000800020001
10503440222068204768708080405086372070345572685054348687204666625037204674788430821
10200060005000200000606080700040000060003000004000000030007000007000404000000040001
10524036504040726880202040532420306337502078302834876020567043263422505065375077501
10006000806030004070005020000000504000300050200020003000300070000000004020000030001
13702040705574807064825060353374203050724550744080208886606070853876453670705420201
10003040407000402000000030700000200080800000300050500000004050000000000000200080801
10702380708080808087702480707080532250807544307750378370847080868365884563763070401
10307000302050003000600080605060000070200080300000400080300040000000000000006060801
10572023202035376070872350304036747050364080406082505034507036863727888268444030301
10200070008000007020008000703070002040000030407050602000006000000000000040000060301
10503650606452807266408038503028608076376460706040704558763085338460203040466280751
10307000600000800080002000708070007040000050208000700040007000000030604080300040001
10302060276670833050543640303040608080808020406726368046506272235060447080403075301
10502030000070305070600060605000806000404000200000006000703040003070700020308000001
10225050328070706024607060508075708833605255272660707650307040404032803860705848251
10600030005060007000302030206000403000300000800020700020006000400030007000400000001
10407084302063783580552080402060208040768366207050467050738460758850303082363633201
10005000703000000070300020803060200020000020006060700060000030300050202000000050001
10776570807562433360206270504080383250383020427088803037772040608020457263433070871
10006000700000003000300030006070000060200060200040007000005040303070800070000050001
14306067864847707088704076422072426060208667504760233728272032408080504080765832501
10008060000070006000304030004030000080700000300080005000003080004000302000300000801
10444050326080672550676042504060836860788730234040806047703620508886602527508070701
10500060400020002060004000502070800020004000300070204080004000800070006000008060801
10207880705425408080307660303030855056707084407080204370504052233230502043436020301
10200000400000800080200060700080007000405000408080405000404000800000303000006080001
10447464483350803680368050638077204280203050806820407050702070307073273240408066631
10000000007000400070300070006080500080005040006000700030603060402000700030807080001
12754257604060484880206623405020302066344270244076655620306860406345203022204036601
10000020002030005000500000807070807060000040200080000080805000700040005000004000001
10727068677073705070677280307040647080304063803840557020408040624060225072753476601
10404000000070003020400070305020004000303000607000202080507040306050005000000000801
10502073865224834070208080304055505046605760708052307082606050807070208578873030701
10003000007000000060007080006000007000403000803000007000802060005040400040008080201
10227222304030874836344050487362287330406050707547233760377088242062722040507380461
10700000203070004000400070007060003000404080400000000070000040000020008000300060001
10606230735044304070607075702070805642802030837867224080677770247220606657877046301
10702000200040006070008000506070200000003080004000500080600000200000208000004070001
10802067402383642050433884508080582686453027503020706470405447303276408073802086481
10308060008000002060008000200060000000400040008050800040800000400000805080008000001
10203040543075703083808070223335278060807450763030506050578870236720403020885326701
10307000800070002050002070000030007020600020300040704030000070000000200050200000201
15206463533540432040884077586060307330874030706030324054887543675588738580704474401
10004000000050000070200020006000400000700040004030006000007000000000000050800000401
10288645737086308570607460805643468355304254857066704080506080325350857020474240801
10000070003000603000700060300000000060008000504070008020500060400030300020000050001
10226070806450303065826050207545252660453020708050566037556862305034803222368037521
10007000400070505000005000302000700000200040803070002000200000003020002000300030001
17806470552070303344405867722050405585505320404030307050208386306020258060405340501
10600060004000800030003000000050400000702000700040705040800000608040000050500000701
10833052363573887030335035503760266570203027424020706040735720205067572640223828701
10000080000000008080008000600020006000508000007050406040004000805000000060000000201
13342240504420305060704750704064652050333642402080306227307087366025285080305660701
10000000500030700020800000804020000080200000005020300000603000005000500080700030801
10382843253068726530868387252080462553506068733220672420204356302026606640806080201
10000000006020000050000000700060000000005040000040703000400050003030004000308080201
10505372703070848070277783203052846835428030842040805057467060326680357034546020601
10207000007070300020000080002000000000008040400030008060600070000070008000005050801
10876037427060508882304020478230687747765060708867622060606338823045304023702070801
10006000700060307000506060700080000060000060400000000040008000500070008050004050401
10802820253870306220807060257030884230752860588463875226456060707887585720827270801
10400060000060800060807030000020706000400080006000000000300030800000400000600040601
10574050277082363030465060742780508042778084606070457760703470253380405428634050301
10004040008000000050000080002000803000006000802080005000700030800000500000004080801
17884070402454456286774787202043602053307340203020707048322040408084673486804050501
10000080404000007000008000006080004000800000600060307000008030008000000000400070201
10834334508087284080705258856050747760804363544455704754704030626067572260534570701
10000000806000002030702000000050500000400000005000800000700060004060004000503000301
10476820404665403044307088842880806256663275403080608560408632205870305042703082801
10300060703000400050002000000000204000300000206060307000200030400030408000005020001
10407030565080833650683382422355305035302540805020672060275040253080407088586040641
10006060000030000000600000700080002020007000408050000040307000800020502040000080001
10226047854635863556402070402050252060488024546036457780304078805337508330502436701
10305060000000000000608030004020000070400030003000600020008000500000805000500000301
10502070607666843420603032673083477430505680506850702033584626204260703025857560401
10805000600000000080007000300030004000403000300000402000003000300070005000300070301
10502854248884434572686570202353407083255030256265708788406060623346532536607066201
10007000000000000000000000400000008000000070000000200000800030000000000000005000001
11111111111111111111111111111111111111111111111111111111111111111111111111111111111
