11111111111111111111111111111111111111111111111111111111111111111111111111111111111
10000000000000000060000000003000000000000000000000700000000000000000000040000000201
15574084208072578030876232304040373826544824857260403765636028825720736030307670501
10006050002000007000400000202070008000000000000030008000007000000040005000300030001
10507660745075408324207050404045332040325782343083543774706856727064305684338820281
10500040003000400000704030700030000060003000002000000060008000005000403000000020001
10334057604080423750305070576320507488608062808543235030524054723836302076572062701
10006000703030003030008060000000307000700050400030005000400030000000006080000020001
16703060506644507028875020783445406070276560456080405267805030838267482770602730801
10008030802000303000000080700000800020200000200030300000005060000000000000800060401
10806880503060204043308320204060576340305556405320847840482030688252453648468080201
10202000702050003000800040408070000020200020800000700020500080000000000000004030201
10474032803032562050877850404063356040352040207054208027504073352758233327366070601
10200050006000005020008000503060003060000070206070308000004000000000000060000060401
10502840304547406486304053805023604055747880702070206244385025824420602070353350421
10306000800000700040002000304050006030000030402000400030007000000030403030400060001
10804040367280436030372220703030402040804060704647585076505837375020732060206033701
10603060000040703080600040306000506000602000500000007000207060007080600020702000001
10755060578070308076808070403082603626407473836520803630405060208067705740302546451
10700050002030003000706050606000702000300000400060200060003000400020007000700000001
10703074604033226340867040803070607070238323802060723080725440832570308068588362601
10005000404000000080500060508060400080000040005080800080000020600020708000000070001
10845220302388846650306430208030747760467040258073403026384070203080858465453030221
10006000200000007000300050002050000020500030400050004000004040508030600030000070001
12307045632223506057607043372062268030304252504660675677785067504070704060876455601
10008040000070006000407040006080000080400000800050006000003040008000502000600000701
10445050746050363880445077507040344760687520326040804066506570405487704847204020501
10500050300080005070004000702040200020002000200020505060007000400020004000005030701
10708480702766402040606620205020584085803043502040806550207055877760802046886050501
10700000800000700050200070600020004000308000305080607000704000200000403000007080001
10846688558840805430675050457067403450507040804420308070306030808046264360308062241
10000000004000500070600070005080600040003070007000300030303030603000400060602080001
15646274808030742220404326603050206048853880533043778670605550807878608057405086401
10000080003080005000300000203080202070000050400080000070408000600040007000002000001
10547066357082602040333430604020833020606064405560454030605030744040637082386846401
10704000000040008050200020302040005000602000408000207050802070502040004000000000401
10208087548223586070606070203038605047803420204058404037306020805080303667745040801
10007000006000000070006070007000008000708000804000006000607020002080300020004070501
10522535608030655684448070648822335260402070808446682840462044746082644080705220421
10500000504080003000500070008060005000608020800000000080000060000020008000200060001
10502820454073208080602078306070802857606080557622887030835570247470207522266044801
10805000800050004070006000503020400000007050002000600080400000500000603000004030001
10307083804445827030887655307070272332567036707070607370206568507357203066207064861
10508070004000006030008000300030000000200030003030700030800000500000507060003000001
10402070474035304036403020636572882020708640542060706050246450728370802050368348501
10808000300060002070006020000020005020700030300040503060000060000000700060500000301
12608533255420376040228028877020202650684040507070754027647772644885542680508658701
10004000000050000050800080003000800000600070006040006000002000000000000040700000301
10566547875067604570306260505744757586206786788068605080204060222420234060436830301
10000020004000403000700020600000000060004000308060005080400080400080400080000040001
10254030606450605057236060504646868860546050207070733078338583407044702422662037561
10007000700030306000008000307000600000400060808040003000800000004020002000400040001
17204420645040503284705827836080308827208420404030302040707276808030865030308680401
10400020007000800070002000000020800000502000700040802020700000305080000040500000301
10346085273877737040653065507540383280306043456080507070468540702026564360243847301
10000080000000004030007000200040003000805000007050308040004000204000000040000000401
13742660507840208060707650302033844020842536707030206562603074328078822040703820601
10000000500080600050800000807080000070400000006050600000405000006000700040400080401
10658877867026368650754424888040782245807035228480863360702627706022406350802070601
10000000008050000040000000500040000000004040000040805000700040008070008000506080301
10304242204080857080688828202082555558548070348060706058882040754550846036264070601
10707000008070500040000030005000000000004030200040006040400050000040005000002070501
10462068443030603724305030445830423266233040302338626060306522888052302072404030801
10005000600020504000503080800070000080000080600000000070008000400070004060003040601
10303340548220502260603060728080772320642260824644557824325060702246777850432630201
10200060000060300080607060000080408000700080007000000000800080800000500000700020601
10265080533034676030363040226230204066786024405020625840503830828260708363448040701
10002030003000000030000040002000608000007000508020004000600050400000200000003070501
18528020703546588748753363503086802083605780307070406085528020208047246776207060601
10000080804000007000006000005020003000300000300020206000007020005000000000500050501
10628256204064388060305357633040323270607772234463502634303050488047857480662560301
10000000403000002020308000000060400000300000008000200000300030003030005000207000201
10258360202368602045603027376860604765655467308020408220202738802580507078706075401
10400050305000300020005000000000303000800000207020804000300040300070803000004070001
10807060327050246450462384558574805045704430705060237020333030484070306053874040741
10006020000080000000800000200040003030008000502060000030702000800080404030000030001
10457043345448746726406060206080254020724073783075686850402032402836706560602386501
10605040000000000000507050005050000070800080006000400070008000700000605000600000601
10807020207255775820602066866043238680606460506680404047873582507220307032744530601
10207000500000000080006000500080005000702000400000705000006000300030003000600070301
10204368826747877382475760808578508052482070223458804875306040546453837533702085801
10005000000000000000000000500000007000000020000000600000700050000000000000006000001
11111111111111111111111111111111111111111111111111111111111111111111111111111111111
