11111111111111111111111111111111111111111111111111111111111111111111111111111111111
10000000000000000020000000004000000000000000000000400000000000000000000050000000401
14462066403026284040757747205020858843872836332830603237765076683380648040204540301
10006030006000004000400000206060006000000000000080008000007000000060002000600080001
10507750875075205237806070302024556050385488748055262656308824732055202222362670741
10800050008000700000603040300070000030003000007000000060005000002000802000000030001
10537047405040358470605070884220306565508035408246844060673076852436403026475053701
10005000702020006060007040000000205000600020400050008000600030000000005040000060001
17302020704373308055222070538433402070864260542050805772505060446263225760802350201
10008070507000204000000050200000600050700000300030300000008040000000000000800050201
10607580405070303086505320502020457270402867504570568580363070576852382778788070601
10806000207060005000700030802080000060200080600000500020600060000000000000002030501
10335083808022736080248870302088476050743060604087206023202024247672735354327030701
10600040004000007080008000205030006060000070702030506000004000000000000070000070501
10407840505627307737205022505046303033734550407020302477744072335280206040662430861
10805000700000700030004000303040005030000020306000200050002000000060205060500070001
10604050828870632080843480802030304020704080505765555025707457225020858070802068601
10406080000050205020800030403000704000605000800000008000206040005080700050306000001
10684030224030305083204080407066808483406445246270404260705070206057202670408854631
10700060007060007000208050602000208000700000700050400070005000600030007000500000001
10807088608035375630777040404080508060542627303060555050876460738720505048734872801
10003000805000000030600080806040200020000040003040600050000080500030608000000070001
10683250803282643680208680406050668660867050485034508057348050603040453534683020371
10006000400000003000600050005080000060500030400080008000008080203050600020000060001
12506024563432407045605044777045678070408365304320624545282064606020406080357467501
10008030000080002000204050005030000070400000300060006000004070007000203000800000701
10747030337060656320844068602080457850378820482080502068507520408842306268702080801
10600080200020007040007000304020200020004000200030303020003000200050002000008070701
10407240708773707050305450606040842032802047407080704880205085667340603056753050501
10700000700000500050500040200030005000208000608030702000705000500000305000004060001
10476642338840503820833070765077402870405080604640505080703040602036446440306033441
10000000003000600080200040003040400060002080002000600020602030705000600070608050001
13575828206030677770305244503040205033353480623075675520307440208826703077704075801
10000020006040008000200000802050408080000070500040000030207000700030007000003000001
10424082573048208040288560704050422050506042303230652030808020228070233062663884401
10408000000060003040500080603030006000805000505000608060507030206020005000000000801
10402024448556473080402050605074708063503720704022206053204080705040406563622070401
10004000004000000020004050002000005000504000404000003000204070006040500040002030701
10868548605080444635456020437687584580804030205348728630424023825026822080606770861
10300000404060007000800040006030008000406060500000000060000030000020003000200060001
10505640738023806050304064706050802258805030782334873050682420486320705363623022201
10802000600040005040007000202030700000007060002000400080300000600000506000007030001
10207085603224357020584464302070636667743057408070308620204585405853502024305038451
10608070005000007050002000800020000000200030002080500020800000700000408060007000001
10602080254042708087402040884424668040703360226070606080388840622270206040383556701
10506000800030003020006040000030008030600020800040602030000070000000300020500000701
16803458822370424080577087837060206770663060702070556046278552724388285380802464701
10005000000050000050300020004000500000700070006080002000007000000000000030500000201
10525446322072408520608220507588785826602323748048404040604020785450882060346370801
10000020004000708000300040800000000050005000205060005020800070800040300040000040001
10542080806330302024764070504265466340467020808030388026254783307038403322374057241
10005000800060207000002000705000800000700030408080006000600000008080002000200020001
17605630446050304326402358236040208863802840703040606040404624204020656020503680601
10200030007000500080005000000050400000603000800070807030800000408080000040300000601
10623074355488887040438077702570522330605027434080205050583770802025874640386564701
10000020000000003070003000600030007000406000007020305040008000202000000020000000401
13248450605740506050607770707066367040526724503060605367504046226022576050406380801
10000000500020400060700000503030000080300000003020300000208000007000300030500070301
10457844677065534430256377266040276364705088774640224660705887307052703540808070301
10000000007050000030000000700080000000007030000080604000200060005060003000204040701
10804543402040283020882488607088878474524070346050503045883040344820253062624070701
10503000005050600070000080003000000000005030400050003040500060000050004000004030401
10728038423060707784505030344350677648824070704736557070506223467033505047508080801
10005000600020507000605080400080000030000060200000000080004000200080002030005030801
10308260278420706850507080583020473450585660545225347848232060608635753830752850701
10600020000060700050405040000030504000300030003000000000800040600000300000600080601
10643070335046556030852050628470703036246063405070623270705440823830402282686020401
10007030005000000060000080008000705000006000602080006000800070800000300000004050701
15223050607373857523833233502058603085606750808030604088354040408082536348403060701
10000050803000003000008000004040006000300000500050606000004070007000000000600040501
10427725603086784070802528876070458230506368653528303446802040435042726770745280501
10000000806000007040508000000060500000300000005000800000700030005020003000205000401
10482530708827507027706082565780206678788736804040307520602873407730603087604073801
10200020206000700060008000000000603000500000803050208000800080700080503000007060001
10708030422060665870228526787484305055407240308040444070433030858070505022265060461
10004070000050000000200000700070003080008000405050000040606000400030607060000060001
10358085563447528352302020508030262040824082334054883540807045704547303620803758501
10207080000000000000607060002030000050300080005000400020004000300000503000800000701
10305070303648662440306052875082634620402830708420204074537727504340708027832820201
10405000300000000030006000700030003000404000200000305000002000600080003000500070701
10706262485745274386358570403433703048784030388463802373307030356363337837408053601
10007000000000000000000000200000004000000030000000700000800060000000000000005000001
11111111111111111111111111111111111111111111111111111111111111111111111111111111111
