11111111111111111111111111111111111111111111111111111111111111111111111111111111111
10000000000000000040000000006000000000000000000000500000000000000000000070000000601
18586052606065855050486344304060367624244848385420703325224025578720688030603370601
10008060004000007000300000404080008000000000000070007000005000000030007000600050001
10302380642032607526505060605023736070778372738065324533703737767027404267576270621
10700060007000500000202040400070000020003000002000000080002000002000607000000080001
10637085608060287640206040685250602438202042305222654060557035252457208067785044801
10007000705080002030006060000000804000500020400020002000600020000000005020000050001
14403080508547804022758050336853407030582640876060306254508020233753525230803360601
10006080804000807000000070600000500070600000600050600000005070000000000000700020201
10803470505080706035603270806070347640206383304380537640526060626474776747462050201
10804000804030002000800080203060000020400030400000500040600030000000000000006060301
10558035206078883030662270704046374040562080806088602038802024532227566785455040401
10400050003000008030005000602050006080000020508020507000008000000000000050000050501
10306780804786403737303067708045702064226560607070702754788058464840808050268440321
10402000400000200060002000503050008070000060304000800050003000000050403080600060001
10703060482570743030227320706030608050307060303667337066706436862070582050804028601
10305080000020804020400020306000202000205000600000004000205030002080300050503000001
10672040727060208088203080806024805368402244484860207540708070603054608260505563821
10600070005070002000804020306000806000300000700080400040003000200070008000400000001
10203044208028767760355080308030606050663327605070865070558340676780306038288764201
10005000608000000070200050706030400050000050005020500080000040800030807000000060001
10542870706373553440302850306030744250383050247026208056633070403080656538287030681
10006000600000004000200080005040000020500070200060008000003080302080500070000050001
14208025654372602027507045247036775050202322306760865863284025306070604040537868701
10004060000050008000506070007040000060700000400030004000003080002000307000600000201
10454050273020253830578033204060438350655440337040803084405660807682805446202040501
10800060500030005070007000706020600040008000200060307060005000200020005000003060201
10704380408737308070202460204020253034604047706060506270804082223730205072467050301
10600000300000300030200050500080003000708000607080803000602000400000703000006030001
10863446453730803540373020334052504770602020208260603050202080506078765820404027531
10000000005000800060200060002030200080005070007000800030403050206000200030705050001
18438433502050832470307447408070308032447450282068437370607220304546602067205028801
10000020003050004000200000403020304020000030600020000080307000600030005000007000001
10848052225054705080432480407070476050207085304750464060807030325060776058435638501
10202000000050002080800020303030004000302000306000607030505020602030002000000000701
10305082746352687020502080202067605055702430703028808025707060506070205278247070201
10005000003000000080006030008000007000306000605000008000706080004030300030004030801
10834427807030343328636030884385343340208040507262842260464046667042266060204470631
10800000702080003000600080004070007000603020200000000040000060000040002000700070001
10306640448023803030207074503050206465504030567347272070738520777280802648467027401
10803000500040007070007000505070200000007030003000300050700000800000807000002040001
10702047804282465030855873603040766725525075806050505340402622605224607063307043531
10708030005000002030002000400030000000200070003040500040800000700000707020005000001
10804030427077802066602080534645767030803320286080602040757350248260803080538833201
10804000800070005070002050000060002070500020800080605040000020000000500080300000801
18806827644580376050622084357020704650846030506050665037653655878338463260505426501
10003000000060000050200080003000300000500030006080003000007000000000000070500000601
10826777643062303580208640203772577274604364524032408070206080674750635060663520701
10000050005000607000300070300000000060006000807030004030800080400020800080000020001
10745070203660306038434070702735368660383030805050752033856575404048403435785042851
10002000500050206000006000703000800000700080206080005000500000006040007000200030001
18302530726070802366308572323070802575406480304040206080608824203040866070807430401
10200020006000300050006000000030200000202000500020304030300000603070000060800000701
10468045822264762050845082202350333840404073376070302050878360805043258560754765501
10000050000000007080008000200040005000305000003040603050002000607000000060000000301
12228580207230403020506740804085748050776367204020202885203025826074734060205560501
10000000300020500080800000603040000040600000002080500000806000003000700020700070801
10442282334065364250852534472060822373608085854680848360803257705025807820307080701
10000000005060000050000000700030000000008060000040806000400080003060008000203030601
10807726408080363050254743302023877728358030223020205088452040576430877045584060601
10604000007020500070000040007000000000005080400080006080700040000080008000004050401
10784045848080402766608030747470522544352060606745733040602888743074706073604080601
10002000800070802000408070300050000030000070500000000020004000600070008080007030701
10802780757530804830404020644080755720746340462335374574775020702276662850226730801
10600070000040200030606020000020608000700040002000000000300030700000600000700020201
10686060642083543050882040642420704078448046505040324840808840335820306876257060301
10006060004000000030000040003000604000005000808080002000800050600000300000008030201
13656080605566773256686235306024507026707450702060502085285070804045822667302030301
10000080306000002000008000004030008000200000200060802000007070005000000000400050801
10866686507022728050805857485030422440706664364275204457708040835087256850645750501
10000000408000006060205000000030700000800000008000800000500020006050005000205000401
10262460703836605058302068486480203544722356506080805580202242307540306055306043301
10800030207000800050007000000000205000700000305040403000600020400060203000006070001
10303020744040658770255627244364806078602820505040852070222040752070703025732030261
10002060000060000000400000400040003060006000705020000040602000400030307020000050001
10647086675477438634206030408020326040483077347058533530804056604363507650803487401
10407070000000000000502020007070000020300070007000400040004000200000205000200000501
10703070802875363520302046882074622650504370403730308067348628502430703023446580201
10804000300000000050005000200050002000606000800000407000007000800040002000200070701
10806425435288455568776530305728703087372070786726604376205040773835485335402023601
10006000000000000000000000400000008000000070000000600000800040000000000000002000001
11111111111111111111111111111111111111111111111111111111111111111111111111111111111
