11111111111111111111111111111111111111111111111111111111111111111111111111111111111
10000000000000000070000000006000000000000000000000800000000000000000000070000000301
15482043803078724080832248404070687447825785675740603383245038885730843040304720601
10005050003000004000700000804080002000000000000020005000004000000040006000600060001
10306480536075507446608020207036688060443848376082564346508488754075807882384760461
10600060008000400000208060600050000060008000003000000030006000004000702000000020001
10385028806060645260606040246850405442304046502885256070437045835785304077587056301
10008000406070008030007030000000702000300040700030002000300020000000005060000020001
16504040403424705072587030887327606070324650655060702383604060277887367660506640701
10005050303000502000000050600000800030400000800070800000002070000000000000600070601
10708560606020305058308650802060587340502555204240855370568020287247336675826030701
10308000202060002000500060502080000050200040300000800020300070000000000000004030301
10684077503066246070743240205045578050532080505053705022306053426358636265627060301
10400050003000005050007000208080002080000070704050202000007000000000000050000030601
10708760806626203625403085706074505083257740706070703586362037874780503020486730671
10705000800000200020008000207080004030000080408000600020005000000080305060500030001
10202070738780768080646450802020605050308050702644632044603352842020786080302036301
10302080000070205080200070704000306000307000200000003000807050003020500060303000001
10885030522040404023203030802056405552302437562780203760203020503066604750305886631
10200040007040005000808030304000504000400000600020600080008000600060007000800000001
10706072405074783320584030803080608050657437406060378070233840645370802085686433701
10006000507000000030600020308040700050000050003040700030000050500070403000000020001
10428480702484274250407530708070573820388050362078403057357020404060635258735070241
10006000700000006000200060008050000080700070300020002000005060702040500070000070001
15804074482644705066604044446054365030605525503860248884226028606030603040366377601
10006070000050007000607060004070000060400000600020005000005040008000208000700000401
10283030674070885220584037706060473620458660286030808044202730608782204736603080601
10200030300030007030002000606040200050008000500080407060002000400070002000003030701
10602860307557306040304830602060487082403036706040705720203064647220402055776020601
10300000400000800060700020800080003000203000802070403000604000700000702000007080001
10824385662260204420858020444057607420203060207660404070602080703085852620406047731
10000000006000300060700020002060500040008080003000200080702080204000800020403060001
15632657204030666820408483704070408026548480686066846470408430705656608077603034201
10000080008030002000800000302070805020000030600060000050308000400040003000008000001
10682085532034508030234220407020773040806078707220826070504050566060887028653262301
10806000000030006070200080405080008000602000503000605060205040502080002000000000301
10504063644556243040706070408057307047502420306062702042808050307060503755282060201
10002000002000000040002060007000004000305000705000008000306050003080500030008080601
10833643808030576748333080437624324260703020706572833860664088877042842030707850371
10600000503040004000800050005030004000507050400000000050000080000060002000500020001
10603560842036805080702078603050707824508080342325434080227520222680207746367027401
10205000200080006030008000508030300000003050006000800040600000700000608000004080001
10807046705868625050372857704080775826636066402060206270603657405277707026204056721
10708020004000003030006000300060000000300060007070600050500000500000306040006000001
10505060277088504046806020685556676060302850643070207060478320538820704070722667301
10207000400080003050008070000050002030400070500070504070000050000000500060600000401
14608234435720564070636044368030403230428080504040746058824474356385487780502782501
10002000000020000070700080004000500000300080004070005000007000000000000070500000301
10374537742057607640607720508665864847607653678087604070804070867420562050722480201
10000030005000304000700040400000000040007000603040006020200070800070200020000070001
10356040708730808028227020604636675250273040704070545022454282705057508244656052661
10007000500080602000007000804000800000600080704040006000600000008040004000400080001
16707630433040705862508277244040505238608750308070508070506778206040536070204480801
10500050003000800030002000000020300000505000200070704080300000304030000030600000401
10565058634463233040724054805540783530705038775060805080755550403068584350786636401
10000040000000005060002000200080007000804000002040204030006000604000000030000000701
12468670503840304050805750706052387050632766508070205638604084635066372080802750701
10000000400060800050200000702060000080200000003080800000407000004000400070800080201
10853587627027658240725356688060862524302053528720643450302867303087505380508050801
10000000002080000040000000800050000000007040000080507000200040007070003000406080501
10504634805060326040678633606076843375544080332080302047284040466520468064747030501
10606000007040700050000060007000000000003050200030007080400080000080006000006030801
10222077867070608388205050224650757448487050303632662080803385768077502087808050201
10005000700050504000204070200050000050000060300000000060005000600080002020007060301
10305520276630504740406020242060467620763380472232482585252040202284422570266760801
10800020000040600070508040000030607000600070008000000000400030300000300000200080801
10442020666062835060788030226470804076845048705070343760603280375550807588736030301
10003060002000000080000070005000706000002000407060007000800070400000700000005050401
16356060803753683646872884407065808037604540402080504075568060408084746255606050701
10000020703000004000008000003040006000300000300020808000008070006000000000200030301
10747626708085244080204474877080855280603628427464403584408030345084884370433470701
10000000205000006070504000000030200000800000008000800000500060007070003000308000801
10843240705665704078204025535770502678435653408070604340304853305340706067705054801
10400050603000800020002000000000804000800000605020304000600040500050406000007070001
10508040648080843880564446572356407085604550306020882080473040743070404077356050761
10005080000020000000800000400070003040005000308070000060804000400050604030000050001
10654055858565743383404050504060383020632077765052682680504028205366203360803756301
10402040000000000000503040006040000030600030004000600080004000600000806000800000701
10505030605887765640704024756024458760607520708240406054237362207570708052352820301
10406000800000000030007000300050008000803000700000306000006000500050008000800030801
10706428578748666564382440407427507058762080776767804574306020552875573546404026801
10002000000000000000000000200000005000000040000000300000400070000000000000002000001
11111111111111111111111111111111111111111111111111111111111111111111111111111111111
