11111111111111111111111111111111111111111111111111111111111111111111111111111111111
10000000005000000000000000005000000000800000000000000000000000005000000000000080001
15507022802065763273304240732053305030206077567062266568427744705020348330744060601
10403070008000000000800070000060004040608000005000300000000000505060200080008080701
10702580755346584520702070333550667250507752508030306083322670806030704035707420501
10300050000000000000503040007000500000600050004040006030005020500060803000300050801
10538030705462468438436080703058704274743540448060342840706060486665406070205040401
10400080703000000000500030502000305000002000600050500000600050500000808060308000501
10207830886062823420507060606420354030602038804555508078254020803670603230406528201
10500050005030000000307020407040000050600050400000006080002060704000505000200000401
10862080205060743777704060603055783440763770606073327042306080506057407056423370701
10000030500040002000003040500050006000800000608000004000007020504000005020005000701
10866840708235822060884030876388202032408554403086508834204030204026836030805640301
10008000400000800080800070000000007000805000508000300000506020003000007000400030201
18204057336246402234208067844488535030305620402620236240207023767750303646738050201
10008080000000405060007000600000006070005000700020000050202000000080700000600060301
10285020627730404020802360706724506534604062706083304030545683488067245470406754801
10800070800030403000407030400030008000606000806000808060800000800050004000300070001
10504020408050804046507030643030362030354320434740806020707730204040406045587070241
10702050203070002000400020007060007050000030006000306070300030506050200040002050001
10808080406053527847306253706080506648877022602077504060328040306060248370507083501
10608020003030002000402000400060200000003060400030006030507030006030000000206000601
10408352627020305040402070384050638424307070306750863020502032748845824043846270301
10500000002000202050700050007040003000802070200070400060002000000080003040004020201
10288567232876806070224720604282706080508020645040202257846264827070706240703060801
10000000300000002060800050800030003050600080005070200060000020000070505000805060201
15435070705322888030803060554080655050355737307050206030268040702750204087705030401
10002020200000005070002050605030000030000000808020506030500050500060503000206000301
17307350405855506030325030802050228082325220405020705070403660438370807880608630301
10003000207000700070004020306080002000000070006030204000608000800070400030500030501
10207024345080543522603060208070608525287458225280336868802088708020304040453065601
10508000000060003000007070007030202000700000000000600030008080003000704080006000001
10502326736855404085227040344034308060302078527882407080828020687435757050505034781
10500000300050007050000060500080008040007000002000804000302060008000003050802000001
10827676708060346020402820203830287022624448206050808825804052304078302045507068801
10600080003000600020600030605020800060000000808030400000006000803000503000004000201
10206020607842406850508280407040704258668240742070608542737040206730702775573060401
10002000302000006000506000805000408000000030000060400070003020205000300020002030301
10868057304053574065548057705728807020375037878560745020603050602020748023504060501
10005000204000600030003020003000400040007070000000300030408040306070005000506030701
14608745707070707378404060533080677853207080506288706787408030704060706670603760801
10004000706050300000305030000060700000402000800000800000006080200050807000500030801
10233050706060262530507056252250548370768837478630567022506060236563808060405040601
10500040005080000080002000000060500050200040000060004000307080507000808030803000501
10404586532020567067684760447070702070204080366080403380226080405030533020835684501
10600000700060005000000030700030006000703030300070300030800030004060000050008050001
10805420803363808522577020506822426366336060702277652088304032277035607423803080571
10407000204050005000005030300000007000002070300000000080006000004000800000500080001
10863040306070604080884060557283305087302084402527624780504644348320808720202626201
10700040308000308060600030002000703040005000803000000000806000005000702000508000801
10205766806363283040806380405080608050287630632062755637578068704062665058605030401
10300000200020000020400020400050200050600000600030000040007000800030005040708040001
10347770462050602043576040244080602450602044402040284080408040608340304070302040351
10000050005000208050000060008040507050008020008030007000302060400040200030003050001
18254045408482206020252658604230804074565640206078206885307440256040253267728077601
10002040005000005070006000506000500050008000602000300000206000600080400000006050801
10807070428544257057406420705023362260503068337827703750306040607770403333507070501
10307040800000004000600000607000000030508000500000700060800070600060202000403050201
10286060873876808580307735806537804080807050808880635860625633844020406083807040501
10006040008000005080700000300000704000403060700060000000400000002040003020004020001
10303038507067557050638844658750342883703020557078255757356475707077263060273062301
10605000304040000050000000000070000020007070005040000000000000802000000040004000701
10702260407050805244375352758030335060275587564080537482275270606665627232805760721
10200030800050200000000000800040700040000000700070700000003000600000000000200060001
10577080652680584770853530308685207052442330302650307842506023863683604750536045301
10008000400040000070000080200000608040000030600000703000403080000000200080000040001
10504688603040784078522060752030305050708030247082508070705027503360305063778850771
10308000002080006000008060003050603020303030008030002070807000800050508000000070001
10706053686065842087302545704880404620576054405380722062403020457860703226333035701
10700060600030005000206000705000500000600040606000600080005080000020700080005050701
10554540808580704443803040578060368755208670204040305740467040557030407050233020201
10600000400000200070005070000040002000003000400030200050403040003040207000500070401
13207053762867282040266030468380676052785030887320608080707020626060804737403670701
10005000000080003060600040000060300060000050300000702000200080200040803000400000201
10207367846062706070604083433050603530507550503368333545465040405830308060302734201
10400000002000005020608000800030300000505000400060000000002060600000806020400080701
10682332848035457030403333405275243578802034547750205485306050425577647070858040601
10000000002000500030002000005000300040002030008000405000003020800070300050005000601
10383527306433704035445044736780706060336070405046306048342070804040707532202826201
10003000500040003080006000000080704070800070702000602000700080008000600020002000501
10403030857050804080804384545020706720402450203830676550623757737854843060384050201
10700050006000206000400000005000600000200000300030000060000000000000000070000040001
11111111111111111111111111111111111111111111111111111111111111111111111111111111111
