11111111111111111111111111111111111111111111111111111111111111111111111111111111111
10000000000000000020000000007000000000000000000000700000000000000000000060000000201
14838034503043646080776666807030444466245742682320308777343046286830232060308420601
10002070004000006000800000605040005000000000000060004000003000000080004000800060001
10407720586088705283204080403023276050378825788075784582705367572055704446675240381
10800080004000600000703020800080000070008000005000000070003000005000606000000080001
10572036405050358860305080472530507678506045504756225020662048488445804054566062701
10002000508020008030004030000000507000500080200020008000200030000000007030000020001
14204060502746805036386030274684807030536750622060708855205070445555838870502240401
10006040303000205000000040200000500070500000400080500000004050000000000000500050301
10405740605070207064802650505030822420207488508540777630773030532482564264364060801
10508000803060005000400040404050000070300060400000400040200060000000000000007050201
10473084804085268060268350602084334030623020403078206076208068748662754775657060401
10300030007000004050005000708050007040000080608050306000002000000000000030000040301
10805580503236206733707035208023706068824360407050703484283025585360405050423350631
10406000500000500080002000308070008060000050703000200070007000000080408080800060001
10206040446370786060865520706030306070406030503846645058702464632020788020506086301
10806030000040703040500060708000505000808000600000007000307060005080400080606000001
10742060267040705065403030407055407832706522766720304820804050206043804260405523661
10400080004060004000703080808000703000200000600060700070006000600070002000500000001
10502058706088327420783070605040207040422432607030836030357260348680604046353354301
10002000702000000030500060305060200040000050003080300050000080600060704000000030001
10487240805784447870406650707020877840734060865025504036258040403020854367746020771
10004000700000002000600070007050000020500040800020003000008070703030600070000060001
12503057462547804057402056234065887040302228607240552546243057608080407040765253401
10006030000050007000508070007060000020800000700080008000008080003000304000600000501
10738020687080746770848034703070326450342240483050506077807820607382506274705060201
10200080500080006070006000802030800080004000600050506050002000200070006000007080401
10607340706778208050307640407030365088705045708050406440408067437840406054655020201
10800000200000400070800080400070004000308000604050807000807000600000705000007030001
10277356638430506750376020674045408730305030704780402020703030602022444740804036631
10000000004000200050300030006060300060002070005000500080808050608000300040404060001
13723474204020463580406353705030608084863740833034364640406880704336304063302085401
10000020006070005000800000404070802070000040800070000040302000600070004000004000001
10457032425026804030532230205050236060308077403620527060808060668020682087733462301
10208000000070007030700050505050005000605000408000704020508050804020006000000000501
10204074334423727060402040408044304073706850303054806072407030606050404753325050301
10002000006000000050006020008000006000402000704000002000208030007020600060002050301
10834583708050423643223040887585772430605070806882642320587022837085458080307830421
10800000506060005000700020006060005000805070600000000040000030000060004000400030001
10202760862056805040604064303020806335605050623733253050485660848230207567243076501
10304000700030008070006000708080500000008040006000700030500000600000403000003080001
10404043707565526070673532703070685826387073603070308550807854405832607084703082371
10203060004000007020004000300040000000500040005060500070400000800000504050005000001
10703020533044306034203020788847886080405750683050503020744830675480803080435373501
10506000400080006030005020000020006080700060600040705050000060000000400050800000801
18205472633640846060375072686060806880366070505030224073643287776485328440504444801
10008000000080000080200030004000200000500030005080003000003000000000000060600000401
10475358663087406530806680308344587364607237438062304040303020373720638040257240801
10000020003000702000400080400000000070008000306070007070600040700030400050000020001
10742070802420606032658070306367378350863030808040345074337325304038207387278082531
10003000600080603000007000202000200000200020703020003000700000007060006000500080001
17208530325020807445703383837050202464806250703020703030202456605070545040408530301
10200040003000600030006000000020700000705000300050802030600000205070000020200000301
10884053627556248070534066604440545670605085272060507060478540505036676860853734801
10000080000000002020007000200060003000608000008040205050002000806000000080000000801
15553760407580202060607830407038665040625857408040605654308084837083536070608820501
10000000400080300020300000805080000020600000005050400000304000003000500020200030301
10886885378076673760826377674060534284508057522340824370307325403034803680206050801
10000000006070000060000000300080000000006030000050307000200080007050003000704030401
10506442805080547060236545508087787326645020622050507044333070853430788077836070401
10707000006060800080000050004000000000005030200020002080600030000080002000002080201
10856077628020502473605060685340776322354030502233782020305248625058808032306080701
10006000400060308000605080600060000020000030300000000060005000200070006050005080801
10803840388420302520703070278060738250744420728323227457847030207546238520852350701
10800030000020500080404060000040303000300020005000000000200030700000600000800050701
10473040782088354040577040244680806044756063308070575450807570342480404283424040301
10002050007000000060000030002000304000006000305030003000200020200000200000007050401
18447060804573225255357668508022407086408550305040803045868050708048475584206050301
10000050508000007000007000002030003000300000300020506000005060002000000000700020601
10748483305065834050708872763050477360707263527388805378202070278048753340454560201
10000000402000008020404000000030700000400000006000800000700030005030005000303000701
10627360206566802044802053556260302244826276308020304460306688303520804028704073601
10700080206000300040006000000000607000600000602060408000700040700040603000006030001
10304080827020723880445763825822607084407730202040575050642060823040408023685080421
10004030000020000000400000500020008020008000502040000050804000300030803080000040001
10635058768376676723505030303040342070655024368066783440802045502327205380602586501
10205070000000000000208050006080000060400030007000200050005000500000806000200000201
10205020804838885260304068736058342880608860507870206078675677607450702063767460401
10203000400000000070008000200030007000806000200000202000007000200030007000300040401
10708647222483567568365440808385206024555070552774607687803080878864772555508072701
10002000000000000000000000600000008000000040000000200000200030000000000000004000001
11111111111111111111111111111111111111111111111111111111111111111111111111111111111
