11111111111111111111111111111111111111111111111111111111111111111111111111111111111
10000000000000000030000000006000000000000000000000200000000000000000000040000000301
14722077808036248070645587807070587572547275665270805586223032533370546060404240701
10007070003000008000800000308050004000000000000030008000004000000040003000400040001
10606550485086306257402070403073342060556524446057682525404665655057403682367670271
10500020005000300000204030700020000020002000008000000040006000008000804000000070001
10346048508060382630205050776750802238205052803458543020523067777373704027785057401
10006000805050003070008030000000405000300050200040008000600050000000007080000020001
13306050305357307055574050276866508070735650645050608682806050266386586760602230201
10004060506000707000000030400000200070500000200020800000005060000000000000600070301
10702320708030807077806330202040272460408234807340862880862040867367268824545020601
10306000207020006000500050202050000070300020400000700070500040000000000000002080301
10864082302052348040425780207028635080577040208048804073603027424583784423872080501
10700070004000005080007000307070004020000060704060406000002000000000000070000050301
10302220704776503674604063606023806065577380203070502535552038783560407030528870751
10607000600000500020006000408080004020000020207000400080002000000060408070700080001
10307030778870426050836550407060305050403030306844334073806744852050632040706064501
10203030000080607080600060702000304000708000600000005000604070007080300070307000001
10338030224070704085404060405036804526205358446260303740603040202078504820606226751
10600080006040008000802060505000708000500000800030600050004000300060004000400000001
10805087508024262560862070406060705050468737507050754030733420576220203076887386601
10007000207000000030800030805080700040000050004030300080000070700050508000000060001
10857350706533884620508560403040785670756050642068204087257040504050875655822080561
10003000600000002000600070007070000030200020600070006000005070504060300040000050001
17804062888277207073504062372085772080805455803470384345465055204050808060722722501
10007070000080005000205020005080000080800000800060004000002060007000304000500000801
10375040343070743360453023705020537480872340844040603028506870405353206323205040401
10300040500080004020007000407040300040004000600060702020005000500040005000002040701
10406830706757303020803480602070227055607076404040408420804043472680402073225080301
10600000500000500030400030400070004000404000608050704000608000500000702000008040001
10676383274880402430568060227032507450602020407520603050406050705076748220702038831
10000000002000500040700080008070800030007060006000400020504020303000300020507040001
13828236505050855620506268602060307052523520654056268840702350505236302032203065801
10000030008080008000500000407030202060000040400050000050805000500070008000003000001
10644032635068707060647780203080553040608062702350365030503080787060777085734573601
10608000000080003040400070305020002000605000808000304050802040805070007000000000201
10707064526555487080507030204055503063208240203026403058508050702040407572867050401
10004000003000000080006030003000004000408000304000007000407040008070300030006030301
10573778202030758238455060253458248680305030307677447580426077575076724030403770231
10800000505060008000700040003050003000402060200000000060000050000050008000400060001
10306260454038403040207024802030207436807020728263773030728530676780507463583033401
10503000300030005080007000703040200000006030007000600070500000400000803000008020001
10308055606234723020263778206080384475888027704020207250708453407324202025306066851
10805070007000003070006000800060000000700080005070700080200000500000505060007000001
10702020474055403072508040568282225050708750835030802060656760458880503060323374801
10305000800050006040006080000020003070800060700080205030000030000000700050700000301
17702638433550658040365027732060503540637020407080872068862325228643767240405323701
10007000000060000070500030003000600000300050005060003000005000000000000030400000301
10572426327065304350703880408783456683707434247073405020707030245680542080445550801
10000080003000405000600040500000000050006000207080007020700040400030400020000030001
10826080606380704076842020705668584780747030507050758062662877406032606257657022381
10007000200020206000006000204000700000300080505020008000600000004040007000600030001
15805330852030303337706268372080204443204440503030507040405384703070727070307450301
10300030008000500050002000000030800000805000500040803040400000606070000060200000201
10877022683832534080543077506430277620504085668060207030485520802058345650843683301
10000070000000002060003000400020007000205000002030207080002000604000000080000000701
16524470804630604070703880203023384030434378603030303867302085257076654060606330801
10000000700030700080700000202050000040200000002050800000202000003000400080400060601
10576644752032657860272726328070822623508035247520558780407675202038805220805020801
10000000002040000020000000500070000000003040000030504000200040006050006000707030801
10603346507040552020886663607065644874783040257060305025837040628660564024254040801
10704000004070700040000040006000000000002060600020004070400080000020004000006040401
10834085286020207527808080623620474782325050308565244020704222563083505077805060701
10006000800080403000606040600030000030000030700000000020007000300050007040006070701
10303670748760607860802050567040484770382770838747448357565030206273355870228330501
10200070000050600080403030000030402000200080007000000000700040300000300000200030801
10654060854054354070725070563650505037756053804020856530202470856870202855685060401
10002040007000000050000070007000707000002000504030003000800060400000600000007060601
17323050707435787724447534503048305084607480608080304076767080502035425375805020501
10000040706000007000004000006040005000500000200020702000004080005000000000400080301
10225646805048752060704768744020843660706446582278204666206070264054233330777270701
10000000404000007040303000000070500000500000007000300000300050008070006000205000501
10763540408475208074804054642540407548382237603070405540202456405360406034605025301
10700040507000400050007000000000503000400000404040204000300050300080505000003060001
10503040747040327350566627468275807084505460405040263070365060743020804033727020341
10002060000020000000400000200060007030008000406060000060208000800040805050000020001
10745074248624426377703050807040725070337042482046288260605036806762308230306652401
10805020000000000000805080003060000070200080004000200030007000300000508000300000401
10605070607658354420302073323077676570502630704280303053525235603420306088522780301
10603000200000000030007000300080006000804000700000406000006000700030003000600080501
10202888624555424684235760403722208023732060734656807287808030237383352522504078701
10004000000000000000000000500000006000000040000000500000400020000000000000005000001
11111111111111111111111111111111111111111111111111111111111111111111111111111111111
