11111111111111111111111111111111111111111111111111111111111111111111111111111111111
10000000000000000060000000008000000000000000000000400000000000000000000080000000301
17237032205056758050476567807060343356587888774320503273248037286480783060802280401
10002070005000002000200000702080003000000000000020008000002000000020005000300080001
10805480663053207228608040406047882030423378363067444288403647778028808825523640751
10700020006000400000705080400070000050006000004000000080004000007000605000000050001
10873087705050436330608050787360607746806075302647787070875062624582604044754023801
10006000303080006020006080000000507000700060300020004000500050000000003030000050001
13505050807883606048488040534384702050867380852080407463703070847223736380307870301
10004040703000305000000070800000200030300000600040600000002040000000000000500050701
10708640706020304023203780402060666640602835404330324360327070665725442646877080701
10302000308050008000800080208070000040300070400000800020800030000000000000007070801
10324076504034226050244860808083445080666020606065505037507043676745333433662040701
10800080007000004040005000807060008040000030406020804000004000000000000020000030701
10703860508464306734307024802062407026232560502020306555278072482460308020466420331
10303000600000700030004000205050003030000020607000500040002000000020208080400030001
10608030276230263040372720403070302060803020807357638027608436225030784070505027301
10805040000070807050400060604000708000805000300000006000406050008060600080802000001
10382020334070508036202030306038702886607268474480707380705080307043207450605224551
10800080005040006000403030207000308000800000800050200080007000600080002000400000001
10503066306076832260767020602020702030243488403040477040324660676470507022222443601
10007000802000000050500020703060600040000020008030600030000030200070302000000080001
10647680608467368720207230708020567270272030424036502037752080407070742776862020731
10002000700000005000600070007060000060200030800060008000006080606050600070000030001
18806024233835602057403028425072865060604233506440462356542034206070403050375547801
10004070000030004000805020006070000040800000500050002000004080007000203000300000601
10754060686030387560672082607020687520237880458070503043703470507845608332406050601
10600040300080008060003000702080200040002000700030608060006000200050004000008020201
10502460205745402050408640803080872075406058308020707220206063758430805073866050701
10400000600000800060200020200070003000602000302020304000503000300000406000002040001
10277363333280403880734050322038202250607040608870605040607020808033267430808088251
10000000005000200030300060007060200060003070005000500030603060505000700030507050001
17484253502030372370608858203070806062542680655085345780806240604365708056404055701
10000060008020004000300000404020405030000030300040000070602000700080008000007000001
10838072886074808080438770604080644040202022205670358040608070654080567055572432401
10508000000030003020600020407020003000507000702000506040406070204080004000000000301
10504053773772688080207040308028203068306480806024702034403070208020708658352050501
10002000006000000040007070002000005000306000605000002000605050004030300030005030301
10334244302040356544236030256276266540503050805645228680225076547084885060305850241
10400000202080006000200080005070002000603040200000000080000070000080008000300020001
10403350552055304070404054505080408742202070737728552070763620752640803662883085801
10404000200020005060007000407080600000005030005000700060800000600000205000004030001
10808042703554735040585432507030866436846064803080302870502738305483406048204057661
10705080006000004030004000700070000000600070007040200060800000500000302060008000001
10403060464085808066208020577728357060504360585070305040254520253540303080672542601
10808000800070002050007050000020002060300080800060805070000020000000700050700000201
12603437224370235030772056245060506330652050507060423034558868474427222550508347601
10002000000040000060200060003000800000700080006080008000003000000000000060600000201
10472685285073606270208870703523555374202562687042503060504050323480228040225530301
10000080006000204000300050700000000080006000706080008060600060300070600050000040001
10335050803230804052536080803867536340285080406020736023465324502062608522455053571
10003000200030307000002000208000800000600060307030004000700000008080006000300050001
17502670634050207472406423888050705335204350608020606060206864708030747070303560201
10300080002000800050006000000030400000603000700030602080400000505050000060200000401
10472042888276582070355037805870664670507044262040806080467820404035854670822636501
10000040000000003080002000800020006000404000007070706060006000503000000020000000701
15672460207230403060402550708075426050245636608080706434605042267085476050608760801
10000000500080500070600000204060000030700000006050200000303000005000200080200080801
10447552374072356740537454477020636274202085865620887220407672807053203750705020601
10000000004080000040000000400070000000006040000030205000200060002080008000602050801
10206664606080487060453454803047243668375020763080407043324070822880827073262020601
10205000002060700080000060005000000000006030800020008050800070000050005000004050801
10865058434020405342506050875380832835245080502845558040203454572055606074403070801
10008000400060608000208050400020000030000070600000000050006000300080005080008060301
10406520783220505620406050774030726260365830838762537527375070506854243650287880401
10800080000030800060508040000080606000700070005000000000700040700000500000400080201
10337020625084875080726080528620603088372083507060678770803240724760507436532050701
10004050002000000080000050007000506000002000703070002000600050200000500000002050501
15478080804325742774378867602082806022708560304030307057555060705038537746502060201
10000050704000004000002000002070002000200000700020205000007060008000000000500080401
10454673203054253040302775787080465570803662237825207437703040382083832850584480801
10000000703000006030308000000040300000500000002000800000800040006040006000803000301
10447230404727602076604044536460503585622344408040406650203542502360302076708032701
10800060206000400070007000000000806000300000804020305000700070800050208000004020001
10406080783060558360858353838647803032307570407040553070828030557020207085484020661
10006020000050000000800000200030008060004000605040000030405000600030604070000020001
10237032857486637327206050305030836020656047342063525830502068702554306260502425801
10802050000000000000508020004080000030300040008000300020007000400000605000800000601
10306040207827747430706033668084222860608660707560604068264663508370502026358860801
10807000300000000030006000400030003000606000500000704000008000300070007000200070801
10705788724322475652783340807655502084784080827236804558205060763284753283306022401
10003000000000000000000000500000004000000060000000600000200020000000000000003000001
11111111111111111111111111111111111111111111111111111111111111111111111111111111111
