11111111111111111111111111111111111111111111111111111111111111111111111111111111111
10000000003000000000000000003000000000800000000000000000000000002000000000000030001
17203027708032547753404350622052208040306038828072678475877245203060747740325030701
10305020003000000000700030000040005020708000006000700000000000405070700070006060601
10406480427222824530305020225250362720203774606040306083386560207080603028402280201
10500050000000000000303050002000500000300020003050007080003060700060404000700040801
10632060305555272572374020602026604363488350345050476830308070257737805050705020801
10200040304000000000200020807000607000005000400020500000300030700000806060303000401
10508270866087284850304060402740677080406087608853508058473020307520606260304842701
10800070003080000000803050408070000070200040400000002050008050405000208000200000201
10787080605080653833506080704034422770566880704026365087505050307077503058775840601
10000070700020007000004050800080003000700000403000005000002050807000004080004000401
10385740407532428070325020543767608047507342407086204548405070408076847080607350201
10008000500000300080800070000000004000703000407000800000207030005000005000400080401
15506022528664404725603082754442785080502750704440772440304053458260808372654030501
10007060000000408080008000500000008050007000300050000050404000000030500000500020801
10768080446480408080304420402262707857706065503075604050368675364055226870208372301
10200020500030608000302060500020002000405000703000708030700000200070004000500030001
10606050406040205056807040586070373050282320272480507080308880703040403025653040471
10707080506060004000300080008030007040000060002000608020200060708080200070003040001
10704030406068276332405862306060502682867026506046403030737070403050644560504033201
10308060006080002000706000300040400000008050800050004070602080002070000000702000701
10707657887070806040706050367060354567302050607860882060706087358723872086854870601
10400000005000503080200080005080002000803030500060300070004000000060003030005070401
10683556567423604060222580702633605070407050748070802668362825527020403520602080201
10000000800000007050500060400040008080800030006040300060000020000020607000802060501
12278080702363355020708040777030445080223875406050405070525080408470506083707020601
10003080500000004060002070204070000040000000405030306050300070200060306000505000201
12807520407246808020826060502070557062845230606080502040705240834820708830203750501
10005000607000800070004060307080008000000050004080407000706000500060800080700080701
10407083627030382528202060508030507843543432526520477588408057804070405050727023601
10302000000030008000005020006070806000200000000000800050002040005000202050005000001
10207887855237704057326060438035508040205052254574806020433050238384825080203028651
10700000300040008040000050400050006060002000008000606000407020008000008050704000001
10622853705060434080607370305630262028642836203060406662404046703058203076705047601
10700030006000400040500040608020600080000000802050300000007000207000703000008000801
10506030804823806720702430706030202442888870262030607265378040306750406523335020701
10006000706000002000404000604000208000000070000060300050002040204000800050004080501
10667052703063378025662087302653506030463076538230743060607060403050375038705060401
10007000607000300060007020005000800020007030000000200020805080305070003000502040501
12503486306080602265208060842080637424606060207432703783205020203020307720608540501
10006000505070600000502070000040300000205000600000700000008020500040605000800060501
10742030305050253260602083454360543450867677828470683035502030675876802080308080601
10200050007040000040002000000030200060400060000080007000706020608000405080803000501
10707276335080586083624750745070406070407050787040807670585030805040848040386352401
10200000500070004000000020200050003000404060300080700050300030008080000070003080001
10703730606237605375574040303584832534424040405422438053806043326034305675504030821
10706000608060007000004040500000002000008070800000000020008000007000600000200030001
10755070505040802030826020888455804064406078803642486330504537725640404460808773701
10700060707000702080400060008000408080007000508000000000703000008000305000306000201
10308326602588275080804480307020708050743550526053758782745022203042772033408060701
10700000500040000040500050700050600080200000800030000040003000600070008070604080001
10482760284080806024647080423040402770207068604080725050202050607380207040802050441
10000070003000306030000080004030208040006040008070008000603080700060600040004030001
18235058404248506020827287708540604028552480308065707523306340427040822526538078501
10003060003000004040002000305000400050004000607000400000404000200080200000004070401
10808020387482226038505360205033757850703064332524206830707020708730808625303050201
10606030800000003000800000205000000070506000300000800060800030200060607000402040801
10355060867526408650507283705377406080308020402420756640553458857030302073208040301
10002040008000006050500000800000508000308030500060000000600000002020006070006040001
10207034704047483050633278653330745876806030338038556565225878404062434070844078201
10503000702020000020000000000060000040005030008040000000000000207000000040005000201
10407860205080506322827225727050358080833428485060422843378830806633846763204370381
10700030600050300000000000200030700030000000400070800000007000800000000000200050001
10735080682770386660258820608372703067343430305260404647507065265285802680778057201
10006000400070000070000020700000606060000020700000608000604020000000300050000040001
10605542603030382037667060288060805020605070572046404080706085305720304055873770471
10604000003060003000003040002070408030604050004020005020805000600070606000000070001
10604077632043586064203745304440605250656086307560633076506050545720604522273036701
10800040500040007000506000308000300000800050605000300050006020000070800020004060401
10276640802730506347805020473020278338502840502020705230678030657070202070564020501
10800000300000400030008080000060004000007000300050600020202050002050308000400040701
14505023545356848060472080834850626056264050657640204050306050533040607747707740801
10002000000060005040300080000030700030000080600000507000800040700080602000400000801
10204774756082808020202046457070702650306260805677676327433070507560404060308576301
10300000004000007060606000200060700000406000600070000000004050200000607020600020501
10876733467034862020408878507855543678608027852430303538502080425522777050674060301
10000000005000300080004000005000200030008040007000305000007050400020400080006000501
10473776304722307067765058482870506040367030803087802083278080305030708384607888401
10004000200070008020008000000020808040500040604000302000200050004000200030008000401
10204070268030208060705534258080804720708670204630883480453572426735842020324020301
10600040003000408000300000004000200000400000300030000070000000000000000040000050001
11111111111111111111111111111111111111111111111111111111111111111111111111111111111
