11111111111111111111111111111111111111111111111111111111111111111111111111111111111
10000000005000000000000000004000000000600000000000000000000000003000000000000020001
17808054304046858287202260285072208070406057733054436375484476808070443820826080201
10205030007000000000600040000020007080603000004000600000000000206030400070008070701
10302370534883368720203080723880585460208224608040806048483760707030703053703880601
10300030000000000000703030002000700000500030003040008050002030400080503000600060201
10744060608324234825857020505074807464748550245070545470404020254235804020306070401
10400070205000000000500020508000506000006000500040200000700040200000202060808000301
10707750253057683820207080607480236050308078808765803034783060504470703830608727801
10200070005040000000608030607040000080600080500000003040005070407000704000800000401
10785070606080753876202040307066825620825560606084456048506020805024205076784820601
10000030500070003000005060500030006000300000308000002000004070203000003030005000601
10422340405824578080877040473283708067804472304067603222404080604032657070504430501
10007000500000500050200050000000002000804000405000500000304060006000007000800060201
15404075884286806475408027678824474020202760308740372270708078228680308866737030601
10006040000000303070004000200000002020004000300060000050305000000080600000300070801
10782030875880708050307440404227703384308077702048202040527677387023862280803284601
10600080600020405000604080600040003000704000204000407060600000200050006000200070001
10803060606030307024302080622050672030673270287420705060503880208050302042633060561
10502060205020003000700030006070002030000040002000503080700020203060500020007020001
10506050208042647774408627604020804438482032204087605050743070808020385570203078701
10406050002070006000607000600060300000008060700050004080808020002070000000707000501
10702546556050608030306030684040273685302040208720822040403086826222766053234680201
10700000002000206020700030008030003000803020300030800030002000000030002070003040801
10832463532858606020758850302848406030206050272070707437688475722060508760403060801
10000000400000007050800060500020006030200070008050800040000040000050507000404050201
18888040403872243070708060432030453030382434407060506020846070407570207047407070401
10005040400000003040003050506030000050000000306080804080300050500040803000506000501
12806750207644702080752080203080467076246570306020203030504880274640502450203250701
10008000807000400020006080705030004000000080002050307000208000200080500050400060201
10405055352070228742603030803080706764474538554770675838308038402080602030677036401
10407000000060003000002050008080503000800000000000200040006060007000205060004000001
10202682625745702038246020644084307060707065246426607070485080377535425020202068731
10800000700060007020000070700030007040008000007000207000705070006000005030402000001
10263464208050424070302750208470632084478566503060702723802055303038607044503026501
10600060006000500040700060205030500030000000705030300000007000404000804000008000301
10808070607753804740803550306030505854585740265020505273522040703770403428227080301
10005000308000003000405000603000805000000060000050200080008080202000300020006060801
10834042203056867027742074407564308060732065353620774030805040703060526026703060401
10004000408000600040008040003000400020007080000000600080506080307050008000305020201
17207733202050703284504070778030364325207030202248602532605050308020705380604420701
10002000504050500000406040000020600000308000400000600000004050300060308000500070801
10547050505080576550202046425660667420644376763350337044702030248687702040708050501
10300060006080000020005000000020800030400050000060003000403020607000604020608000701
10607286546080855078228820384050502020603080227070306380543040207080336050885438201
10600000600070003000000040800060006000203070700060700080400040006070000080002080001
10607840505678803354242020703624775223378040402847875073703043647033803758703060381
10304000306080002000004070500000008000008080300000000070002000004000700000300020001
10388080805040806040847070434465603043802053503888246870508873865230207620307345801
10500080306000602070400080003000402070004000607000000000608000008000802000706000701
10508343307477368040205470508030605060785620524057662787534024407042852074603060801
10400000800070000050200040800020300080500000800020000020008000800070008070807060001
10833680524070207065654020785060307270708028508020434030207070506370207080502020321
10000040004000507080000030004060406040007030004020007000608070200030200030002070001
17343077303847602060588536804840405087673340605082305883505850267040344354536023601
10005070008000004020005000408000500050007000307000200000203000500080800000007060701
10303050642268445077205380605035634650306067527433605830702060804580304725805040801
10405020600000006000400000708000000030405000600000400070800040500040505000807040401
10775040545657802770406568506762502060302070207440486750428434477040803062707050601
10004070006000006030600000300000206000605020700060000000700000007040004070007040001
10803083307075238070782274532260565366408070682022438444888475208052234050667034301
10205000406060000080000000000060000060006050004040000000000000705000000040005000701
10202470705080204554533744238020727080588477536060387247584780702863726442603320771
10300020400060500000000000200050400020000000300060600000004000400000000000700060001
10825020535250446880855670302428507027784650805520206453204075327524503380744058301
10008000500080000070000050800000406040000050600000508000403070000000500060000040001
10504853705030335073667060226060608070706020444028402030302027502530305077574680421
10603000005060002000007070002030708060806030002020003040304000200030702000000020001
10407074754022742046203665608480605520773066402550376086303080578520306583624075801
10700040700070003000304000302000700000800020502000500070008050000030600020006020401
10776780705540207836604050752020236737505460507070507660883050355020203060234070301
10700000300000700070006040000060007000008000200040400040403040004080208000500080701
12603023888683637080753030833830833047644070575250605030605030653020707726704640701
10005000000030002060700080000020400020000040800000403000600060400080602000800000201
10305252568023408040803042856060507330202680607643842872656030803460206030604688401
10300000006000008020508000700050500000603000700080000000004070500000405080600070401
10577378434074824060803442707387337536205043775470508556505060284388232080743060801
10000000003000300020004000007000200060003040008000706000003030400040700040003000701
10262588307253508052855065225620605030468050407074208054884030808050507225308886501
10006000200070005080007000000020407070800030205000303000500050006000600040003000801
10604080468020605060302328555080707260702860705640574460524354277633625070273080301
10400030002000405000600000006000500000600000300060000060000000000000000050000020001
11111111111111111111111111111111111111111111111111111111111111111111111111111111111
