11111111111111111111111111111111111111111111111111111111111111111111111111111111111
10000000005000000000000000008000000000700000000000000000000000004000000000000020001
15308023404037562586803770744073502060504046244072322682532658407050573670775040301
10206060008000000000700080000020006060702000007000500000000000306050200040003060701
10605220272456556720602050336540423650404747707080704035465570802030407043704760601
10600040000000000000207080008000400000800040003070005030003080200040305000500020401
10466020807822524843557060507063802382557360382040734780806070362364608030605060301
10500030606000000000600020403000403000008000300080300000400040800000207070706000201
10807640735057762720508080508770372070607087308466407085622070203770705540803322301
10400050003060000000607030305020000030600060800000007020004040604000205000700000201
10688040307030745557402060708084277770632620503058354088704030706043403042387230801
10000020800020003000003070200070002000800000208000005000003030305000004060007000701
10764360504242676080256080768645803063806673703075805272303020207064254050206760601
10007000200000400080800080000000003000502000504000800000703080003000005000600070401
12406074763774804787608072252547833050605450604550873430707086682520306282244040401
10004080000000405040007000600000004070002000300050000020704000000070400000800080801
10554080876770603030804850206572206375408064404037607060868376757078533660502628301
10600060400020704000205080700030008000407000305000408060500000500050003000700070001
10505030608030806078508030777060447080623840453380808050808370302080707064834020731
10505030608020005000400030008050005020000070007000404020700050308050800020003060001
10207060502042536763506768706050807437228024304054604060783060808080568840808087501
10208060002070008000704000700040600000002080700080005020202070006060000000805000701
10408443668050203040205060238020546353405020403380882080503032764836352027826870701
10500000007000208030300070007070002000402050200030700050008000000030004040002080601
10873457875662808030352230706434703040708040784030406487583733557020503240305040201
10000000300000003070800030500080004080200070002050200060000070000060403000202060401
17383070304675255020204020786040758060763366304060206040683040703420208043505070701
10008060600000003060007020606070000080000000704050508020800080800070606000803000801
16702220505565308030643050404050252057266880706050608020308320632270508770504540601
10002000306000600030004020508040004000000030005020507000804000300080600070300050201
10703044585080736662305030307040304573726833754750657487706035505050308030763047201
10306000000050003000008020007020706000600000000000400030002070008000305020007000001
10603482462624302035766070468083605040805038628876305020334040883355862060703086351
10700000500070006020000070500050008070004000002000806000203030008000005060703000001
10648842405030678080305360402620645035442237408080506824202087508044705057304034601
10200080008000500050700060207070400040000000705060200000006000704000804000006000601
10305060503825506530206250308030404273265330648060508847248060502880603483344060701
10004000404000002000604000602000702000000020000080500040003020603000200050003050801
10437045802083547022362078604873405020485056875630625040506060304080733048808020601
10007000308000700020008060007000600080007070000000300080205020205020006000706070801
18203575704030607678705040522030887248505050806436605878406040204030206620204340701
10003000606020300000306040000070600000505000700000600000005050700070604000500040801
10243080502050286870602078277820438220347686888480786055705080348588603050407020801
10600060002070000080008000000030400070600040000080005000206040803000606040206000801
10204758623020543054844850867070503020705060688070404340824070706020465070228883401
10300000600030002000000050300060007000507060200040600070400070005050000060003030001
10803280208662206228684040406224823478568040506658232055506032783087402845606040221
10805000405070007000006070500000008000007040600000000060002000003000700000200050001
10436030403020407070425030784282706036507026402826636370204238885680802750407255701
10500040408000804050300080008000704080002000203000000000403000008000608000206000701
10607375302474334020402470708080502060724740254042246325788056205083568023404070401
10700000500030000050300060400070600030400000300080000060002000200070004050707050001
10527860632040507088888070234060802370407046503080276020302070302450305030702020561
10000020006000507030000080008060405060006020003040003000807020300080300050002070001
14827086206442704050863377602420807035843540605044703624205460666020826252784088201
10006060006000007040004000802000200080008000404000400000802000300020800000008020801
10605050263473244077802470306077455480603027552777707240206080708650502355203020301
10308060700000003000700000802000000070803000800000200060200030400020503000506030301
10825060242377707730303484706233702050602050302650228250635662842070304064805040401
10008020002000005060700000400000303000508020400050000000400000008080003080007040001
10407077805074546070327426786760253866803030368034856376576473508056546030564066501
10308000208060000050000000000070000050007040002050000000000000604000000030002000401
10305350802050306283887586675060368050562855756050353843463560506576267753305770351
10600020300020800000000000600040400050000000800080400000002000700000000000400060001
10667060227670523360224780207562304076863720406450507784405034554323805620563086501
10002000500020000060000030800000503050000060300000402000702030000000800020000040001
10605752607040877082427080425020608080705030222032607070305032308630206067782750471
10504000004080003000005080005080303020805030008070002080807000800030702000000060001
10304025545023723076704252307660608320743056703280744086602060377570407586462048501
10600040200080007000402000705000500000700030407000200030005050000080700030002030601
10555830705560806276306060547070382455205520707040203470265040557020506050285060201
10600000200000700020006020000080006000008000800020300050506020002020605000500080301
12702056665737328050535060242550468035665070883380403080506020775060408885504350401
10005000000030007080700070000080300040000070800000308000800020600050208000700000601
10708263632082402060707035586040303460205380405835248458825060703420603050508545801
10700000003000003040302000200070400000408000200060000000004020800000402050700070401
10458277445057887020703664502445375526406053586850702283403040624237234070626070601
10000000003000800070005000006000700030003040004000303000006060800020300080002000801
10877367603837305056432052567250608040745080502027404062573070804050707687303784301
10006000200030004070002000000020403040400050303000802000800030004000700060004000801
10305060822050303040507553476070604220703450202750563740838248542575348060778040701
10400020008000607000500000008000400000700000800070000040000000000000000020000070001
11111111111111111111111111111111111111111111111111111111111111111111111111111111111
