11111111111111111111111111111111111111111111111111111111111111111111111111111111111
10000000006000000000000000004000000000700000000000000000000000007000000000000020001
12803025705043767847502870225045707040703035556077783433582222207030354880888080701
10208030008000000000600050000050006040304000008000400000000000207070200060004050501
10306260524454763560504020525460847250503722502050602054654750704030302033306660801
10600030000000000000407040005000300000300040006050008050002070600020607000400080601
10525070404243437835336070606068503833826720454020388580505050752266805080304060401
10400030605000000000800060607000804000002000500050600000200050200000402080808000401
10407670626037826760404060702660846020602055208838307064632060802420207460604288501
10400040004080000000507070702070000070200050800000008060007050203000705000800000801
10844040604040583738503070802062264360675280808087844083404040407084807073637680601
10000050700060004000002050700080003000300000607000007000007070808000005020005000501
10565470408367484050482020478637702055204272405022403833806040405054682060702250501
10008000800000500060200040000000007000204000605000300000604020006000008000500060601
17708048554452802243805062553588255070302650406870344360508042244750504348345080701
10002070000000405080006000200000005080005000300020000050604000000030500000700020201
10723030642870203070207630304536403644707023803038802040733355326045468660805373801
10400060600020207000408060200020003000607000405000507030600000800060006000700060001
10506080507030805032308050582070836080265780433820505020806370504080706084372080631
10608050602060008000800060004070007050000030005000308040200060505070600030007060001
10502030602085247253807886804060504845683038408088208040627050703050787460708037801
10504050002030008000603000800050800000005050800050003080703070007030000000802000501
10404466384050602020403040268020545442602060308550873040606066877857743035854760701
10600000005000204080600030006050008000607060600020500030002000000020006080007050201
10447522648255207080448530608646603050205020323040802443577433263070608340502020401
10000000800000006020500030800030004080700050003020200040000070000070204000602040701
14473080608366222080303060227030276070225736403070708030552070508640405037503080701
10005020800000008080004070705020000050000000207040403070300050200080404000303000801
12508730305254206040528020306040587043635320304040507040605540248640308770506550501
10007000402000700060003060202060003000000080002060505000706000200070500020200040201
10305076726060567223507030604080502572874335455820855487807038704030205040587058301
10406000000080005000002050007080503000700000000000700020008060005000207080005000001
10304767384623403085772030446087203040805027676374802020532020754576454080802023481
10800000700030008080000040200080004070004000005000203000204040006000007030505000001
10742766507030673060706470604750576082257538707050706584302047806027408046202085401
10600070002000500040500060702070800080000000207060800000007000405000206000002000501
10707020406338604550704230502070403543437230364040408686462030808570806676252020601
10005000402000002000705000805000706000000050000080200070006070205000400020008080501
10453053502053454064333075702872206060383075546360528030802060406050336063203040401
10002000804000600060004050008000400030003080000000800020203060305070003000408050801
18202258302040507653202080253070647876603060603887403422705030405040406680708250301
10007000607070500000804080000050700000707000600000800000006040700070202000600080301
10474040806020346420604043572360557380532238472720566033205080626463806070406070401
10600060006060000060003000000080300020600070000030006000203050202000306060807000701
10502264243050477034538860367060402080807060857040205720775070708070585070573435701
10200000300030002000000020500050006000408080400080800030700070003080000070006050001
10807550808822606575453060603428654332345070505447562084806046235088702454607030281
10407000607020008000005030300000004000008070300000000020005000004000300000500070001
10424060805050703040833080243557205073604046603876588880804474766850202440603782401
10500050306000507020700050007000804070007000304000000000408000003000507000606000801
10502658603646652030302820507030503040634580743022657524258076508048763072304040601
10300000200030000080600040600060200020600000300020000070008000700080002070806030001
10256770672030605027273070548070208870706085604040643040406030206320504050404020851
10000030005000306030000030007080208050002020003050008000302080700020600060004070001
15625036705835403060656782202440706058673740705083403844202220483020584834428066301
10002040005000006070004000507000700040008000204000400000602000700070800000003020201
10608040656857876033807850205076764350406038485454708380704080407530508877808020201
10308020500000002000400000206000000080403000700000600040200060700070202000204060701
10765070383476202220403636605752803070404040407270688780644823633070608034803020201
10008060005000005060600000800000802000405040800020000000400000008040003020003050001
10603024604075845030636267537340462426203030848073852723562254405056288050872022601
10804000606050000040000000000060000020003020007040000000000000203000000060007000401
10503380204030503558878388256080446050853654537050883825326350706853732633603450631
10500050200080500000000000500060600040000000400070800000002000800000000000800060001
10254070724760753220444580205446208044544250704730207523206045273638304720825028801
10005000600060000080000070500000207040000050400000506000702070000000200030000050001
10304758306020245084342040682030804050506070386025403020503038402570705032455670871
10405000008040007000005050006040203030506070008060002050605000300080805000000080001
10507046442058473055207722607770505360325064506780573042408060622320404744758064401
10600060400080007000608000507000800000600070605000800040004060000080400050003020301
10454220803630302255602080478080673552205560703020307680336030662060707020437030301
10600000600000500070008050000060003000006000600070500050803030002040305000200040801
17802072268374537020644040766680684066675060256360406020305060756080208753208850201
10007000000020007030700080000080600080000080800000706000600020600020608000300000201
10805784734086706070605076428070403620703530604773583582624060708880808080408475701
10800000005000005070303000600050300000704000700070000000006060500000503030400080501
10557555387085273070504764806344584874607053332820808832605050462266468040653050601
10000000004000700030002000003000400050002040003000605000004080200080600080002000501
10872484502758703026846055788820706020323030707023207057256060508060505542203284701
10002000600050003070002000000040503070800030308000504000400020003000800020003000801
10206060433060603030406327228080505520505750505620758360588568258535733030476040301
10500060008000402000600000003000300000700000500070000060000000000000000080000070001
11111111111111111111111111111111111111111111111111111111111111111111111111111111111
