11111111111111111111111111111111111111111111111111111111111111111111111111111111111
10000000000000200000000000000080000000008000000000000000200000000000000000000000001
18608374663580863560404845578086603077707530203056802670442020705335324326777328301
10005000000070000080400000006000406000300000602000706000400020407000000000000030001
10608222286050383080823577202270402480542465757770207056205560677070735642682020361
10507000800030308000300000200030508000800070008070803000007070003070000050003050001
10307020606060303722702040422020508037802032707030504634562070207058437330406050701
10400050002040003000002030202030002000005000602000700000800080200060000000800040701
10224024685540527070365070803077352840225760804733282770805738838880767232225030801
10008020000030200020007030004000000040000030308000000070600000000000200000008070601
10707360203085705033403055584885238050688030603080627060587364637386206265808250601
10800020708000007000505000000040000050003050004030005070006000500000406000500080801
10788030205688683870802324643740205366503035776037303052702050506470603020543053401
10006000607000000080200000008000600080005060000080207080006080002000207080002000001
16508563608020806063424682434083574060706060404250506020468020826058347050206272401
10003000400030606000003060008060600030806000200080005020007050006000002050600000601
10363840304680432032406020303030405880806687743837278080708050608836702060335240641
10000000600070003000700060300020002000500000000020000080802030300000200080000040001
10328445208078502623432820423770682020722834787060324583804088848280822873828780501
10000000702000200000004000800080800020700030500080000050002000800000500000000050401
10472340428520732323506022424050204852502050206632857020754650803852706553224036601
10000050600060200000007000000070500000003020008000003070000000405000706000700040001
16635380506060605063564688806652608720678027382055866040837732647020307070408550501
10000000405080804000000000807000300030002000002000004060000040008020003030200080201
10557454308020608853702570423050728025786340407373603066646020502073838070683060781
10800080003000700000400030300060002000000040800000603030000080302000000080500070001
15803020707356288320357530608823505035385053308780504043374560604487563776305035601
10002050202000000050000080603000006000008000402000303000000000600050008000004080001
10823070283045534073544072604050242723606270402065507275306375748050803040535040321
10008000600080006050008000802020000020002030505000202000400060007000600070006030001
10203333205060604060547340237086282080427080467460303040442057204063787826504043801
10600080003050600030000060002030000050700030000050002060700080004000000060007070801
10376030787040525623468030507020463520407822446082224670703860507257723040636060801
10802000400080000000000050404070600080007030002000000040600000406000000020002000801
10607375505054836373762570202030304076773070604048684080323777728077763450403632501
10700020807000000000000080400030004000002000505080003040002000000080000060600000301
10502040405044285772774060206045357430604868705070207024405373336530375040722380401
10202050004000005000005020202040000050700060008000406000800000000080800080000020701
10468050586582807044607080304060276086475030843422403230508464728040202065528050801
10000030007000308000300020706000600040000070000000803000500020000040702000003080701
10667872308038706040624740505482523220803373658430305085422250208357206555558080301
10700000708000007030005000200050000000400040000000602070000000205000004000400050601
10606230702435332374374033464030345243673280747484308030203656205033282070308480501
10004000606000200060007060006040200000000080007080004000800020502000002070300040401
10225077705030508070703040734020704052828058703020807340276050702764205082462070201
10005000800050305000700070005050002060003000002000800080508000502000506000003050601
10507340557430205824744848406086888430502772546846577070707050707050503357505020701
10600050700000800000200030008030000020200000500050008030408070803020500000400070201
10568050402565443820205080262050724030302570502060808040407064405080566780852020801
10005030807000500020805080000020004000405000603050200080406000403020000050004050701
14828030502060503040706022587774206063803065703070473480503720804034353053207080301
10007040404080007060202000600000606000305000408030200030007000402000704000608070801
10804050608050255650202370502520506330403270254080744024362733702850604050208220301
10600020806040004000603000304000505070803030002020008000000000600080602040400020701
10454870204022808067402043207084808080407020407022205263257430205070506070538050601
10500060705080007060006000003000006000207030300070200000000000608050808070003000801
10204040307042238070306645606443633644505050624350602685257564206020307082307322401
10503000502000008020700000500020002000002060000000500000002000002050804000500000501
10805336304475208060602620824040204078488042268580305782478048345060606488774080701
10505000304030004020206000600050203080004000700030208000002080600070200000008020301
10204460403070365080506083805680503030502350805030588038705070607860406576504020401
10605000700040000030206070003000406000200000807080500020005020600000800000402070501
10605066336237287420507025848080803734887648505042806440502030856747352450505850401
10500050003000000000605000000040400000000000404000008000304060000000007000400000301
10353740602040254743408335778465246226886660255333876070302046583666506053572747201
10000000700060300000300000700000800050000020000000002040607000000000206050007000701
10475243783670506240603780802320308080448085273320202080506546536770605058703070501
10000000000020707000800050008000705070300030000030400040400000002080003000007020001
10546470568260503055334067356020356070307230737034638380704844604070373357535084331
10000040007000406000004000600020800080300000700080000000600000502070000040000050001
10267036205022808672807625406462206680224260804680874673677640704046352080855230801
10003000708000505000500000700000707000800060608000200060000060700040000060000060801
17308460705760805030688670327780807040206032606085246030365750575550407852558038201
10008000400050303020000060000060205080802000504000003040700030006000300000007000001
10504065582050806077604038746030603028505570503025405080806073707087745420807336201
10508050005040002000406000007020007000700070008000507050203030007020000040700000801
10353053204028372640703782444048433760248086383530706030302040583070246077764030631
10003000802050000000708040000040008000700020004080305050206080200020800080003060001
18502480608050505223704060246230204070203435207040705080806080243250202480606073301
10003000305030600000200050000000506040200000002000300040006080008030300000204060001
10537047406040207560457336885534707040534786323576552567443087702060804346603630601
10004000006000600070000000000000800060000000000000000000004000004000800000200000801
11111111111111111111111111111111111111111111111111111111111111111111111111111111111
