11111111111111111111111111111111111111111111111111111111111111111111111111111111111
10000000007000000000000000004000000000200000000000000000000000008000000000000030001
15303074606063682276704840443052302060706054534028454338434466606050865580825060201
10207030002000000000400050000030005030403000003000600000000000202050500030003070301
10407540627834873830505030583670573320408683606030505022463760406060507087805580701
10600050000000000000807020007000500000600020007030007020008040700060508000300080501
10533080808337588236625070408065608478623450888080877630207040632485708060402060801
10600050606000000000400070802000302000005000300070600000400050600000407070605000801
10807560425063755570608070702780882060802073404387804032425040604470202840808234601
10400080002050000000306050403050000040200030300000007040003070405000302000400000301
10743060607050646243607060206074348380366840405027668088203030307064803023776530201
10000030500040007000008060700030007000700000307000008000005020702000004030006000601
10683860702338772050685030766654705056208764204022306327202070406087784080803550601
10002000300000600060200040000000002000702000308000200000706040003000003000700020201
16404035378627504472608033577446555070207740706420775880602042364220808256674040801
10005080000000204080002000300000002060008000400060000060502000000040800000700040601
10777080254860707070805870604427708573508048405082308020683282335038525740303743201
10200060600060205000805050800080006000306000307000604070700000500040003000500060001
10203080308060403036305030427040385020764830648560304030605580504070705076666030661
10407050204050008000300070007080008080000020005000202080400030305070200070005070001
10305040702066468343305827604030302563864035404047706060443040707060723460204073501
10207070008060002000306000800030700000007040200050003040706020007060000000304000301
10204555636050707080207080682080556788808080502670787040505044286662267053446480401
10300000004000208030800070005030005000506030400050600080004000000020008070005040401
10632685532277506030325420505346707020306070474030708622432322456030704420206020201
10000000700000002050200080700020006020800050006060500050000070000020406000807080401
12686040507852863020407060872050632060268543607030607040825040506330707024306040501
10003050300000004020003080806060000080000000607070208020500040500070706000706000801
15505420407682508040223080308030876073222440608080202050508830658770203540205340601
10006000705000500030006080505060004000000060008030208000507000800040400030800030501
10708032867030472642402080605050302783268872255360442237504062602060304030334036501
10606000000030006000002050003060606000300000000000500040003070002000208030007000001
10403772856225702087426060232084606050606046773527703040843080568573472040803032731
10700000600050004050000050400060007030002000007000705000308020004000004060706000001
10288527708080223060306370702350554046452242202080402575608068806056806065806065501
10400080005000600020800050606060800020000000306050600000003000408000802000002000301
10208020504653805740503860506050404585624560788020608222564030803770607237478050801
10005000307000004000802000306000402000000030000040600040005040703000700040003030501
10845043405028556083464083704727604060882076853430823040703020408020676022707030801
10005000404000800070003020005000700080007020000000500050307060306060002000303030501
15406442403050706672603070664070332623502030503825707647802040703080804520203550701
10008000308060300000606020000040200000308000200000400000005060300020302000400070401
10678040207050573720204066555440334630743772343420222076707040433525406080407080801
10300030002030000040004000000030400060500080000080002000504080403000403050802000501
10308428735040443073828820674080507060804020526080803350685030503080676050536538301
10500000800040002000000050200050008000804040200040500040200020007070000050008040001
10603640406468605677476050504874245757536030406885242027705072343067502567304080251
10206000805080003000003070700000008000002060500000000050002000003000200000400040001
10222050408040604080536030872858607073404087803437587560202487483880306520405636801
10200030702000703030300060007000208050003000403000000000605000006000703000806000801
10306274405722575060304760806020505040832420423056273574222062306082465028505060401
10600000200040000030700050800030200040200000200030000080006000400070007020604050001
10856430776040507073556030657030408320702065202060842070704080605320702040702070541
10000080003000202070000030005020208080007030002080006000704060200080200070003020001
14376046507572303040338735603340502063242540304068305427305530466070834483573087301
10005050002000004050008000503000200060004000502000200000506000400040600000002060701
10508020374566644064207640506044425780803063386632407340306080802470602842807020401
10704040200000005000400000203000000060507000600000700030500080800080602000306050301
10555060626633505530207668304264703040805080603670254450267462267040504038604070801
10008050007000008050800000400000205000205060700060000000300000006030003040005030001
10708022802085573060265534368470487488705030874044832874342623405062885020836065401
10705000603050000030000000000020000080003040006030000000000000407000000030007000401
10405870804050207555563547672070222080242636274060562825237430606378746483707740231
10200030800030200000000000400050800040000000300040200000005000300000000000600020001
10374070734450388530877670208267507064433340802880304575704075686734304240634086601
10006000700050000030000080500000808050000020800000605000503020000000400070000020001
10307268802060735053386070366030702070702040484082303050807058508540607068232250651
10506000008030002000003080004030803020807040006030003030208000800080505000000050001
10403088827064778038704844207340206370785087702430755052607080764650207873336054201
10300030700030007000406000203000600000700060507000800030004080000050300040006020601
10685560608320708428404020344040847483208570708040803440588080438030708070648020301
10800000300000300040008050000030007000006000800030400030507030006020805000300050801
13305072686662445070542040776270336047484020336450205080502020844060208222303340801
10003000000040003080700060000030800050000020400000308000500060300040507000400000201
10502764725058605070508044442070204570706640802683848647235050307380405060808564301
10800000008000007080703000300050200000502000300050000000007070200000204070400030801
10874765643066766080402382703875644337605077623450202655403070663753523080234020801
10000000007000300070007000008000700040007060003000508000005030400060300030002000701
10572786606576404072527053542260205070828070708025803065725040802020707887207658801
10002000700080002030005000000050703020700040203000303000700040007000300030007000201
10406060877030302060603877674070505730404570407530535850635254743573725050246030501
10400040008000607000600000008000400000200000700080000040000000000000000050000020001
11111111111111111111111111111111111111111111111111111111111111111111111111111111111
