11111111111111111111111111111111111111111111111111111111111111111111111111111111111
10000000006000000000000000008000000000300000000000000000000000006000000000000020001
13805022606077568265307230533027203050604044334064564428454456203060637730778080201
10704060006000000000500040000070004020508000008000200000000000702030400050007020801
10805660843253854660502030468870782830508678607030304088725370307080605087402370401
10400080000000000000404040004000400000400030008050006080005060700040506000400070801
10225070506228528664522030703072705768365430625080834550306080758635402030704020501
10600050503000000000200060305000306000008000300060200000600070700000508070502000801
10302370667027686770202050207870848070407033202483305032748030205250505660805847601
10600030002060000000605050304070000020600030300000008050006040203000502000600000401
10366050502020456825508060304026234560644860504053657055608060402082202046838580601
10000030800070004000006020300070007000300000705000008000006030806000004020007000801
10426320703462372040433050275355705074608424805022402282703030307055386070504730501
10005000600000800040200040000000005000308000707000300000404020008000004000400070201
18308062353452503737506064725275726070203230802420448870506076348320305582665080301
10005040000000306080007000500000003030007000700060000070305000000060700000800040301
10537030834770305080804880505342203484705083605054608050665244432025463760804274701
10400080700030404000503060300060005000302000408000206060200000300080003000600060001
10603050704020506024408070654040236060264680467520606040702460808020208028427040531
10405080304060002000800020005080004080000050006000608050200050207030700070006030001
10603040304056733663604525708020605563883056803054306070472060806050528420607023301
10402060004060002000808000500020200000008040700080003060606040004060000000804000801
10205556365050303040808050636080723263404040604820875070203035437643232082722460201
10600000006000605050700060002020007000508020500020700070007000000080003030002040301
10586334648835403030557240603545707060702060478060202657852452375030702360207050201
10000000300000007060600030700060002040200030006040800060000020000050502000307050201
14728040503455558060204070675060662050876337304080802030485060408240807047308040501
10008080200000003040003030202070000020000000208040408070500030400030504000307000701
18603230402882208080748050406060463086424420507080406060408250825670503820404520301
10005000402000300070004080307060007000000060004040607000407000700080500070500040401
10605076445040475637207070307050504248832824863230724642603047505030402080375055701
10606000000070006000004070006040208000600000000000500040004070005000602020003000001
10704667485287303057552050253085708050703072737738502030486030824486637020802062561
10700000800080006020000060200060003080003000008000707000804080005000008030805000001
10424588802070464040607270807330765066354743507030807648706024207063707087807085501
10500040006000700020700070502040200050000000607030700000003000807000504000004000801
10808030303324603640802260405030804388788470743080208283884070403370804344675020301
10007000308000007000702000607000504000000080000020400040007050404000600080004030601
10732062607032657037434058403383505060787046466830873080208030405060647085703080301
10006000503000800040006040002000400050005070000000500050407070708070003000707080601
13703357806080304562606030522040264424307050703763706343208020303020204370507220501
10004000303080500000507030000050500000207000500000800000008030200060807000800040601
10724040404070884730202083872860785380754247832870252023306070838885505060408060701
10400020005050000070002000000070400080800030000060008000805070806000205050406000301
10406382872030274076737460285050305060206060244050802760667080206070468040227833301
10400000200030005000000020300050007000702050400050500050300060005080000080008020001
10804430405827504227268060805652487483768070305424634073203084573063605883408070241
10506000504070003000002040700000008000007050400000000060007000004000300000700080001
10574070705020407070785040785483408055703024704866236520807336642560702320303362201
10200080707000704020300050007000404060002000705000000000807000003000308000802000401
10306387303333525040802340606070802050523740377058664226423042803083255042502040801
10400000600020000020800050400070700020400000800040000050008000600080002070308060001
10376470832060707063834040655060308260608083505030768070605070502450803060605020271
10000060008000804070000060008080207050002050006080008000608030300030200020005030001
15747053604726608070827326407670705053674830307076507458305820284030853656885055501
10007030008000005040006000202000200070005000604000700000807000500060300000003040501
10805050273746874042206720805048553420206022745467606340606040802830408884604080801
10303040300000003000400000808000000040702000800000200080200040800080506000803020201
10522020377324802260507848808873402080505040605440864780528845873060603068304050301
10006020003000008070600000600000706000405070300050000000700000002030002070005080001
10707023408038552020462784463830344254603070274023527758463443304078833040654028301
10404000405070000060000000000050000050006070008050000000000000703000000030002000601
10407830804040505773658772773080732020478627285040744483237660408644472578503780861
10700070400040500000000000600050200030000000500080200000007000800000000000700060001
10438020787230683550683320304528304053848520602840808372803056365288607840736022201
10007000700080000080000020300000602070000020600000308000808060000000700040000030001
10602463307070474087437020883080702050706050855082807020507028607820605046488540841
10503000008080008000006080005050804070205020003080004080303000500050203000000070001
10402078338082848085703868808880505460556066405450453072202050876440808322664058601
10300030400040008000507000508000500000600070607000400020002070000040800080005050401
10773530705480405434305030444070827846405450808060804360277030676080507030863030601
10700000200000600040008030000050005000007000600060600020804080002040608000600060701
14807076867853668050238070324360287033254050528450705050203050352030407685305340801
10006000000070002040400070000030800060000070200000808000500080300040808000200000501
10703767758075705040402062753040302670708330307645725225228050408880304080706746701
10400000007000004080403000600020800000604000200050000000002050500000706040300070201
10366685282088535020707458206577337735408082737860505375606080674753587080783040201
10000000002000300070008000007000400020007020006000706000006050500020200070003000401
10424746606876304025543084367640403060285050303056502087723060302060705354704234601
10005000800030007020003000000080208050700060703000406000500060004000400040007000701
10606070345070707070404224666030608250507570708450475680548664722745852070555060501
10800030007000608000300000002000300000600000300080000020000000000000000030000060001
11111111111111111111111111111111111111111111111111111111111111111111111111111111111
