11111111111111111111111111111111111111111111111111111111111111111111111111111111111
10000000005000000000000000003000000000800000000000000000000000008000000000000050001
18207083706073724677607420767082206060708048823073687348646376707020457880366020701
10506070006000000000400020000070008070606000006000200000000000404070200020005020401
10503340562734237240202060262370734550506738706050702073322860503020202038704480201
10200060000000000000508020007000400000400080002080004040007040500060808000200050501
10783070402627648456663030304038807326828350552070686560808080688426205060307040401
10300080708000000000200040608000303000002000200030200000400080400000804040808000301
10504370342064326830402060403470267040404064207277705047282020406780604860704268401
10500020004060000000806070204020000050500060600000005050006080407000405000800000701
10246040206030748448807040204022546550527480707035675073308030806038606037842430801
10000060400040005000002030800080002000200000802000008000002070606000007080006000201
10382580506376338040842060374664502087407545807067705676306020302026324050608740401
10008000400000300030800070000000002000303000803000400000808060007000007000500070801
12205034282588608677607074576384364030606340304760345340506025637250604827542080201
10002080000000303060007000300000004070002000500080000070206000000030400000600040301
10722020458880704070706730803882205776307063506056505070728358442043856860407836801
10400060800060203000207070500020003000808000608000408040600000800060003000800040001
10708030603020704024408040657080536080838730522530608050302260307080504035634060481
10604020306060007000200020006060007050000070006000807060800040508070700080003080001
10607020703033865483604843503040203635442046606022303070373080506080624450308066401
10508070004040002000203000400070300000003040600060005070403040006080000000502000801
10503647637050304020606020534070833748604070204760432050704088855883834038287780801
10800000002000605080300080007050007000503030800030700020005000000040007050007040201
10484826486684802030772770407558202030704040355080606838332647457040605250505060801
10000000200000003070400050200020005040700070006040200070000070000060805000506080301
13747030302833427050608050272020822050268478704070504060862080504630606064604040301
10005060500000007040003030202050000020000000202020804080700050400070306000508000301
12706530407775202080735070403040457076476430705030403040707480885420805570707770201
10007000705000300020006080502080007000000050003080502000602000800050800030200040301
10208076445080786878708030404080806338656548424380586224408048806050704050748083801
10702000000030007000005050003030207000800000000000700050007030002000707070002000001
10705384388844503025245080578085506070508045684548302040287060265765873020805044321
10700000600040002040000070700020006040005000004000206000803050008000003040302000001
10328242503040322050702450603630787057385337606020407548305042207068804064305086801
10700070004000500020500030308060500020000000407040700000004000302000602000003000701
10303060607228203850403580808020403746262530247050607886277030303240608226468030501
10008000302000005000306000203000204000000060000030600050007060806000700070007070701
10546046303044754033362034303663208050835028852660778050708080402060342034303070601
10008000608000700080007060005000700020007040000000400020507070406080007000808080501
16205475803040708274504050463040775643205060706675708746405050408030608370602680401
10002000203030200000708050000060200000603000800000200000004020500020508000500020601
10543030405080743750607085843370333620684232874650746062603070828678607020403050801
10400030007030000020007000000070400050800040000050003000807080306000706060307000301
10705237423050854076678370235030204080206040766040604530575020806040422040888847401
10300000400080006000000040400040006000302080400020300070300070007070000040007080001
10607670802424407363887030805522834625462070404347555073806057867054505528604030521
10206000604060004000003080500000002000004020600000000050003000005000300000700070001
10525040707030808030365030278223603085808045605588688330608368443860705730607233601
10600050206000407040800050002000708080002000602000000000207000007000504000806000301
10604566807572528060803550207080205080283780233067357233565026308024824045808050301
10700000500030000020200020200020300040800000200030000080006000800020003060307020001
10552670525080604038287070576020204670608076304060267030302080404350507030202020481
10000050006000304030000020007080803030006030007050005000707050200020600080008050001
16888074206854407050483525606240307074837320603026805222204220323030575678344062801
10002030004000002020005000407000800030003000308000400000204000400020700000006020201
10503030463434664082402830705038855270705062732524304830408040505570506628603040401
10606020700000006000700000604000000030505000200000800040400040800020707000402030301
10647020283477508540403365805826407030602030603530585320433686775080806044305080601
10006030003000005020500000700000402000607050500080000000800000002020006020003020001
10506076408077373080344633577880627573507030732025252358324552702074678080576076201
10807000503040000070000000000030000020004080006070000000000000604000000060004000401
10405670304040405263872432363050255060725464766040287275854280808253788376202750261
10700020400040400000000000200070700060000000400040300000004000200000000000400020001
10288080437240385230626240504256208076686560706450603538202075376778803620823056801
10002000700050000050000080700000308020000020600000205000807060000000200070000040001
10704852605060634058765080626050702060606060846072607040702067502270505048742880841
10803000005080005000005070002080807070507070003060007040708000400040303000000060001
10704068632032445063606223603320707640265077408450853025305080577340202783447063501
10200080400060003000207000405000700000800020802000300060003080000020700060004040801
10258430303530807742806060763030648448806430504060205750552080374080503080566040301
10700000500000500080004060000020006000004000400070500020803030005060402000300050401
13502085826427423060446030355380323048625030325350404020203020844050502677404770301
10006000000040006020200040000070300020000060400000803000600020400070203000700000501
10804846743024208080806066544080207430808450707643778423653020507770308030204378401
10700000007000005070604000300060500000404000500020000000005080300000808020700070801
10856375453076362050808833206242747464402024626760804722302040863327357030575020801
10000000003000700070004000003000300080006040003000404000003050500060600050002000401
10774363807658602076548068646820702080747050704077403054236030307050603584805448801
10002000300030004060006000000080707070200050207000502000300040008000200050007000501
10302030634040607020306244686070205540506740803780648570367627336252533060843060601
10600060008000307000600000006000200000300000500050000050000000000000000030000030001
11111111111111111111111111111111111111111111111111111111111111111111111111111111111
