11111111111111111111111111111111111111111111111111111111111111111111111111111111111
10000000003000000000000000004000000000300000000000000000000000003000000000000060001
13707073707057748636605620545055302070207026247042543586762245208060283260527080301
10305050006000000000700070000050008050302000004000300000000000806020500080007030701
10505220575288367280202020556470375350702678303040602062646440504080803064207580501
10400070000000000000508040007000300000200080004020003030002030300040404000200080201
10685040606725864333447050606055206744782840763060823440402020386478704070608060401
10400060705000000000700050205000308000004000300030200000500020500000305070705000601
10303230384073277770705050802280584060602075506857504033257040508470806870708455501
10400040008040000000802050804020000020200030200000008020007020708000305000600000501
10554080404030742327204020208057332550747840508042777068504030308045307024667580301
10000050200050007000004030300030002000200000808000002000008080204000005030008000201
10276480408552558040376040587623707043806775606076606738803080503046553040507520301
10005000800000400070800080000000005000508000604000700000306050008000008000200060701
16702035473484708623704024852756322070802340707770625760802022885780708528382080301
10006030000000607040002000200000005040007000500080000070804000000050600000600050701
10254030444640504030207870504873607548405033703082502040282636565036485340208757601
10500080800040302000604020600060007000303000708000807080300000800030007000800020001
10505080402030604083403060475030437060337580725520507030505660604030608082756050751
10502070403080005000800020006040008020000030007000203070300040802060800050003030001
10808030504084246538305858304040202565532065806075407020267070603030756740407066301
10608040002030008000206000600070700000006020700040006040406060006020000000506000401
10502436753040402030407050887070253673805080606270537040604056563347458026824740701
10300000002000407080500030002020004000603060700060300070008000000060005020003060301
10278222653358405030242740206378705040406050248040207722544446462060504470407070501
10000000400000004040800030600050007070600020004080800040000040000020706000406060401
16782080308287786040408030575060548040443355307080202020732060603630304046307040301
10003020700000004030002060203070000050000000207080603080400070800030205000806000701
12206480408767606040666070803060822068662860507050403070608270486470607420502260701
10004000307000700020002030803040003000000060003030702000608000300020400020600060701
10607038558080274337202030308040806746825555484680383856205036305020606030888028201
10307000000080007000004040007060807000300000000000700080002020008000405070002000001
10605247378382508057454080586083404030602023355476202020856060452266874040706044641
10800000300080003070000060800040008060007000006000804000808070004000007030708000001
10333655808080626040608260605880837034664333704020707827205066403087405037703086801
10300020008000700080800020303080500070000000505030800000008000306000505000007000501
10707020708854304750706850802030305286673580437030407558374030305880508644626050201
10002000705000006000502000304000606000000070000030400040005020307000800040003050401
10625086206043423083375022805237607030245055665280336050306030706020374074604040501
10003000507000400030004030002000600020005080000000400040508020806070004000705040201
12604462306020505634802080478050654282306060603582405436804030804040704850207570501
10008000303030200000808080000030400000204000700000700000004020500070602000200020701
10264030406080674850602026725570634660674767654560377053203070672483603080606080401
10300050003030000030004000000050400020200080000080008000708040703000606040204000501
10706784388030432073634260747020302030202060832050607340524030806060762020333888801
10700000300080008000000080600050008000403080600040600080200080003030000040008070001
10408780608675503337366070704535538387843070205783276064403027734044804348707030581
10407000706030006000005040600000006000008030600000000080008000004000700000700070001
10878070806020304030578030342636205074208088607742885240703567767840708380203565201
10700020802000303050200040006000805040008000502000000000408000007000802000704000701
10803837307256623030706620405080803070487840744047274263624074802038346078306050601
10600000800030000070400070400040600070200000200080000070004000400060006080606020001
10878340552020408025526050777030703550502087702040786020504030608450204020306020351
10000070007000306040000020005080205030003020004080007000505080300030700070008020001
13327067603274404040372752505530703075546730803042808762308650663050228585278082601
10008070007000003050008000802000800040004000305000700000304000700060600000003080601
10304070666336378056504880606088863460605044585823203570202030402280807686808080601
10602030200000006000800000808000000040707000200000200040300070400050505000404040801
10424080586882202720303484505667405070503050204640635240358845368030207026504030501
10003070007000002060300000200000204000708040600050000000400000003050007070008030001
10206024803067644050447442867350676224702020337047244425472777806085842040356086601
10508000606040000040000000000050000070007040008060000000000000808000000020008000701
10207320402060608622643626832080278040736527574070832843637330507734566846808870241
10800070200060700000000000700020400080000000800030700000004000800000000000700070001
10475020486840388350575470202678203072887470402870707374307074486785207850427046601
10007000700030000070000040700000708080000050600000503000205030000000600070000030001
10704776204080633042228020645030305080304040538057202070803063402260802027464530421
10702000002060004000003040008060705020302060003030006060604000500020207000000050001
10304055855088548076603686406840406660863065603260856068703040543450202523884056401
10300080500040002000804000506000300000400030407000300070003080000040200070002070701
10468670508860802547608030464030852788607240303080708880732080827030708040358070201
10500000300000300040007060000060005000002000200040700030403050003040702000400050701
18204086522638225040532040544640682028853030722220208040304070288050506224307340601
10005000000040004030600070000080800020000050200000207000800030300050506000600000401
10404254838052202040604037463020407580808240503667872342832030505720407040708525201
10300000007000006050704000200070200000605000800060000000005050300000208040200070401
10267257487053637070804245407764368654707047547720206484205070373482752050428030301
10000000008000500030003000002000800070005080008000606000008060300060500070006000401
10565552503637205064463047223450407040588040802074408022588040403020403525305243501
10003000300040004030002000000080503070500060504000704000600040005000800040006000701
10305030347060408040202872452060603570502450302250885620527655664323252040853050301
10400070005000202000400000002000600000800000700060000020000000000000000070000020001
11111111111111111111111111111111111111111111111111111111111111111111111111111111111
